------------------------------------------------,-X-X-X-X-X-X---------------------------------------------------------------------------------------------------------------------
------------------------------------------------,-X-,-.-<-,-X-,-------------------------------------------------------------------------------------------------------------------
------------------------------------------------,-X-,-,-,-,-X-X-------------------------------------------------------------------------------------------------------------------
--------------------------------,-,-,-,-,-------,-X-.-.-.-,-X-X-------------------------------------------------------------------------------------------------------------------
--------------------------------,-X-X-X-X-,-,-,-,-X-X-.-W-X-X-,-------------------------------------------------------------------------------------------------------------------
--------------------------------,-X-X-X-X-X-X-X-X-X-X-X-.-X-X-X-,-,---------------------------------------------------------------------------------------------------------------
--------------------------------,-X-.-.-.-.-.-X-X-.-.-.-.-.-:-.-X-X---------------------------------------------------------------------------------------------------------------
--------------------------------,-X-.-.-.-.-:-.-.-.-.-.-E-.-.-.-.-X---------------------------------------------------------------------------------------------------------------
--------------------------------,-X-.-.-.-.-.-.-.-.-.-.-.-.-.-.-.-X---------,-,-,-,-,-,-----------,-,-,-,-,-----------------------------------------------------------------------
--------------------------------,-X-.-.-.-X-X-X-X-X-X-X-X-.-.-.-.-X-,-,-,-,-,-X-X-X-X-X-,-------,-,-X~X~,-X~,---------------------------------------------------------------------
--------------------------------,-X-.-.-.-X-----------,-X-X-.-.-.-X-X-X-X-X-X-.-,-,-t:t:X-------,-X~.~X~X~X~X~--------------------------------------------------------------------
--------------------------------,-X-.-:-.-X---------------,-X-.-.-:-.-:-.-.-.-E-,-t::-t:X-,-,-,-,-X~X~X~X~X~----------------------------------------------------------------------
--------------------------------,-X-.-.-.-X---------------,-X-.-.-.-.-E-.-.-.-.-,-t:t:t:X-,-X~X~,-X~.~X~X~------------------------------------------------------------------------
--------------------------,-,-,-,-X-.-.-.-X-,-,-----------,-X-,-,-,-,-,-,-.-.-,-X-X-X-X-X-X-X-.~X~,~,~,~X~------------------------------------------------------------------------
--------------------------,-X~X-X-X-,-,-,-X-X-X-,---------,-X-:-.-,-,-,-,-:-,-X-X-X-X-X-X-X~X-,~,~,~.-X-X~,-----------------------------------------------------------------------
--------------------------,-X~,~,~,~,~,~,~,~,~:~X~--------,-X-X-X-X-X-X-X-X-X-X-X-X-X-,-,-:~,~.-.-,-,-X-.~X~----------------------------------------------------------------------
--------------------------,-X~.-,-E~.-.-E-,~.-,-X~------------,-,-,-X-X-,-,-,-X-,-X-X-,-,-.~,~.-E-,-E~.~.~X~----------------------------------------------------------------------
------------------------,-,-X-X-X-.-.-.-.-.-X-X-X~,-------,-,-,-X-X-X-X-X-X-X-X-.-.-.-.-,-.~,~,-,-,-.~.~.~X~----------------------------------------------------------------------
------------------------,-X~X~X-X-.-.-.-,-,-X-X-X~X~------,-X-X-.-.-.-.-.-.-.-,-.-.-:-.-,-,~,~,~,~,~,~X~X~X~----------------------------------------------------------------------
------------------------,-X~,~,~,~.-.-.-,-,~,~,~X~,-------,-X-.-.-.-.-.-.-.-.-,-.-.-.-.-.-.-.-.-.-.-.-X---------------------------------------------------------------------------
------------------------,-X~X~.-.-.-.-.-,-,~.-,-X~X~------,-X-.-.-.-.-.-.-.-.-,-.-.-.-.-.-.-.-.-:-.-.-X---------------------------------------------------------------------------
--------------------------,-X-X-X-.-.-.-.-.-X-X-X~--------,-X-.-.-.-,-X-X-X-X-X-.-.-.-.-.-.-.-.-.-.-.-X---------------------------------------------------------------------------
--------------------------,-X-X-X-,-,-,-,-,-X-X-X~--------,-X-.-.-.-X-,-X-X-,-X-.-E-.-.-.-E-.-.-.-:-.-X---------------------------------------------------------------------------
--------------------------,-X~,~,~,~,~E~,~,~,~<~X~--------,-X-:-E-.-X-------,-X-X-,-,-.-.-.-.-,-,-E-X-X---------------------------------------------------------------------------
--------------------------,-X~X~X-.-.-.-.-,-X-X~X~--------,-X-.-.-X-X---------,-X-X-X-X-.-.-.-X-X-X-X-------------,-,-,---------------,-,-,---------------------------------------
------------------------------,-,-X-.-:-:-X---------------,-X-.-.-X-X-----------,-X-X-X-+-+-+-X-X-X-----,-,-,-,-,-,-X-X-,-,-,-,-,-,-,-,-X~X~,-,-----------------------------------
------------------------------,-X-X-.-:-:-X---------------,-X-.-.-.-X-------------,-,-X-.-.-.-X---------,-X-X-X-X-X-X-X-X-X-X-X-X~X~X~X-,~X~X~X~----------------------------------
------------------------------,-X-X-.-.-:-X-,-,-,-,-,-,-,-,-X-.-E-.-X-------------,-X-X-.-.-.-X-,-,-,-,-,-X-:-:-.-E-,-:-.-,-:-:-.~.~.~.-X-,-X~------------------------------------
------------------------------,-,-X-.-.-.-X-X-X-X-X-X-X-X-X-.-.-.-.-X-,-,-,-,-,---,-X-X-.-.-:-.-X-X-X-X-X-X-.-.-.-.-,-,-,-.-.-,-.~.-X-X-X-----------------------------------------
------------------------------,-X-X-.-.-:-.-A-A-.-L-.-.-.-.-.-.-.-.-.-X-X-X-X-X-,-,-X-,-E-.-.-.-,-X-X-.-X-X-E-.-,-:-,-.-,-.-.-,-.~.-X-X-X~----------------------------------------
------------------------------,-X-X-.-E-:-.-.-.-.-L-.-E-.-.-.-.-E-.-.-.-X-X-X-X-X-,-X-X-.-.-.-.-.-.-.-.-.-.-.-,-,-.-.-.-,-.-.-,-.~.~.~.~X~----------------------------------------
--------------------------------,-X-A-.-.-.-:-.-.-L-,-,-,-,-,-,-,-,-:-.-.-.-E-,-X-,-,-X-.-.-.-:-.-.-:-.-.-.-.-,-,-,-.-.-,-,-,-,-,~,~,~,~X~----------------------------------------
----------------------------------,-X-X-X-,-,-X-X-X-X-X-X-X-X-X-X-X-X-X-X-.-.-,-X-X-,-X-E-,-,-.-,-,-,-.-.-.-.-.-.-,-,-.-,-:-.-.-,-.-.-.-X-----------------------------------------
--------------------------------------,-X-X-X-X-------------------------,-X-.-,-X-X-,-X-,-X-X-,-,-X-X-A-X-X-.-E-.-.-,-,-,-,-.-E-,-.-A-.-X-----------------------------------------
------------------------------------------------------------------------,-X-.-.-X-----,-X-X-X-X-X-X-X-X-X-X-.-,-,-,-,-.-.-,-,-,-,-.-X-X-X-----------------------------------------
------------------------------------------------------------,-,-,-,-,-,-,-X-.-.-X-----------------------,-X-X-X-X-X-X-X-X-,-,-,-,-X-X-X-X-----------------------------------------
------------------------------------------------------------,-X-X-X-X-X-X-X-.-,-X-,-------------------------------------,-X-.-.-.-X-----------------------------------------------
----------------------------------------,-,-,-,-,-,-,-,-,---,-X-:-.-.-.-,-.-.-,-X-X-----------------------------------,-,-X-E-.-E-X-----------------------------------------------
----------------------------------------,-X-X-X-X-X-X-X-X-,-,-X-.-.-.-.-,-.-.-.-X-------------------------------------,-X-X-.-.-,-X-----------------------------------------------
------------,-,-,-,-,-,-,-,-,-,-,-,-,-,-,-X-:-,-,.,..-:-.-X-X-X-.-.-.-.-,-,-.-.-X-------------------------------------,-X-X-.-.-,-X-----------------------------------------------
----------,-,-X-X-X-X-X-X-X-X-X-X-X-X-X-,-X-.-.-.-.-.-,-:-X-,-X-.-:-X-X-X-X-X-X-X---------------------------------------,-X-.-.-.-X-----------------------------------------------
----------,-X-X-:-.-.-.-.-,-:-X-X-.-:-X-,-X-.-.-.-.-.-.-.-X-X-.-.-:-X---,-X---------------------------------------------,-X-.-.-.-X-,-,-,-,-,-,-----------------------------------
----------,-,-X-.-,-E-,-,-.-A-X-X-.-.-X-X-X-.-.-:-:-.-.-.-.-.-.-:-,-X---------------------------------------------------,-X-.-.-.-X-X-X-X-X-X-X-,---------------------------------
----------,-X-X-,-,-X-X-,-.-,-.-,-.-.-,-,-,-.-E-.-:-.-.-.-.-.-E-,-.-X---------------------------------------------------,-X-.-.-.-.-.-.-X-X-.-.-X-,-------------------------------
----------,-,-X-K-,-X-.-X-E-,-.-,-.-.-X-X-X-.-.-.-:-.-.-.-.-.-,-.-X-X---------------------------------------------------,-X-.-.-.-.-.-.-.-.-.-.-E-X-------------------------------
----------,-X-X-,-,-X-X-X-.-,-.-,-.-.-X-,-X-.-.-.-.-.-,-,-X-X-X-X-X-----------------------------------------------------,-X-.-E-.-.-.-.-.-.-.-.-,-X-------------------------------
----------,-X-X-,-.-.-.-.-,-A-X-X-E-.-X-X-X-,-:-,-,-,-.-:-X-------------------------------------------------------------,-X-X-X-X-X-X-X-.-.-.-.-E-X-------------------------------
------------,-X-:-.-E-.-.-,-.-X-X-.-.-X-X-X-X-X-X-,-X-X-X-X---------------------------------------------------------------------------,-X-.-.-.-,-X-------------------------------
------------,-X-X-X-X-X-X-X-X-X-X-.-.-,-X-X-X-,-X-,-X-,-,-------------------------------------------------------------------------------,-X-.-.-,-X-------------------------------
------------------------------,-X-,-,-,-X-X-X-X-X-.-X-X-X-,-,---------------------------------------------------------------------------,-X-,-,-,-X-,-,-,-,-,---------------------
------------------------------,-X-,-.-.-.-E-.-.-.-.-.-,-X-X-X---------------------------------------------------------------------------,-X-.-.-.-X-X-X-X-X-X-,-------------------
------------------------------,-X-.-,-X-X-,-,-,-,-,-,-<-.-,-X-----------------------------------,-,-,-------------------,-,-,-,-,-,-,-,-,-X-.-.-.-.-.-.-.-.-,-X-------------------
------------------------------,-X-X-X-,-X-X-X-X-X-X-X-X-X-X-------------------------------------,-X~X~,-----------------,-X-X-X-X-X-X-X-X-X-.-.-.-.-.-.-.-E-,-X-------------------
------------------------------------------------------------------------------------------------,-X-,-X~----------------,-X-.-.-.-X-.-.-.-X-.-.-,-,-,-,-.-.-,-X-------------------
----------------------------------------------------------------------------,-,-,-,-,-,-,-,-,-,-,-X-X-,-,-,-------------,-X-.-E-.-.-.-.-.-.-.-.-,-,-W-,-.-.-,-X-------------------
--------------------------------------------,-,-,-,-,-,-,-,-,-,-,-,-,-------,-X-X-X-X-X-X-X-X-X~X]+]X~X~X~X~,-----------,-X-.-.-.-.-.-.-.-.-.-.-,-,-,-,-.-.-,-X-------------------
------------------,-,-,-,-,-,-,-------------,-X-X-X-X-X-X-X~X~X-X~X~X~------,-X-E-.-.-.-.-,-.~.~.~.~.~.~.~.~X~----,-,-,-,-X-.-.-.-X-X-X-X-X-.-.-.-.-.-.-.-.-,-X-------------------
----------------,-,-X~X~X-X-X-X-,-----------,-X-X-X-E-,-.~.~.~H~.~.~X~------,-X-.-.-,-,-E-,-,~.~.~.~.~E~.~.~X~----,-X-X-X-X-.-E-.-X-----,-X-,-,-.-.-.-.-.-E-,-X-------------------
----------------,-X~:~.~,~,<,<:-X-,-,-,-,-,-,-X-X-X-.-,-.~.~.~.~E~,~X~,-,---,-X-.-,-,-X-X-X-X-,~.~:~.~X~X~.~X~,-,-,-X-W-.-.-.-.-.-X-----,-X-X-X-X-.-.-.-.-.-.-X-------------------
------------,-,-,-X~.~,~,~.-.-,-X-X-X-X-X-X-X-X-X-.-.-,-,~,~,~,~,~,~X-,-X-,-,-X-.-,-X-------,-X-.~.~.~X~X~.~X~X~X~,-X-X-X-X-.-.-X-X-------,-X-X-,-X-.-.-.-.-.-X-------------------
----------,-,-X~X~X~.~,~.-.-.-,-.-.-.-A-+-.-:-.-,-.-.-,-.-,-:-.-:-.-X-X-X-X-X-.-.-,-X-------,-X-E~.~.~X~.~.~.~>~X-X-----,-X-.-E-X-X-------------,-X-X-X-X-X-X-X-------------------
----------,-X~.~,~,~,~,~.-.-.-E-.-.-.-.-+-.-.-E-,-.-.-,-.-.-.-.-.-.-.-.-.-.-.-.-:-H-X-------,-X=H~.~.~.~:~E~>~>~>-X-----,-X-.-.-.-X-----------------------------------------------
----------,-X~.~,~.-,-,~:-.-.-,-.-,-,-A-+-,-,-.-,-.-.-,-.-,-,-.-.-.-.-,-,-X-X-.-.-,-X-------,-X=E~.~.~.~.~.~>~>~>-X---,-,-X-.-.-.-X---------,-,-,-,-------------------------------
----------,-X-.~,~.-.-.-.-.-,-,-X-X-X-X-X-X-X-X-,-.-.-,-,-,-:-,-:-,-X-X-X-X-X-X-.-,-X-,-,-,-,-X-.~.~.~X~X~.~X~X~X~----,-X-X-.-.-.-X-,-,-,-,-,-X-,-X-,-,-,-,-,---------------------
----------,-X-.~,~.-.-.-.-.-,-.-X-,-X---,-X-X-X-X-,-.-,-.~.~.~.~.~.~X~------,-X-.-,-,-X-X-X-X-,~.~.~.~X~X~.~X~--------,-X-,-.-.-.-X-X-X-,-X-X-X-X-X-X-X-X-X-X-,-,-,-,-------------
----------,-X~,~,~:-.-.-,-,-X-X-X-----------,-X-X-X-E-,-,~,~,~,~E~,~X~------,-X-.-.-,-,-,-,-,-.~.~.~.~.~.~.~X~--------,-X-,-E-.-.-.-:-X-X-X-.-.-.-.-.-.-.-:-X-X-X-X-X-,-----------
------,-,-,-X-X-.-.-.-.-,-.-X---------------,-X-X-X-X-.-X-X-X-X-.-X-X~------,-X-.-.-.-.-.-E-,~.~.~.~.~E~.~.~X~--------,-X-,-.-.-.-:-.-:-X-X-E-.-X-X-.-W-.-.-.-.-.-,-.-X-,-,-,-----
----,-,-X-X-X-X-,-,-,-X-X-X-X---------------------,-X-X-X-X-X-X-X-X---------,-X-E-.-.-.-.-X-X-.~,~X~.~.~.~X~X~--------,-X-X-.-.-.-.-:-.-:-.-.-.-.-.-.-.-.-.-.-.-.-,-:-,-X-X-X-----
----,-X-X-A-.-.-.-.-.-X-----------------------------------------------------,-X-X-X-X-X-X-X-X~X~X-,-X~X~X~X~------------,-X-.-.-.-.-.-.-.-.-.-.-.-,-,-,-,-,-,-.-.-,-,-,-X-X-X-----
----,-X-.-.-.-.-:-.-.-X-------------------------------------------------------------------------------------------------,-X-.-.-.-.-.-,-,-,-.-:-,-,-.-.-.-.-,-.-.-,-,-,-X---------
----,-X-.-.-.-,-,-,-.-X-------------------------------------------------------------------------------------------------,-X-.-.-.-.-.-,-X-X-.-.-,-.-.-.-.-.-,-.-.-,-,-,-X---------
----,-X-.-.-X-X-X-X-X-X-------------------------------------------------------------------------------------------------,-X-,-,-,-,-E-,-X-X-,-E-,-,-.-.-.-.-,-.-E-,-.-X-X---------
,-,-,-X-.-.-X-,-,-----,-,-,-,-,-,-----,-,-,-,-,-,-----------------------------------------------------------------------,-X-X-X-,-X-X-X-X-X-X-X-X-X-X-.-.-.-X-X-X-X-X-X-----------
X~X~X-X-E-.-X-X-X-----,-X-X-X-X-X-,-,-,-X-X-X~X~X~,-----,-,-,-,-,-,-,-------------------------------------------------------,-X-:-X-------,-X-X-X-X-X-.-.-,-X---------------------
X~,~,-,-.-.-.-.-X-----,-X-,-.-X-X-X-X-X-X-X-.~H~,~X-,-,-,-X-X-X-X-X-X-------------------------------------------------------,-X-X-X---------------,-X-.-.-,-X---------------------
X-E~.-,-,-,-,-,-X-,-,-,-X-,-.-X-X-.-.-,-X-X-,~,~,~X-X~X~,-X-X-X-X-X-X-,-----------------------------------------------------,-X-X-X---------------,-X-.-E-,-X---------------------
X-,~.-.-.-.-.-.-X-X-X-X-X-.-.-.-.-E-.-.-.-.-.-,-.~.~,~X~X-X-X-,-,-,-X-X-,-------------------------------------------------------------------------,-X-.-.-,-X-------,-,-,---------
X~,~:-.-.-.-.-.-.-+-.-.-.-.-.-.-.-.-.-.-.-.-E-,-.~.~,~X-X-X-X-.-t:,-X-X-X-------------------------------------------------------------------------,-X-.-.-,-X-------,-X~X~--------
X~E~.-.-.-.-.-.-.-+-.-.-.-.-:-,-,-,-,-,-.-.-.-,-A~.~E~X-X-,-,-,-,-,-,-,-X-----------------------------------------------------------------,-,-,-,-,-X-.-.-,-X-,-,-,-,-X~X~,-------
X~,~,-,-.-.-:-.-.-+-,-.-.-.-,-,-.-.-.-,-,-.-.-,-A~.~H~X~X-.-.-.-.-.-.-,-X---------------------------------------------------------------,-,-X-X-X-X-X-.-.-,-X-X-X-X-X~X~X~X~,-----
X-.~.~,~.-.-.-.-X-X-X-X-.-E-,-.-.-.-.-.-,-.-.-.-A-.~.~X~X-.-.-.-.-.-.-,-X---------------------------------------------------------------,-X-.-.-.-.-,-.-A-,-.-.-:-,-,~.-.-,-X~----
X-E~.~,~.-.-.-.-X-,-X-,-X-.-,-.-E-.-.-E-,-.-.-:-,-.~H~X~X-X-.-.-.-.-.-X-X---------------------------------------------------------------,-X-<-.-.-.-,-,-,-,-.-.-W-,-,~.-E-,-X~----
X~.~,~,~E-,-,-,-X-----,-X-,-,-.-.-.-.-,-,-,-,-.-,-.-,-X-X-X-.-.-.-.-.-X-X---------------------------------------------------------,-,-,-,-X-.-:-.-.-.-.-.-.-.-.-.-,-,~,-,-,-X~----
X~X~X~X-X-X-X-X-X-----,-X-X-X-X-X-.-.-X-X-X-X-X-X-X-X-,-X-,-.-.-.-.-,-,-X-------------------------------------------------------,-,-X-X-X-X-.-.-.-.-.-.-.-.-.-.-.-,-.~.~X~X~X~----
----,-X-X-X-X-X---------,-X-X-,-X-E-.-X---------------,-X-:-A-,-,-,-A-:-X-------------------------------------------------------,-X-X-.-.-,-.-.-.-.-.-:-.-.-.-.-.-,-.~X~.~X~X~----
------------------------------,-X-.-.-X-----------------,-X-X-X-+-X-X-X---------------------------------------------------------,-X-,-<-.-,-.-.-.-.-.-.-.-:-.-.-.-,-.~X~X~X~X~,-,-
------------------------------,-X-X-.-X-------------------,-X-.-.-,-X-----------------------------------------------------------,-X-X-.-.-,-.-.-.-.-.-.-.-.-.-.-.-,-,~,~,~,~X-X-X-
------------------------------,-X-X-.-X-------------------,-X-.-.-,-X-------------------------------------------------------------,-X-X-X-X-.-.-.-.-.-.-.-.-.-.-.-,-,~.-.-,-.-.-X-
------------------------,-,-,-,-X-.-.-X-,-,-----------,-,-,-X-.-.-,-X-,-----------------------------------------------------------------,-X-<-,-,-,-,-,-,-,-,-,-,-,-,~.-E-,-X-X-X-
----------------------,-,-X-X-X-X-.-.-X-X-X-,---------,-X-X-X-,-,-,-X-X-,---------------------------------------------------------------,-X-,-,-,-.-.-.-.-,-,-,-,-X-X~X-X-X-X~----
----------------------,-X-X-,-,-.-E-.-.-,-,-X---------,-X-.-.-.-.-.-.-A-X---------------------------------------------------------------,-X-X-X-,-A-,-A-,-A-,-.-X-X---------------
----------------------,-X-X-,-.-.-.-.-.-,-<-X---------,-X-.-.-.-E-,-,-,-X---------------------------------------------------------------,-X-X-X-,-<-,-.-,-,-,-X-X-X---------------
----------------------,-X-X-:-,-.-.-.-,-,-W-X-,-,-,-,-,-X-.-.-,-,-.~.~A~X~--------------------------------------------------------------,-X-X-X-,-,-X-X-X-,-.-X-X-X---------------
------------------------,-X-,-,-,-,-,-,-.-.-X-X-X-X-X-X-X-.-.-,-.~.~.~.~X~----------------------------------------------------------------,-X-X-X-X-X-X-X-X-X-X-X-----------------
------------------------,-X-X-.-.-.-.-.-.-.-,-.-.-+-.-.-,-.-:-,-.~,~X~X~X~,-------------------------------------------------------------------------------------------------------
------------------------,-,-X-.-.-.-.-.-.-.-,-.-.-+-.-.-,-.-.-,-.~X~,-,-X~X~------------------------------------------------------------------------------------------------------
------------------------,-X-X-.-.-.-.-.-.-.-,-,-,-+-,-.-,-,-E-,-.~X~X-------------------------------------------------------------------------------------------------------------
----------------------,-,-X-.-E-.-.-W-.-.-A-X-X-X-X-X-X-X-,-.~.~.~,~X-------------------------------------------------------------------------------------------------------------
----------------------,-X-X-,-,-,-,-,-,-,-.-X---------,-X-,-.~.~.~X~X-------------------------------------------------------------------------------------------------------------
----------------------,-X-X-,-.~.~.~.~.~,~A-X---------,-X-X-X~X~X~X~--------------------------------------------------------------------------------------------------------------
------------------------,-X-X-X~X~X~X~X~X~X-X-----------,-X---,-X-----------------------------------------------------------------------------------------------------------------
--------------------------------,-X~X~--------------------------------------------------------------------------------------------------------------------------------------------
--------------------------------,-X~X~--------------------------------------------------------------------------------------------------------------------------------------------
