--------------------------------------------------X-X:X:X:X-X6X6X6X-X-X-X-X-X-X1X1X1X-X<X<X<X<------------------------------------------
--------------------------------------------------X-t:+Yt:X-t6+^t6X-.-X-X-X-X-t1E-t1X-t<+]t<X<------------------------------------------
--------------------------------------------------X-t:t:t:X-t6t6t6X-.-X-X-X-X-t1t1t1X-t<t<t<X<------------------------------------------
--------------------------------------------------X-X-X-X-X-X-X-X-X-.-.-.-.-X-X-X-X-X-X-X-X-X-------------------------------------------
--------------------------------------------------,-,-,-,-,-,-,-X-X-.-.-.-.-X-X---------------------------------------------------------
--------------------------------------------------,-X-X-X-X-X-X-X-.-E-.-.-E-,-X-X-X-X-X-X-X---------------------------------------------
--------------------------------------------------,-X-.-.-.-.-,-,-.-.-.-.-.-,-,-----------X---------------------------------------------
--------------------------------------------------,-X-.-.-.-.-E-,-.-.-.-.-.-,-,-----------X---------------------------------------------
--------------------------------------------------,-X-.-.-.-.-,-,-.-E-.-.-E-,-,-E---------X---------------------------------------------
--------------------------------------------------,-X-.-.-.-.-,-X-.-.-.-.-.-,-X-----E-----X---------------------------------------------
--------------------------------------------------,-X-.-E-.-E-.-X-.-.-.-.-.-,-X-E-,-,-,-,-X---------------------------------------------
--------------------------------------------------,-X-X-,-,-,-X-X-.-E-.-.-E-,-X-X-,-,-,-X-X-,-,-,-,-------------------------------------
--------------------------------------------X-X-X-X-X-.-.-.-.-.-.-.-.-.-.-.-.-.-.-.-.-.-.-X-X-X-X-X-------------------------------------
--------------------------------------------X-H-E-,-.-E-.-.-.-.-.-.-.-.-.-.-.-.-.-.-.-.-E-,-,-E-H-X-------------------------------------
--------------------------------------------X-----,-.-.-.-.-.-.-.-.-.-.-.-.-.-.-.-.-.-.-.-,-,-.-.-X-------------------------------------
--------------------------------------------X-E-E-,-.-.-.-.-.-.-.-.-.-.-.-.-.-.-.-.-.-.-.-,-,-E-E-X-------------------------------------
--------------------------------------------X-E-E-,-.-.-.-.-.-.-.-.-.-.-.-.-.-.-.-.-.-.-.-,-,-E-E-X-------------------------------------
--------------------------------------------X-----,-.-.-.-.-.-.-.-.-.-.-.-.-.-.-.-.-.-.-.-,-,-.-.-X-------------------------------------
----------------------------------,-,-,-,-,-X-X-X-X-X-.-.-.-.-,-,-,-,-,-,-,-,-.-.-.-.-.-.-X-X-X-X-X-------X-----------------------------
----------------------------------,-X-X-X-X-X-X-X-X-X-.-.-.-.-,-,-,-.-.-,-,-,-.-.-.-.-.-.-X-,-,-,---X-X-X---X-X-------------------------
----------,-,-,-,-,-,-,-,-,-,-,-,-,-X-.-.-E-E-.-.-X-X-.-.-.-.-,-.-,-.-<-,-.-,-.-.-.-.-.-.-X-,-X-X-X-----,-,-,-X-X-----------------------
----------,-X-X-X-X-X-X-X-X-X-X-X-X-X-,-,-,-,-.-E-X-X-.-.-.-.-,-.-,-,-,-,-.-,-.-.-.-.-.-.-X-,-X-,-------,-.-.-,---X---------------------
----------,-X-<-.-.-.-.-.-.-.-.-.-,-,-.-.-.-B-.-.-X-X-.-.-.-.-,-.-.-.-A-.-.-,-.-.-.-.-.-,-X-,-X-,-------,-,-t:,-----X-------------------
----------,-X-<-<-.-.-.-.-.-.-.-.-.-,-.-.-.-,-.-.-X-X-.-.-.-.-,-.-.-.-.-.-.-,-.-.-.-.-.-,-X-X9X-,---------------------X-X-X-------------
----------,-X-<-.-.-,-,-,-,-,-.-.-.-,-.-.-.-,-.-.-X-X-.-.-.-.-,-.-.-.-E-.-.-,-.-.-.-.-.-,-.-E9.-,---------------------------X-X---------
----------,-X-X-X-X-X-X-,-,-X-X-X-X-X-.-.-.-,-.-.-X-X-.-.-.-.-,-.-.-.-.-.-.-,-.-.-.-.-.-,-.-,9.-,-----------------------E-------X-X-----
------------,-,-X-X-X-X-,-,-X-X-X-X-X-,-.-.-,-.-.-X-X-.-.-.-.-,-.-.-.-.-.-.-,-.-.-.-.-.-,-.-,9.-,-----------------------------------X---
----,-,-----,-X-X-,-,-.-.-.-,-.-.-.-X-,-,-,-,-X-X-X-X-.-.-.-.-,-A-.-.-.-.-,-A-.-.-.-.-.-,-.-K9.-,-----------------------X-X-X-------X---
,-,-,-X-,-,-,-X-.-.-,-,-,-,-,-.-.-,-X-,-.-,-,-X---,-X-.-.-.-.-,-X-X-,-,-,-X-X-.-.-.-.-.-,-.-,9.-,---,-,-,-,-----------X-------X-------X-
,-X-X-.-X-X-X-X-.-.-.-.-.-.-.-.-.-,-X/,/,/,/./X/--,-X-.-.-.-.-X-,-X-.-.-,-X-,-X-.-.-.-.-,-.-,9.-,-,-,-,-.-X-X-X-X-X-X-X-------X-------X-
X-X-.-.-.-.-.-,-.-.-.-.-.-.-.-.-.-,-X-.-.-.-,-X---,-X-.-.-.-.-X1X1X1,-,-,-X1X1X1.-.-.-.-,-.-,9.-,-,-,-,-,-X---------------------X-----X-
X-.-.-.-.-.-.-,-.-.-.-.-.-.-.-.-.-,-.-.-.-.-,-X---,-X-.-.-.-.-,-E-.1.1.1,1.-E-.-.-.-.-.-,-.-E9,-,-.-,-.-,-X---------------------X-----X-
X-.-.-.-.-.-.-,-.-.-.-.-.-.-.-.-.-,-.-.-.-.-,-X---,-X-.-.-.-.-,-,-.1.1t1,1.-.-.-.-.-.-.-,-X-X9X-.-A-,-,-X-----X-X-----X---------X-----X-
X-X-.-.-.-.-.-,-.-.-.-.-.-.-.-.-.-,-.-.-.-.-,-X---,-X-.-.-.-.-X-X-X1,1,1,1X-X-X-X-,-,-,-,-X-,-X-,-,-X-X-X-X-X-----X-X---X-X-X-X-----X---
--,-X-.-.-.-.-,-.-.-.-.-.-.-.-.-.-,-X-.-.-.-,-X---,-X-.-.-.-.-X-.-.-.-.-.-.-.-X6X-,-,-,-,-X-,-X-X-X-,-------------------------------X---
--,-X-X-.-.-.-,-,-.-.-.-.-.-.-.-.-,-X-.-.-.-,-X---,-X-.-.-.-.-X-.-.-.-.-.-.-.-X6X-,-,-,-,-X-,-X-X-.-,-,---------------------------X-----
----,-X-X-.-.-.-,-.-.-.-.-.-.-.-.-,-X-.-.-.-,-X---,-X-.-.-.-.-X-.-.-.-.-.-.-.-X6X-,-,-,-,-X---X-X-.-.-,-,-,-----------------------X-----
------,-X-X-.-,-,-.-.-.-E-.-E-.-.-,-.-.-.-.-,-X---,-X-.-.-.-.-X-.-.-.-.-.-.-.-X-X-,-,-,-,-X---X-.-.-.-.-.-,-E-,-------------------X-----
----------,-X-X-.-.-.-.-.-.-.-.-.-,-.-.-E-.-E-X---,-X-.-.-.-,-X-.-.-.-.-.-.-.-X-X-.-.-.-.-X---X-.-.-.-.-.-.-.-,---E---------------X-----
------------,-X-.-.-.-.-.-.-.-.-.-,-.-.-.-.-,-X---,-X-.-.-.-,-X-.-.-.-.-.-.-E-X-X-E-.-E-E-X---X-.-.-.-.-.-.-.-,-,-----------------X-----
------------,-X-X-.-.-.-.-.-.-,-,-,-X-,-E-,-E-X---,-X-,-,-,-,-,-.-.-.-.-.-.-.-X-X-.-.-.-.-X---X-.-.-.-.-.-.-.-.-,-,---E-----------X-----
----------------X-X-.-.-.-.-.-X-X-X-X-.-.-.-.-X---,-X-.-.-,-,-,-.-.-.-.-.-.-E-X-X-E-.-E-E-X---X-A-.-.-.-.-.-.-.-.-,-,-------------X-----
----------------,-X-.-.-.-.-.-X---,-X-,-,-,-,-X---,-X-,-,-,-,-,-.-.-.-.-.-.-.-X-X-X-K-,-X-X---X-A-.-.-.-.-.-.-.-.-.-,-,---E-------X-----
----------------,-X-E-.-E-E-E-X---,-X-.-.-.-.-X---,-X-.-.-.-,-,-.-.-.-.-.-.-B-X-,-X-.-.-X-,---X-.-.-.-.-.-.-.-.-.-.-.-,-,---------X-----
----------------,-X-E-.-E-E-E-X---,-X-.-.-.-.-X-,-,-X-A-.-.-A-X-.-.-.-.-.-.-.-X-X-X-,-,-X-X-,-X-,-,-,-.-.-.-.-.-.-.-.-.-,-,-------X-----
----------------,-X-X-X-X-X-X-X-----,-X-.-.-.-.-X-,-X-X-X-X-X-X-.-.-.-.-.-.-.-.-E-E-.-.-,-X-,-X-,-,-,-.-.-.-.-.-.-.-.-.-.-,-------X-----
--------------------------------------X-.-.-.-.-.-X-X-X-X-X-X-X-.-.-.-.-.-.-.-.-.-.-.-.-,-X-X-X-,-,-,-.-.-.-.-.-.-.-.-.-.-,-,-----X-----
--------------------------------------,-X-.-.-.-.-.-.-,---E-,-E-.-.-.-.-.-.-.-.-.-.-.-.-,-.-+-.-,-,-,-.-.-.-.-.-.-.-.-.-.-.-,-----X-----
----------------------------------------,-X-.-.-.-.-,-,-----,-.-.-.-.-.-.-.-.-.-.-.-.-.-,-.-+-.-,-,-,-.-.-.-.-.-.-.-.-.-.-.-,-----X-----
------------------------------------------,-X-X-.-.-,-------,-.-.-.-.-.-.-.-.-.-.-.-.-.-,-.-+-.-,-,-,-.-.-.-.-.-.-.-.-.-.-.-,-------X---
--------------------------------------,-,-,-,-,-X-X-X-,-,-E-,-E-.-.-.-.-.-.-.-.-.-.-.-.-,-X-X-X-,-,-,-.-.-.-.-.-.-.-.-.-.-.-,-------X---
------------------------------------,-,-X-X-X-X-X-X-X-X-X-X-X-X-.-.-.-.-.-.-.-.-.-.-.-.-.-X-,-X-,-,-,-.-.-.-.-.-.-.-.-.-.-.-,-----X-----
----------------------------------,-,-X-X-.-.-.-.-.-.-.-.-.-H-X-.-.-.-.-.-.-.-.-.-.-.-.-.-X---X-,-,-,-.-.-.-.-.-.-.-.-.-.-.-,-,-X-------
----------------------------------,-X-.-.-.-.-.-.-.-.-.-.-E-A-X-.-.-.-.-,-,-,-X-X-,-,-,-X-X-,-X-,-,-.-.-.-.-.-.-.-.-.-.-.-.-.-,-X-------
----------------------------------,-X-,-.-.-.-.-.-.-.-.-.-.-.-,-.-.-.-,-,-,-t<X-X6.6.6.6X6--,-X-.-,-.-.-.-.-.-.-.-.-.-.-.-.-.-X---------
------------------------------------,-X-,-.-.-.-.-.-.-.-.-E-.-,-.-.-,-B-,5,5.-X-X6,6t6,6X6,-,-X-E-,-H-.-.-.-.-.-.-.-.-.-.-.-,-X---------
----------------------------------,-,-X-,-.-.-.-.-.-.-.-.-.-.-,-.-.-,-.-.-,-,-X-X-.-.-.-X6X6X6X-.-,-,-.-.-.-.-.-.-.-.-.-.-W-X-----------
----------------------------------,-X-.-,-.-.-.-.-.-.-.-,-,-.-,-.-.-,-.-E-,-,-X-.-.-.-.-.-H-X-X-E-,-E-.-.-.-.-.-.-.-.-.-B-X-X-----------
--------------------------------,-,-X-.-,-,-.-.-.-.-.-,-,-,-,-X-.-.-,-.=.=,=,-X-.-.-.-.-.-,-X-X-,-.-E-,-,-.-.-.-.-.-.-.-.-X-X-----------
--------------------------------,-X-.-.-.-,-.-.-.-.-.-,-.-,-.-X-.-.-,-.5.5,5E-X-,-.-.-.-.-,-X-X-,-.-.-.-,-,-.-.-.-.-E-.-E-,-X-----------
--------------------------------,-X-.-.-.-,-.-.-.-.-.-,-.-,-,-X-E-.-E-,5,5,5,-X-,-.-.-.-.-,-X-X-,-,-,-.-.-,-.-.-.-.-.-.-.-,-X-----------
--------------------------------,-X-.-.-.-,-.-.-.-.-.-,-.-,-,-.-.-.-,-,5.-,-,-X-,-,-.-.-.-.-X-X-.-,-E-.-E-,-,-,-.-.-E-.-.-,-X-----------
--------------------------------,-X-.-.-.-,-.-.-.-.-.-,-.-,-,-,-E-.-E-,-,-,-,-X>,>,>,>,-X-X-X-X-.-.-,-,-,-.-.-,-,-,-,-,-,-,-X-----------
--------------------------------,-X-.-.-.-,-.-.-.-.-.-,-.-,-.-X-H-.-,-.-E-,-,-X-E-.-,-W-X---,-X-<-.-.-,-E-.-E-,-H-,---------X-----------
--------------------------------,-X-,-.-.-,-,-.-.-.-.-,-,-,-,-X-X-X-X-X-X-X-X-X-X-X-X-X-X---,-X-X-X-X-X-X-X-,-,-,-X-X-X-X-X-X-----------
----------------------------------,-X-.-.-.-,-,-.-.-.-.-.-.-,-X-X-X-X-X-X-X-X-X---X-X-----------------,-X-W-,-,-.-.-,-X-----------------
----------------------------------,-X-,-.-.-.-,-,-,-.-.-.-.-.-.-.-.-.-.-.-.-B-X-,-X-X-,-,-,-,-,-------,-X-.-.-.-.-.-,-X-----------------
----------------------------------,-X-,-.-.-.-.-.-,-,-.-.-.-.-.-.-.-.-.-.-.-,-X-X-X-X-X-X-X-X-X-,-,-,-,-X-.-.-.-.-.-,-X-,-,-,-,---------
----------------------------------,-X-,-,-.-.-.-.-.-,-.-.-.-.-.-.-.-.-.-E-.-E-X-X-:-.-.-.-.-,-X-X-X-X-X-X-.-.-.-.-,-,8X8X-X-X-X---------
----------------------------------,-X-,-,-.-.-.-.-.-,-,-.-.-.-.-.-.-.-.-.-.-,-XRX-.-.-E-.-.-,-,-,-.-,-,-.-.-.-.-.-,-.8,7.-.-+X>---------
----------------------------------,-X-,-,-,-.-.-.-.-.-,-,-,-.-.-.-.-.-.-E-.-E-+R.-.-.-.-.-.-,-,-,-.-,-,-.-<-.-.-.-,-.8,7.-E-.->---------
----------------------------------,-X-.-,-,-,-.-.-.-.-.-.-,-,-,-.-.-.-.-E-.-E-XRX-:-.-E-.-.-,-X-X-X-X-X-X-.-.-.-,-,-,8X8X-X-XX>---------
----------------------------------,-X-.-,-.-,-.-.-.-.-.-.-.-.-,-,-.-.-.-.-.-,-X-X-X-X-X-X-X-X-X-------,-X-,-,-,-,-----X-----------------
----------------------------------,-X-.-,-,-,-,-,-,-,-.-.-.-.-.-,-.-.-.-.-.-B-X-----------------------,-X-.-,-,-,-,---X-----------------
----------------------------------,-X-W-.-.-,-,-,-.-,-,-,-.-.-.-,-.-.-.-.-.-X-X-------------------------X-W-.-.-.-,-,-X-----------------
----------------------------------,-X-.-A-H-.-.-,-,-.-.-,-,-.-.-,-.-.-.-.-,-X---------------------------X-XW+W+W+WX-X-X-----------------
------------------------------------,-X-X-X-X-X-X-X-X-X-X-X-X-X-X-X-X-.-,-X-----------------------------,-X-.-.-.-X---------------------
--------------------------------------------------------------------,-X-X-------------------------------,-X-E-.-E-X---------------------
--------------------------------------------------------------------------------------------------------,-X-.-.-.-X---------------------
--------------------------------------------------------------------------------------------------------,-X-E-.-E-X---------------------
--------------------------------------------------------------------------------------------------------,-X-X8X8X8X---------------------
