------------------------,-,-X-,-,-----------------------------------------------------------------------------------------------------------------------------------------------------------------------------------
--------------------,-,-,-X-.-X-X-,-,-------------------------------------------------------------------------------------------------------------------------------------------------------------------------------
------------------,-,-X-X-.-.-.-.-X-X-,-,-,-------------------------------------------------------------------------------------------------------------------------------------------------------------------------
----------------,-,-X-.-.-.-.-.-.-.-,-X-X-X-,-,---------------------------------------------------------------------------------------------------------------------------------------------------------------------
------------,-,-,-X-.-.-.-.-.-,-,-,-,-.-,-,-X-X-,-,-----------------------------------------------------------------------------------------------------------------------------------------------------------------
----------,-,-X-X-.-.-.-.-,-,-,-.-.-.-.-.-,-,-.-X-X-,-,-------------------------------------------------------------------------------------------------------------------------------------------------------------
--------,-,-X-.-.-.-,-,-,-,-.-.-.-.-.-.-.-.-,-,-.-.-X-X-------------------------------------------------------------------------------------------------------------------------------------------------------------
----,-,-,-X-.-,-,-,-,-.-.-.-.-.-.-.-.-.-.-.-.-,-,-.-.-X-----------------------,-,-,-,-------------------------------------------------------------------------------------------------------------------------------
--,-,-X-X-,-,-,-,-,-,-,-.-.-.-.-.-.-.-.-.-.-.-.-,-.-,-X-----------------------,-X:X:X:------------------------------------------------------------------------------------------------------------------------------
,-,-X-,-,-,-.-.-,-.-.-,-,-.-.-.-.-.-.-.-.-.-.-.-,-.-X-------------------------,-X-.-X-------------------------------------------------------------------------------------------------------------------------------
,-X-,-.-.-,-,-,-,-.-.-.-,-,-,-,-,-,-.-.-.-.-.-.-,-.-X-------------------------,-X-.-X-------------------------------------------------------------------------------------------------------------------------------
,-X-.-.-,-,-.-.-.-.-.-,-,-,-.-.-.-,-,-,-,-.-.-.-,-.-X-----------,-,---,-,-,-,-,-X-+VX-,-,-,-,-,-,-------------------------------------------------------------------------------------------------------------------
,-X-.-.-,-.-.-.-.-.-.-,-,-.-X-X-.-.-.-.-,-.-.-,-,-.-X-------,-,-X/X/,-,-X-X-X-X-X-.-X-X-X-X-X-,-X0,-,---------------------------------------------------------------------------------------------------------------
,-X-.-,-,-.-.-.-.-.-,-,-.-.-X-X-.-.-.-X-X-,-.-,-.-,-X-------,-X/,.X-X-X-.-.-.-.-.-.-.-.-.-.-.-X-X-X0X0--------------------------------------------------------------------------------------------------------------
,-X-.-,-.-.-.-.-.-,-,-,-.-.-.-.-.-.-.-X-X-,-.-,-.-X-------,-,-X-X-.-.-.-.-.-.-.-.-.-.-.-.-.-.-.-,-,-X-,-,-----------------------------------------------------------------------------------------------------------
,-X-.-,-.-.-.-.-.-,-,-.-.-.-,-,-,-,-.-.-.-,-.-,-.-X-----,-,-X-X-.-.-.-.-.-.-.-.-.-.-.-.-.-.-.-.-.-.-.-X-X-,---------------------------------------------------------------------------------------------------------
,-X-.-,-,-.-.-.-,-,-,-.-.-.-,->->->-.-.-.-,-,-,-.-X---,-,-X-.-.-.-.-.-.-.-.-.-.-.-.-.-.-.-.-.-.-.-.-.-.-.-X---------------------------------------------------------------------------------------------------------
,-X-.-.-,-.-.-.-,-,-,-.-.-.-,->-.->-.-.-.-.-,-,-.-X-,-,-X-.-.-.-.-.-.-.-.-.-.-.-.-.-.-.-.-.-.-.-.-.-.-.-.-X-,-,-----------------------------------------------------------------------------------------------------
,-X-.-.-,-,-.-,-,-,-,-X-X-.-,->->->-.-.-X-X-,-,-,-X-X5X-X-.-.-.-.-.-.-.-.-.-.-.-.-.-.-.-.-.-.-.-.-.-.-.-.-,-X-X5,---------------------------------------------------------------------------------------------------
,-X-.-.-.-,-,-,-,-.-.-X-X-.-.-.-.-.-.-.-X-X-.-,-X-,-X5X-.-.-.-.-.-.:.-.-.-.-.-.-.-.-.-.:.-.-.-.-.-.-.-.-.-,-X-,-X5--------------------------------------------------------------------------------------------------
X-,-.-.-.-.-,-,-.-.-.-.-,-.-.-.-.-.-.-.-,-,-.-,-X-X5X-.-.-.-.-.-.-.:.-.-.-.-.-.-.-.-.-.:.-.-.-.-.-.-.-.-.-,-,-,-X5--------------------------------------------------------------------------------------------------
X-,-.-.-.-,-,-.-.-.-.-.-,-,-X-X-.-.-,-,-,-.-,-,-X-,-X-.-.-.-.-.-.-.-.-.-.-.:.-.-.-.-.-.-.-.-.-.-.-.-.-.-.-.-,-X-,---------------------------------------------------------------------------------------------------
X-,-.-.-,-,-.-.-.-.-.-.-.-,-X-X-,-,-,-.-.-.-,-.-X-,-X-.-.-.-.-.-.-.-.-.-.-.:.-.-.-.-.-.-.-.:.-.-.-.-.-.-.-.-.-.-X---------------------------------------------------------------------------------------------------
X-,-.-,-,-X-.-.-.-.-.-.-,-,-,-,-.-.-.-.-.-.-,-,-X-X-.-.-.-.-.-.-.-.-.-.-.-.-.-.-.-.-.-.-.-.:.-.-.-.-.-.-.-.-.-.-X-,-,-,-,-,-,-,-,-,-,-,-,-,-,-,-,-,-,-,-,-,-,-,-,-,-,-,-,-,-,-,-,-,-,-,-,-,-,-,-,-,-,-,-,-,-,-,-----
X-,-.-,-X-X-.-.-.-.-.-.-,-.-.-.-.-.-.-.-.-.-,-X-,-X-.-.-.-.-.-,-,-,-,-.-.-.-.-.-.-.-.-.-.-.-.-.-.-.-,-,-,-,-.-.-,-X-X-X-X-X-X-X-X-X-X-X-X-X-X-X-X-X-X-X-X-X-X-X-X-X-X-X-X-X-X-X-X-X-X-X-X-X-X-X-X-X-X-X-X-X-X-X-----
X-,-.-,-.-.-.-.-.-.-.-,-,-.-.-.-.-.-.-.-.-.-,-X-X-X-.-.-.-.-,-,-,-,-,-,-.-.-.-.-.-.:.-.-.-.-.-.-.-,-,-.-.-,-,-.-,-.-,-,-,-,-,-,-,-,-,-,-,-,-,-,-.-,-,-,-,-,-,-.-,-,-.-.-.-,-.-,-,-,-,-,-,-,-,-,-,-,-.-.-.-.-.-X-----
X-,-.-,-.-.-.-.-.-.-X-,-.-.-X-X-X-X-X-X-X-X-X-X-X-X-.-.-.-.-,-,-.-.-,-,-,-.-.-.-.-.:.-.-.-.-.-.-.-,-.-.-.-.-,-,-,-.-,-,-.-.-.-.-.-.-.-.-.-.-,-,-.-,-,-.-,-,-,-.-,-,-.-.-.-,-.-,-,-.-.-.-.-.-.-.-.-,-.-.-.-.-.-X-----
X-,-,-,-X-.-.-.-.-.-X-X-.-.-X-XEX-X-X-X-X-X-X-X[X[X-.-.-.-.-,-.-.-.-.-,-,-.-.-.-.-.-.-.-.-.-.-.-.-,-.-.-.-.-.-,-,-,-,-,-.-,-,-,-,-,-,-,-,-,-,-,-.-,-,-.-,-,-,-.-,-,-.-.-.-,-.-,-,-,-,-,-,-,-,-,-,-,-.-.-.-.-.-X-----
X-.-,-,-X-.-.-.-.-X-X-.-.-,-X-XE,-,-,-,-.-.-,-+[+[,-.-.-.-.-,-.-.-E-.-,-,-.-.-.-.-.-.-.-.-.-.-.-.-,-.-.-E-.-.-,-,-H-,-,-.-,-,-,-,-,-,-,-,-,-,-,-.-,-,-.-,-,-,-.-,-,-.-.-.-,-.-,-,-,-,-,-,-,-,-.-,-,-.-.-.-.-.-X-,-,-
X-.-,-,-X-.-.-.-.-X-X-.-.-,-X-XE,-,-,-XEX-X-X-X-X-X-.-.-.-.-,-,-.-.-,-,-,-.-.-.-.-.-.-.-.-.-.-.-.-,-.-.-.-.-,-,-,-.-,-,-.-,-,-.-.-.-.-.-.-.-.-.-.-,-,-.-,-,-,-.-,-,-.-.-.-,-.-.-.-.-.-.-.-.-,-.-,-,-.-.-.-.-.-X-X-X-
X-.-,-,-,-.-.-.-.-.-X-,-,-,-X-X-.-.-X-X-X-X-X-X-X-X-.-.-.-.-,-,-,-,-,-,-.-.-.-.-.-.-.-.-.-.-.-.-.-,-,-,-,-,-,-.-,-.-,-,-.-,-,-,-,-,-,-,-,-,-,-,-,-,-,-.-,-,-,-.-,-,-.-.-.-,-,-,-,-,-,-,-,-,-,-.-,-,-.-.-.-.-.-+-<-X-
X-.-,-.-,-.-.-.-.-.-X-X-,-X-X-.-.-.-.-X-.-.-,-.-X-X-.-.-.-.-.-.-.-.-.-.-.-.:.-.-.-.-.-.-.-.-.-.-.-.-.-.-.-.-.-.-,-.-,-,-.-,-.-.-.-.-.-.-.-.-.-.-.-.-,-.-,-.-.-.-,-,-.-.-.-.-.-.-.-.-.-.-.-.-.-.-,-,-.-.-.-.-.-X-X-X-
X-.-,-.-,-.-.-.-.-.-.-X-X-X-.-.-.-,-X-,-.-,-,-.-X-X-.-.-.-.-.-.-.-.-.-.-.-.:.-.-.-.-.-.-.-.-.-.-.-.-.-.-.-.-.-.-,-X-X-X-X-X-X-X-X-X-X-X-X-X-X-X-X-X-X-X-X-X-X-X-X-X-X-X-X-X-X-X-X-X-X-X-X-X-X-X-X-X-X-X-X-X-X-X-----
X-.-,-.-,-X-.-.-.-.-.-.-.-.-.-.-.-X-,-X-.-,-.-.-X-X-.-.-.-.-.-.-.-.-.-.-.-.-.-.-.-.-.-.:.-.-.-.:.-.-.-.-.-.-.-.-X---------------------------------------------------------------------------------------------------
,-X-,-.-.-,-X-.-.-.-.-.-.-.-.-.-.-,-X-.-,-,-.-,-X-,-X-.-.-.-.-.-.-.-.-.-.-.-.-.-.-.-.-.:.-.-.-.:.-.-.-.-.-.-,-,-X---------------------------------------------------------------------------------------------------
,-X-,-.-.-,-X-,-.-.-.-.-.-.-.-.-,-,-.-.-,-.-.-X-,-X0X0,-.-.-.-.-.-.-.-.-.;.:.-.-.-.-.-.-.-.-.-.-.-.-.-.-.-,-,-X-X2--------------------------------------------------------------------------------------------------
,-X-,-.-.-.-.-,-,-X-X-.-.-.-X-X-,-.-.-,-,-.-.-X---X1,0,-.-.-.-.-.-.-.-.-.;.:.-.-.-.-.-.-.-.-.-.-.-.-.-.-.-,-,-X2,---------------------------------------------------------------------------------------------------
,-X-,-.-.-.-.-.-,-X-,-X-,-,-X-X-X-.-.-,-.-.-.-X---,-X0X0.-.-.-.-.-.-.-.-.-.-.-.-.-.:.-.-.-.-.-.-.-.-.-.-.-,-X-X2----------------------------------------------------------------------------------------------------
,-X-,-.-.-.-.-.-.-.-X-X-.-.-.-.-.-.-,-,-.-.-.-X-------,-X-.-.-.-.-.-.-.-.-.-.-.-.-.:.-.-.-.-.-.-.-.-.-.-.-,-X-------------------------------------------------------------------------------------------------------
,-X-,-.-.-.-.-.-.-.-.-.-.-.-.-.-.-.-,-.-.-,-X-X-------,-X-.-.-.-.-.-.-.-.-.-.-.-.-.-.-.-.-.-.-.-.-.-.-.-.-X---------------------------------------------------------------------------------------------------------
,-X-,-.-.-.-.-.-.-.-.-.-.-.-.-.-,-,-,-,-X-X-------------,-X-X-,-,-.-.-.-.-.-.-.-.-.-.-.-.-.-.-.-.-,-,-,-X-X---------------------------------------------------------------------------------------------------------
,-X-,-.-.-.-.-.-.-.-.-.-,-,-,-,-,-,-X-X---------------------,-X-X-,-,-.-.-.-.-.-.-.-.-.-.-.-.-,-,-,-X-X-------------------------------------------------------------------------------------------------------------
--,-X-.-.-.-.-.-,-,-,-,-,-.-.-,-X-X-------------------------,-X3X4,-X-.-.-.-.-.-.-.-.-.-.-.-.-,-X-,-X3--------------------------------------------------------------------------------------------------------------
--,-X-.-,-,-,-,-,-.-.-.-.-,-X-X-------------------------------,-,-X3,-X-X-.-.-.-.-.-.-.-.-,-X-X-X3X3----------------------------------------------------------------------------------------------------------------
--,-X-,-,-.-.-.-.-.-.-,-X-X---------------------------------------------,-X-X-X-X.X.X.X-X-X-------------------------------------------------------------------------------------------------------------------------
--,-X-X-X-X-.-.-.-,-X-X---------------------------------------------------------------------------------------------------------------------------------------------------------------------------------------------
----------,-X-X-X-X-------------------------------------------------------------------------------------------------------------------------------------------------------------------------------------------------
