--------,-,-,-X-X-X-X-X-X-X-X-X-,-,---------------------------------------------------------------------------------------------------------------------------------------------------------
--------,-X-X-X-,-,-,-,-,-,-,-X-X-X---------------------------------------------------------------------------------------------------------------------------------------------------------
--------,-X-,-,-,-,~,~,~,~,~,-,-.-X---------------------------------------------------------------------------------------------------------------------------------------------------------
--------,-X-,-,-,~,~>~>~>~.~,~,-.-X---------------------------------------------------------------------------------------------------------------------------------------------------------
--------,-X-,-.-,-.~,~,~,~,~,~,-.-X---------------------------------------------------------------------------------------------------------------------------------------------------------
--------,-X-,-.-,-.~,~,~,~,~,~,-.-X---------------------------------------------------------------------------------------------------------------------------------------------------------
--------,-X-,-,-,-,~,~,~,~,~,~,~.-X---------------------------------------------------------------------------------------------------------------------------------------------------------
--------,-X-,-,-,~,~.~,~,~.~,~,~.-X---------------------------------------------------------------------------------------------------------------------------------------------------------
--------,-X-,-,-,~,~,~,~,~.~,~,-.-X---------------------------------------------------------------------------------------------------------------------------------------------------------
--------,-X-,-,-.~,~,~,~,~.~,~,-.-X---------------------------------------------------------------------------------------------------------------------------------------------------------
--------,-X-,-,-.~,~,~,~,~,~,~,-.-X---------------------------------------------------------------------------------------------------------------------------------------------------------
--------,-X-,-,-,-,~,~,~,~,~,~,-.-X---------------------------------------------------------------------------------------------------------------------------------------------------------
--------,-X-,-.-,-,~.~,~,~,~,~,-.-X---------------------------------------------------------------------------------------------------------------------------------------------------------
--------,-X-,-.-.-,-,~,~.~,~,~,-.-X---------------------------------------------------------------------------------------------------------------------------------------------------------
--------,-X-X-.-.-.-.-,-,~,-.-,-X-X---------------------------------------------------------------------------------------------------------------------------------------------------------
----------,-X-X-X-X-.-.-.-X-X-X-X-----------------------------------------------------------------------------------------------------------------------------------------------------------
----------------,-X-.-.-.-X-----------------------------------------------------------------------------------------------------------------------------------------------------------------
----------------,-X-.-.-.-X-----------------------------------------------------------------------------------------------------------------------------------------------------------------
----------------,-X-.-.-.-X-----------------------------------------------------------------------------------------------------------------------------------------------------------------
----------------,-X-.-.-.-X-----------------------------------------------------------------------------------------------------------------------------------------------------------------
----------------,-X-.-.-.-X-----------------------------------------------------------------------------------------------------------------------------------------------------------------
----------------,-X-.-.-.-X-----------------------------------------------------------------------------------------------------------------------------------------------------------------
----------------,-X-.-.-.-X-----------------------------------------------------------------------------------------------------------------------------------------------------------------
----------------,-X-.-.-.-X-----------------------------------------------------------------------------------------------------------------------------------------------------------------
----------------,-X-.-.-.-X-----------------------------------------------------------------------------------------------------------------------------------------------------------------
----------------,-X-,-,-,-X-----------------------------------------------------------------------------------------------------------------------------------------------------------------
------------,-,-,-XP.P.P.PXP,-,-------------------------------------------------------------------------------------------------------------------------------------------------------------
------------,-X-X-X-,-,-,-X-X-X-------------------------------------------------------------------------------------------------------------------------------------------------------------
------------,-X-.-.-.-.-.-.-,-X-------------------------------------------------------------------------------------------------------------------------------------------------------------
------------,-X-.-,-,-,-,-.-,-X-------------------------------------------------------------------------------------------------------------------------------------------------------------
------------,-X-.-X-X1t1X1X-,-X-------------------------------------------------------------------------------------------------------------------------------------------------------------
------------,-X-.-X-X-.-X-X-,0X-------------------------------------------------------------------------------------------------------------------------------------------------------------
------------,-X-,-X-X-X-X-X-,0X0------------------------------------------------------------------------------------------------------------------------------------------------------------
,-,-,-,-,-,-,-X-.-.-.-.-.-.-.-X-,-,-,-,-,-,-,-----------------------------------------------------------------------------------------------------------------------------------------------
X-X-X-X-X-X-X-X-,-,-,-,-,-,-,-X-X-X-X-X-X-X-X-----------------------------------------------------------------------------------------------------------------------------------------------
X-,-,-,-,-,-,-,-,-,-,-,-,-,-,-,-,-,-,-,-,-.-X-----------------------------------------------------------------------------------------------------------------------------------------------
X-,-.~.~.~.~.~.~.~.~.~.~.~.~.~.~.~.~.~.~,~.-X-----------------------------------------------------------------------------------------------------------------------------------------------
X-,-.~.~.~.~.~.~.~.~.~.~.~.~.~.~.~.~.~.~,~.-X-----------------------------------------------------------------------------------------------------------------------------------------------
X-,-.~.~.~,~,~,~,~,~,~,~,~,~,~,~,~.~.~.~,~.-X-----------------------------------------------------------------------------------------------------------------------------------------------
X-,-.~.~.~,~,-,-,-,-,-,-,-,-,-,-,-.~.~.~,~.-X-----------------------------------------------------------------------------------------------------------------------------------------------
X-,-.~.~.~,~,-X-XJXJXHXHXHXLXLX-,-.~.~.~,~.-X-----------------------------------------------------------------------------------------------------------------------------------------------
X-,-.~.~.~,~,-,-,-,-,-,-,-,-,-,-,-.~.~.~,~,-X-,---------------------------------------------------------------------------------------------------------------------------------------------
X-,-.~.~.~.~.~.~.~.~.~.~.~.~.~.~.~.~.~.~,~,-X-X---------------------------------------------------------------------------------------------,-,-,-,-,-,-------------------------------------
X-,-.~.~.~.~.~.~.~.~.~.~.~.~.~.~.~.~.~.~,~,-.-X---------------------------------------------------------------------------------------------,-X-X-X-X-X-------------------------------------
X-,-.~.~.~.~.~.~.~.~.~.~.~.~.~.~.~.~.~.~,~,-.-X---------------------------------------------------------------------------------------------,-X-.-.-,-X-------------------------------------
X-,-.~.~.~.~.~.~.~,~,~,~,~.~.~.~.~.~.~.~,~,-.-X---------------------------------------------------------------------------------------------,-X-.-.-,-X-------------------------------------
X-,-.~.~.~.~.~.~.~,~tGtGtG.~.~.~.~.~.~.~,~,-.-X-------------------------------------------------------------------,-,-,-,-,-,-,-,-,-,-------,-X-t/t/t/X-------,-,-,-,-,-,-,-,-,-,-----------
X-,-.~.~.~.~.~.~.~,~tGtFtG.~.~.~.~.~.~.~,~,-.-X-----------------------------------------------------------,-,-,-,-,-X-X-X-X-X-X-X-X-X-,-,-,-,-Xd+d+d+dXd,-,-,-,-X-X-X-X-X-X-X-X-X-,-,-,-,---
X-,-.~.~.~.~.~.~.~,~tGtGtG.~.~.~.~.~.~.~,~,-.-X-----------------------------------------------------------,-X-X-X-X-X-,-,-,-,-,-,-,-X-X-X-X-X-Xd+d+d+dXdX-X-X-X-X-,-,-,-,-,-,-,-X-X-X-X-X---
X-,-.~.~.~.~.~.~.~.~.~.~.~.~.~.~.~.~.~.~,~,-.-X-----------------------------------------------------------,-X-,-H-,-,-,-,-,-,-,-,-,-,-,-,-,-,-,-,-H-,-,-,-,-,-,-,-,-,-,-,-,-,-,-,-,-,-H-X---
X-,-.~.~.~.~.~.~.~.~.~.~.~.~.~.~.~.~.~.~,~,-.-X---------------------,-,-,-,-,-,-,-,-,---------------------,-X-,-.~.~.~.~.~.~.~.~.~.~.~.~.~.~.~.~.~.~.~.~.~.~.~.~.~.~.~.~.~.~.~.~.~.~,~.-X---
X-,-.~.~.~.~.~.~.~.~.~.~.~.~.~.~.~.~.~.~,~,-.-X---------------,-,-,-,-X-X-X-X-X-X-X-X-,-,-----------------,-X-,-.~.~.~.~.~.~.~.~.~.~.~.~.~.~.~.~.~.~.~.~.~.~.~.~.~.~.~.~.~.~.~.~.~.~,~.-X---
X-,-.~.~.~.~.~.~.~.~.~.~.~.~.~.~.~.~.~.~,~,-.-X---------------,-X~X~X~X~,-X~X-X~,-X~X-X~X~----------------,-X-,-.~.~.~.~.~.~.~.~.~.~.~.~.~.~.~.~.~.~.~.~.~.~.~.~.~.~.~.~.~.~.~.~.~.~,~,-X-,-
X-,-.~.~.~.~:~.~.~.~.~.~.~.~.~.~.~.~.~.~,~,-.-X---------------,-X~.~,~,~H~,~H~,~H~,~.~.~X~----------------,-X-,-.~.~.~.~.~,~,~,~,~,~.~.~.~.~.~.~.~.~.~.~.~.~.~.~.~.~.~.~.~.~.~.~.~.~,~,-X-X-
X-,-.~.~.~.~.~.~.~.~.~.~.~.~.~.~.~.~.~.~,~,-.-X---------------,-X~.~,~t.t.t.,~t/t/t/.~.~X~----------------,-X-,-.~.~.~.~.~,~,-,-,-,-.~.~.~.~.~.~.~.~.~.~.~.~.~.~.~.~.~.~,~,~,~,~.~.~,~,-.-X-
X-,-.~.~.~.~.~.~.~.~.~.~.~.~.~.~.~.~.~.~,~,-.-X---------------,-X~.~,~t.E-t.,~t/E-t/.~.~X~----------------,-X-,-.~.~.~.~.~,~,-XbXT,-.~.~.~.~.~.~.~.~.~.~.~.~.~.~.~.~,~,~,~.-.-,-,~.~,~,-.-X-
X-,-.~.~.~.~.~.~.~.~.~.~.~.~.~.~.~.~.~.~,~,-.-X---------------,-X~.~,~t.t.t.,~t/t/t/.~.~X~----------------,-X-,-.~.~.~.~.~,~,-XCX5,-.~.~.~.~.~.~.~.~.~.~.~.~.~.~.~.~,~.-,-.-.-.-,-.~,~,-.-X-
X-,-.~.~.~.~.~.~.~.~.~.~.~.~.~.~.~.~.~:~,~,-.-X---------------,-X~.~.~.~.~.~.~.~.~.~.~.~X~----------------,-X-,-.~.~.~.~.~,~,-XbXT,-.~.~.~.~.~.~.~.~.~.~,~,~.~.~.~.~,~.-,-.-t/.-,-.~,~,-.-X-
X-,-.~.~.~.~.~.~.~.~.~.~.~.~.~.~.~.~.~.~,~,-X-X---------------,-X~,~,~,~,~,~,~,~,~,~,~.~X~----------------,-X-,-.~.~.~.~.~,~,-X2Xc,-.~.~.~.~.~.~.~.~.~,~,~,-,~.~.~.~,~,-,-.-.-,-,-.~,~,-.-X-
X-,-.~.~.~.~.~.~.~,~,~,~,~.~.~.~.~.~.~.~,~.-X-----------------,-X~X~X-.-.-.-.-.-.-.-X-X~X~----------------,-X-,-.~.~.~.~.~,~,-X2XD,-.~.~.~.~.~.~.~,~,~,~,-,-,-,~.~.~.~.~,~,-,-,-.~.~,~,-.-X-
X-,-.~.~.~.~.~.~.~,~.-.-,-.~.~.~.~.~.~.~,~.-X-------------------,-X-X-,-,-,-,-,-,-,-X-X-X-----------------,-X-,-.~.~.~.~.~,~,-X2XX,-.~.~.~.~.~.~,~,~,~,-X-X7X-,-.~.~.~.~.~.~.~.~.~.~,~,-.-X-
X-,-.~.~.~.~.~.~,~,~,-,-,-,~.~.~.~.~.~.~,~.-X-------------------,-X-.-.-.-.-.-.-.-.-,-,-X-----------------,-X-,-.~.~.~.~.~,~,-X@X9,-.~.~.~.~.~,~,~,~,-X-X:X:,-.~.~.~.~.~.~.~.~.~.~.~,~,-X-X-
X-,-.~.~.~.~.~.~,~.-.-.-.-,-.~.~.~.~.~.~,~.-X-------------------,-X-.-.-.-.-.-.-.-.-.-,-X-----------------,-X-,-.~.~.~.~.~,~,-X_XX,-.~.~.~.~,~,~,~,-+`X:XY,-.~.~.~.~.~.~.~.~.~.~.~.~,~.-X---
X-,-.~.~.~.~.~.~,~.-.-t0.-,-.~.~.~.~.~.~,~.-X-,-,-,-,-,-,-,-,-,-,-X-.-.-.-.-.-.-.-.-.-,-X-,-,-,-,-,-,-,-,-,-X-,-.~.~.~.~.~,~,-XSX[,-.~.~.~.~,~,-X-XAX6+U,-.~.~.~.~.~.~.~.~.~.~.~.~.~,~.-X---
X-,-.~.~.~.~.~.~,~,-.-.-,-,-.~.~.~.~.~.~,~.-XQX-X-X-X-X-X-X-X-X1X-X-.-.-.-.-.-.-.-.-.-,-X-X-X-X-X-X-X-X-X-X-X-,-.~.~.~.~.~,~,-X4X<,-.~.~.~.~.~,~,-X-XU,-.~.~.~.~.~.~.~.~.~.~.~.~.~.~,~.-X---
X-,-.~.~.~.~.~.~.~,~,-,-,-.~.~.~.~.~.~.~,~.-,Q.-.-.-.-.-.-.-.-.1,-,-.-.-.-.-.-.-.-.-.-,-.-.-.-.-.-.-.-.-.-,-.-,-.~.~.~.~.~,~,-XSX[,-.~.~.~.~.~,~,~,-,-.~.~.~.~.~.~.~.~.~.~.~.~.~.~.~,~.-X---
X-,-.~.~.~.~.~.~.~,~,~,~H~.~.~.~.~.~.~.~,~.-,Q.-.-.-.-.-.-.-H-.-,-,-.-.-.-.-<-.-.-.-.-,-.-.-.-.-.-.-.-.-.-,-.-,-.~.~.~.~.~,~,-X-X-,-.~.~.~.~.~.~,~,-.~.~.~.~.~.~.~.~.~.~.~.~.~.~.~.~,~.-X---
X-,-.~.~.~.~.~.~,~,~.-.-,-,~.~.~.~.~.~.~,~.-,Q.-.-.-.-.-.-.-.-.-,-,-.-.-.-.-.-.-.-.-.-,-.-.-.-.-.-.-.-.-.-,-.-,-.~.~.~.~.~,~,-,-,-,-.~.~.~.~.~.~.~.~.~.~.~.~.~.~.~.~.~.~.~.~.~.~.~.~,~.-X---
X-,-.~.~.~.~.~.~,~.-.-.-.-,-.~.~.~.~.~.~,~.-XQX-X-X-X-X-X-X-X-X-X-X-.-.-.-.-.-.-.-.-.-,-X-X-X-X-X-X-X-X-X-X-X-,-.~.~.~.~.~.~.~.~.~.~.~.~.~.~.~.~.~.~.~.~.~.~.~.~.~.~.~.~.~.~.~.~.~.~,~.-X---
X-,-.~.~.~.~.~.~,~.-.-t1.-,-.~.~.~.~.~.~,~.-X-------------------,-X-.-.-.-.-.-.-.-.-,-,-X-----------------,-X-,-.~.~.~.~.~.~.~.~.~.~.~.~.~.~.~.~.~.~.~.~.~.~.~.~.~.~.~.~.~.~.~.~.~.~,~.-X---
X-,-.~.~.~.~.~.~,~,-,-,-,-,-.~.~.~.~.~.~,~.-X-------------------,-X-,-,-,-,-,-,-,-,-,-.-X-----------------,-X-,-.~.~.~.~.~.~.~.~.~.~.~.~.~.~.~.~.~.~.~,~,~,~,~,~,~,~,~,~,~,~,~,~.~.~,~,-X-,-
X-,-.~.~.~.~.~.~.~,~.-.-,-.~.~.~.~.~.~.~,~.-X-----------------,-,-X-X-.-.-.-.-.-.-.-X-X-X-----------------,-X-,-.~.~.~.~.~.~.~.~.~.~.~.~.~.~.~.~.~.~.~,~,-.-,-+\,-+].-,-+W.-,-,-.~.~,~,-X-X-
X-,-.~.~.~.~.~.~.~,~,-,-,-.~.~.~.~.~.~.~,~,-X-,---------------,-X~X~X-,-,-,-,-,-,-,-X-X~X~----------------,-X-,-.~.~.~.~.~.~.~.~.~.~.~.~.~.~.~.~.~.~.~,~,-X-X?X?X3X3X3XBXaXBX-,-.~.~,~,-.-X-
X-,-.~.~.~.~.~.~.~.~.~.~.~.~.~.~.~.~.~.~,~,-X-X---------------,-X~.~.~.~.~.~.~.~.~.~.~.~X~----------------,-X-,-.~.~.~.~.~.~.~.~.~.~.~.~.~.~.~.~.~.~.~,~,-X-X-+^XR+RXRXa+aXaX-,-.~.~,~,-.-X-
X-,-.~.~.~.~.~.~.~.~.~.~.~.~.~.~.~.~.~.~,~,-.-X---------------,-X~.~.~.~.~.~.~.~.~.~.~.~X~----------------,-X-,-.~.~.~.~,~,~,~,~.~.~.~.~.~.~.~.~.~.~.~,~,-,-,-,-,-,-,-,-,-,-,-,-.~.~,~,-.-X-
X-,-.~.~.~.~.~.~.~.~.~.~.~.~.~.~.~.~.~.~,~,-.-X---------------,-X~.~,~,~,~,~,~,~,~,~.~.~X~----------------,-X-,-.~.~.~,~,~.-.-,;,~,~.~.~.~.~.~.~.~.~.~.~.~.~.~.~.~.~.~.~.~.~.~.~.~.~,~,-.-X-
X-,-.~.~.~.~.~.~.~.~.~.~.~.~.~.~.~.~.~.~,~,-.-X---------------,-X~.~,~t0t0t0,~t1t1t1.~.~X~----------------,-X-,-.~.~.~,~.-.-.-,;.-,-.~.~.~.~.~.~.~.~.~.~.~.~.~.~.~.~.~.~.~.~.~.~.~.~,~,-.-X-
X-,-.~.~.~.~.~.~.~.~.~.~.~.~.~.~.~.~.~.~,~,-.-X---------------,-X~.~,~t0E-t0,~t1E-t1.~.~X~----------------,-X-,-.~.~.~,~.-.-t.,;.-,-.~.~.~.~.~.~.~.~.~.~.~.~.~.~.~.~.~.~.~.~.~.~.~.~,~,-.-X-
X-,-.~.~.~.~.~.~.~.~.~.~.~.~.~.~.~.~.~.~,~,-.-X---------------,-X~.~,~t0t0t0,~t1t1t1.~.~X~----------------,-X-,-.~.~.~,~,-.-.-,;,-,-.~.~.~.~.~.~.~.~.~.~.~.~.~.~.~.~.~.~.~.~.~.~.~.~,~,-.-X-
X-,-.~.~.~.~.~.~.~.~.~.~.~.~.~.~.~.~.~.~,~,-.-X---------------,-X~X~X~X~H~X~X~X~H~X~X~X~X~----------------,-X-,-.~.~.~.~,~,-,-,-.~.~.~.~.~.~.~.~.~.~.~.~.~.~.~.~.~.~.~.~.~.~.~.~.~.~,~,-X-X-
X-,-.~.~.~.~.~.~.~.~.~.~.~.~.~.~.~.~.~.~,~,-.-X---------------------,-X~,~X~X-X~,~X~X---------------------,-X-,-.~.~.~.~.~.~.~.~.~.~.~.~.~.~.~.~.~.~.~.~.~.~.~.~.~.~.~.~.~.~.~.~.~.~,~.-X---
X-,-.~.~.~.~.~.~.~.~.~.~.~.~.~.~.~.~.~.~,~,-.-X---------------------,-X-X-X-X-X-X-X-X---------------------,-X-,-.~.~.~.~.~.~.~.~.~.~.~.~.~.~.~.~.~.~.~.~.~.~.~.~.~.~.~.~.~.~.~.~.~.~,~.-X---
X-,-.~.~.~.~.~.~.~.~.~.~.~.~.~.~.~.~.~.~,~,-.-X-----------------------------------------------------------,-X-,-H~,~,~,~,~,~,~,~,~,~,~,~,~,~,~,~,~H~,~,~,~,~,~,~,~,~,~,~,~,~,~,~,~,~,~H-X---
X-,-.~.~.~.~.~.~.~,~,~,~,~.~.~.~.~.~.~.~,~,-.-X-----------------------------------------------------------,-X-.-.-,-,-,-,-,-,-,-,-,-,-.-.-.-,-,-,-,-,-,-.-.-.-,-,-,-,-,-,-,-,-,-,-.-.-.-X---
X-,-.~.~.~.~.~.~.~,~tFtFtF.~.~.~.~.~.~.~,~,-.-X-----------------------------------------------------------,-X-X-X-X-X-X-X-X-X-X-X-X-X-X-X-X-X-X-.-.-.-X-X-X-X-X-X-X-X-X-X-X-X-X-X-X-X-X-X---
X-,-.~.~.~.~.~.~.~,~tFtGtF.~.~.~.~.~.~.~,~,-.-X---------------------------------------------------------------------------------------------,-X-,-,-,-X-------------------------------------
X-,-.~.~.~.~.~.~.~,~tFtFtF.~.~.~.~.~.~.~,~,-.-X---------------------------------------------------------------------------------------------,-X-t.t.t.X-------------------------------------
X-,-.~.~.~.~.~.~.~.~.~.~.~.~.~.~.~.~.~.~,~,-.-X---------------------------------------------------------------------------------------------,-X-.-.-,-X-------------------------------------
X-,-.~.~.~.~.~.~.~.~.~.~.~.~.~.~.~.~.~.~,~,-.-X---------------------------------------------------------------------------------------------,-X-,-,-,-X-------------------------------------
X-,-.~.~.~,~,~,~,~:~,~,~,~,~,~,~,~.~.~.~,~,-X-X---------------------------------------------------------------------------------------------,-X-X-X-X-X-------------------------------------
X-,-.~.~.~,~,-,-,-,-.R.R,R,-,-,-,-.~.~.~,~.-X-----------------------------------------------------------------------------------------------------------------------------------------------
X-,-.~.~.~,~,-X-XIXIXI+lXlXKXKXK,-.~.~.~,~.-X-----------------------------------------------------------------------------------------------------------------------------------------------
X-,-.~.~.~,~,-X-X-X-XlXlXlX-X-X-,-.~.~.~,~.-X-----------------------------------------------------------------------------------------------------------------------------------------------
X-,-.~.~.~.~.~.~.~.~.~.~.~.~.~.~.~.~.~.~,~.-X-----------------------------------------------------------------------------------------------------------------------------------------------
X-,-.~.~.~.~.~.~.~.~.~.~.~.~.~.~.~.~.~.~,~.-X-----------------------------------------------------------------------------------------------------------------------------------------------
X-,-.~.~.~.~.~.~.~.~.~.~.~.~.~.~.~.~.~.~,~.-X-----------------------------------------------------------------------------------------------------------------------------------------------
X-,-,~,~,~,~,~,~,~,~,~,~,~,~,~,~,~,~,~,~,~.-X-----------------------------------------------------------------------------------------------------------------------------------------------
X-.-.-.-.-.-,-,-,-,-,-,-,-,-,-,-.-.-.-.-.-.-X-----------------------------------------------------------------------------------------------------------------------------------------------
X-X-X-X-X-X-X-X-.-.-.-.-.-.-.-X-X-X-X-X-X-X-X-----------------------------------------------------------------------------------------------------------------------------------------------
------------,-X-.-.-X-X-X-X-.-X-------------------------------------------------------------------------------------------------------------------------------------------------------------
------------,-X-.-X-X-X-X-X-.-X-------------------------------------------------------------------------------------------------------------------------------------------------------------
------------,-X-.-X-X-.-X-X-.-X-------------------------------------------------------------------------------------------------------------------------------------------------------------
------------,-X-.-.-X0t0X0X-.-X-------------------------------------------------------------------------------------------------------------------------------------------------------------
------------,-X-.-.-.-.-.-.-.-X-------------------------------------------------------------------------------------------------------------------------------------------------------------
------------,-X-.-.-.-.-.-.-.-X-------------------------------------------------------------------------------------------------------------------------------------------------------------
------------,-X-X-X-X-X-X-X-X-X-------------------------------------------------------------------------------------------------------------------------------------------------------------
