------------------------X-X-X-X-X-X-X-X-X-X-X-X-X-X-,-,-----------------------------------------------------------------------------------
------------------------X-H-,-.-,-----,-.-,---,-.-.-X-X-,-,-------------------------------------------------------------------------------
------------------------X---,-.-,-----,-.-,---,-.-.-,-.-X-X-,-,---------------------------------------------------------------------------
----------------------,-X-,-,-.-,-,-,-,-.-,-,-,-,-.-,-.-,-,-X-X-,-,-----------------------------------------------------------------------
----------------------,-X-.-.-.-.-.-.-.-.-.-.-.-,-.-,-.-,-,-.-.-X-X-,-,-------------------------------------------------------------------
----------------------,-X-,-,-.-.-.-E-.-.-,-,-,-,-.-,-.-,-,-.-.-.-.-X-X-,-,---------------------------------------------------------------
------------------------X---,-.-.-.-.-.-.-,-----,-.-,-.-,-,-.-.-.-,-,-,-X-X-,-,-----------------------------------------------------------
------------------------X---,-.-.-.-.-.-.-,-----,-.-,-.-,-,-.-.-.-,---,-,-,-X-X-,-,-------------------------------------------------------
----------------------,-X-,-,-.-.-.-.-.-.-,-,-,-,-.-,-.-,-,-.-.-.-,-------,-,-,-X-X-,-,---------------------------------------------------
----------,-,-,-,-,-,-,-X-.-.-.-.-.-.-.-.-.-.-.-,-.-,-.-,-,-.-.-.-,-----------,-,-,-X-X-,-,-----------------------------------------------
--------,-,-X~X~X~X~X~X~X-,-,-.-.-.-.-.-.-,-,-,-,-.-,-.-,-,-.-.-.-,---------------,-,-,-X-X-,-,-------------------------------------------
------,-,-X-.~.~.~.~.~.~,~--,-.-.-.-.-.-.-,-----,-.-,-.-,-,-.-.-.-,-------------------,-,-,-X-X-,-,---------------------------------------
----,-,-X-,-.~.~.~.~.~.~,~--,-.-.-.-.-.-.-,-----,-.-,-.-,-,-.-.-.-,-----E-------,-,-,-,---,-,-,-X-X-,-,-,---------------------------------
--,-,-X-.-,-.~.~.~.~.~.~,~--,-.-.-.-.-.-.-,-----,-.-,-.-,-,-.-.-.-,---------,-,-,-.-.-,-,-,---,-.-.-X-X-X-,-,-,---------------------------
,-,-X-,-,-,-.~.~.~.~.~.~,~--,-.-.-.-E-.-.-,-----,-.-,-.-,-,-.-.-.-,---------,-.-.-.-.-.-.-,-,-,-.-.-.-.-.-X-X-X-,-,-,-,-,-----------------
,-X-,-,-,-,-.~.~.~.~.~.~,~--,-.-.-.-.-.-.-,-----,-.-,-.-,-,-.-.-.-,-------,-,-.-,-,-,-,-,-,-,-,-,-,-,-,-,-,-X-X-X~X~X~X~,-,---------------
X-.-,-t..-,-.~.~.~.~.~.~,~--,-.-.-.-.-.-.-,-----,-.-,-.-,-,-.-.-.-,-,-,-,-,-.-.-,-,-,-----,-,-,-,-.-.-.-.-,-.~.~,~,~.~,~X~X~,-------------
X-.-.-t..-,-.~.-.-.-.-.-,~--,-.-.-.-.-.-.-,-----,-.-,-.-,-,-.-.-.-,-,-.-.-.-.-.-.-.-,---------,-,-.-.-.-.-,-.~,~,~,-.~,~,-,~X~,-----------
X-.-,-t..-,-.~.-.-.-.-.-,~--,-.-.-.-E-.-.-,-----,-.-,-.-,-,-.-.-.-,-,-.-E-.-.-.-.-.-,---------<-,-.-.-t..-,-.~,~.-,-,~,~.-,-.~X~,---------
X-.-,-t.,-,-.~.~.~.~.~.~,~--,-.-.-.-.-.-.-,-----,-.-,-.-,-,-.-.-.-,-,-,-,-,-.-.-.-,-,---,-,-,-,-,-.-.-.-.-,-.~,~,-,-,-,~.-,-,~.~X~--------
X-.-,-,-,-,-.~.~.~.~.~.~,~--,-.-.-.-.-.-.-,-----,-.-,-.-,-,-.-.-.-,-------,-,-.-.-,-,-,-,-,-,-,-,-,-,-,-,-,-,~,~,~,-.~,~,-,-,-,~X~--------
,-X-.-.-.-,-.~.~.~.~.~.~,~--,-.-.-.-.-.-.-,-----,-.-,-.-,-,-.-.-.-,---------,-.-.-.-.-.-.-,---,-.-.-.-.-.-,-X-X-X~X~X~X~.~.~,~,~X---------
--,-X-.-.-,-.~.~.~.~.~.~,~--,-.-.-.-E-.-.-,-----,-.-,-.-,-,-.-.-.-,---------,-,-,-.-.-,-,-,---,-.-.-.-.-,-X-X-------,-,-X~,~,~.-,-X-------
----,-X-.-,-.~.~.~.~.~.~,~--,-.-.-.-.-.-.-,-----,-.-,-.-,-,-.-.-.-,-------------,-,-,-,---,-,-,-,-,-X-X-X---------------,-X~,-.-,-X~------
------,-X-,-.~.~.~.~.~.~,~--,-.-.-.-.-.-.-,-----,-.-,-.-,-,-.-.-.-,-----E-------------,-,-,-,-X-X-X-----------------------X-,~,-,-,~X-----
--------,-X-.~.~.~.~.~,~,~,-,-.-.-.-.-.-.-,-,-,-,-.-,-.-,-,-.-.-.-,---------------,-,-,-,-X-X-----------------------------,-X~.-,~,~X-,---
----------,-X~X~X~X~X~X~X-.-.-.-.-.-.-.-.-.-.-.-,-.-,-.-,-,-.-.-.-,-----------,-,-,-,-X-X---------------------------------,-X~,~,-,-,-X-,-
----------------------,-X-,-,-.-.-.-.-.-.-,-,-,-,-.-,-.-,-,-.-.-.-,-------,-,-,-,-X-X-------------------------------------,-X-,->->->-.-X-
------------------------X---,-.-.-.-.-.-.-,-----,-.-,-.-,-,-.-.-.-,---,-,-,-,-X-X-----------------------------------------,-X-,->-.->-.-X-
------------------------X---,-.-.-.-.-.-.-,-----,-.-,-.-,-,-.-.-.-,-,-,-,-X-X---------------------------------------------,-X-,->->->-,-X-
----------------------,-X-,-,-.-.-.-.-.-.-,-,-,-,-.-,-.-,-,-.-.-.-.-,-X-X---------------------------------------------------,-X-.-.-,-X---
----------------------,-X-.-.-.-.-.-E-.-.-.-.-.-,-.-,-.-,-,-.-.-,-X-X---------------------------------------------------------,-X-X-X-----
----------------------,-X-.-.-.-,-,-,-,-.-,-,-,-,-.-,-.-,-,-,-X-X-------------------------------------------------------------------------
----------------------,-X-.-.-.-,-----,-.-,-----,-.-,-.-X-X-X-----------------------------------------------------------------------------
----------------------,-X-.-.-.-,-----,-.-,-----,-.-X-X-X---------------------------------------------------------------------------------
----------------------,-X-H-.-.-,-----,-.-,-----X-X-X-------------------------------------------------------------------------------------
----------------------,-X-X-X-X-X-X-X-X-X-X-X-X-X-----------------------------------------------------------------------------------------
