----------------------------------------------,-X-X-X-X-X-------------------------------------------------
----------------------------------------------,-X-.-.-.-X-------------------------------------------------
----------------------------------------------,-X-.-E-.-X-------------------------------------------------
----------------------------------------------,-X-,-,-,-X-------------------------------------------------
----------------------------------------------,-X-.-.-.-X-------------------------------------------------
----------------------------------------------,-X-.-.-.-X-,-,---------------------------------------------
----------------------------------------------,-X-.-.-.-X-X-X-,-------------------------------------------
----------------------------------------------,-X-.-.-.-,-.-,-X-------------------------------------------
----------------------------------------------,-X-.-.-.-,-X-X-X-------------------------------------------
----------------------,-,-,-,-,-,-,-,-,-,-,-,-,-X-.-.-.-X-----,-,-,-,-,-,-,-,-,-,-,-----------------------
--------------------,-,-X-X-X-X-X-X-X-X-X-X-X-X-X-.-.-.-X-,-,-,-X-X-X-X-X-X-X-X-X-X-----------------------
------------------,-,-X-X-.-.-.-.-.-.-.-X-X-,-X-X-,-,-,-X-X-X-X-X-.-.-.-.-.-.-,-X-X-----------------------
------------------,-X-X-.-.-.-.-.-.-.-.-.-.-.-.-.-.-.-.-.-.-.-.-.-.-.-.-.-.-.-.-,-X-----------------------
------------------,-X-.-.-.-.-.-.-.-.-.-.-.-.-.-.-.-.-.-.-.-.-.-.-.-.-.-.-.-.-.-,-X-----------------------
------------------,-X-.-.-.-.-.-.-.-.-.-.-.-.-.-.-.-.-.-.-.-.-.-.-.-.-.-.-.-.-.-,-X-----------------------
------------------,-X-.-.-.-.-.-.-.-.-.-.-.-.-.-.-.-.-.-.-.-.-.-.-.-.-.-.-.-.-.-,-X-----------------------
------------------,-X-.-.-.-.-.-.-.-.-.-.-.-.-.-.-.-.-.-.-.-.-.-.-.-.-.-.-.-.-.-,-X-----------------------
------------------,-X-.-.-.-.-.-.-.-.-.-.-.-.-.-.-.-.-.-.-.-.-.-.-.-.-.-.-.-.-.-,-X-----------------------
------------------,-X-.-.-.-.-.-.-.-.-.-.-.-.-.-.-.-.-.-.-.-.-.-.-.-.-.-.-.-.-.-,-X-----------------------
------------------,-X-.-.-.-.-.-.-.-.-.-.-.-.-.-.-.-.-.-.-.-.-.-.-.-.-.-.-.-.-.-,-X-----------------------
----------,-,-,-,-,-X-X-.-.-.-.-.-.-.-.-.-.-.-.-.-.-.-.-.-.-.-.-.-.-.-.-.-.-.-.-,-X-----------------------
----------,-X-X-X-,-X-X-.-.-.-.-.-.-.-.-.-.-.-.-.-.-.-.-.-.-.-.-.-.-.-.-.-.-.-.-,-X-----------------------
--------,-,-X-,-X-,-X-,-.-.-.-.-.-.-.-.-.-.-.-.-.-.-.-.-.-.-.-.-.-.-.-.-.-.-.-.-,-X-----------------------
,-,-,-,-,-X-X-.-X-X-,-X-.-.-.-.-.-.-.-.-.-.-.-.-.-.-.-.-.-.-.-.-.-.-.-.-.-.-.-.-,-X-,-,-,-,-,-,-,-,-,-,-,-
X-X-X-X-X-X-.-.-.-.-X-X-.-.-.-.-.-.-.-.-.-.-.-,-,-,-,-,-.-.-.-.-.-.-.-.-.-.-.-.-,-X-X-X-X-X-X-X-X-X-X-X-X-
X-.-.-,-.-.-.-.-.-.-.-,-.-.-.-.-.-.-.-.-.-.-.-,-,->->->-.-.-.-.-.-.-.-.-.-.-.-.-,-.-.-.-.-.-.-,-.-.-.-.-X-
X-.-E-,-.-H-.-.-.-.-.-,-.-.-.-.-.-.-.-.-.-.-.-,-,->-.->-.-.-.-.-.-.-.-.-.-.-.-.-,-.-.-.-.-.-.-H-.-.-E-.-X-
X-.-.-,-.-.-.-.-.-.-.-,-.-.-.-.-.-.-.-.-.-.-.-.-,->->->-.-.-.-.-.-.-.-.-.-.-.-.-,-.-.-.-.-.-.-,-.-.-.-.-X-
X-X-X-X-X-X-X-X-X-X-X-X-.-.-.-.-.-.-.-.-.-.-.-.-.-.-.-.-.-.-.-.-.-.-.-.-.-.-.-.-,-.-.-.-.-.-.-,-.-.-.-.-X-
------------------,-X-X-.-.-.-.-.-.-.-.-.-.-.-.-.-.-.-.-.-.-.-.-.-.-.-.-.-.-.-.-,-X-X-X-,-,-X-X-X-X-X-X-X-
------------------,-X-,-.-.-.-.-.-.-.-.-.-.-.-.-.-.-.-.-.-.-.-.-.-.-.-.-.-.-.-.-.-X-,-X-.-X---------------
------------------,-X-X-.-.-.-.-.-.-.-.-.-<-.-.-.-.-.-.-.-.-.-.-.-.-.-.-.-.-.-.-,-X-,-X-,-X---------------
------------------,-X-X-.-.-.-.-.-.-.-.-.-.-.-.-.-.-.-.-.-.-.-.-.-.-.-.-.-.-.-.-,-X---,-X-X---------------
------------------,-X-.-.-.-.-.-.-.-.-.-.-.-.-.-.-.-.-.-.-.-.-.-.-.-.-.-.-.-.-.-,-X-----------------------
------------------,-X-.-.-.-.-.-.-.-.-.-.-.-.-.-.-.-.-.-.-.-.-.-.-.-.-.-.-.-.-.-,-X-----------------------
------------------,-X-.-.-.-.-.-.-.-.-.-.-.-.-.-.-.-.-.-.-.-.-.-.-.-.-.-.-.-.-.-,-X-----------------------
------------------,-X-.-.-.-.-.-.-.-.-.-.-.-.-.-.-.-.-.-.-.-.-.-.-.-.-.-.-.-.-.-,-X-----------------------
------------------,-X-.-.-.-.-.-.-.-.-.-.-.-.-.-.-.-.-.-.-.-.-.-.-.-.-.-.-.-.-.-,-X-----------------------
------------------,-X-.-.-.-.-.-.-.-.-.-.-.-.-.-.-.-.-.-.-.-.-.-.-.-.-.-.-.-.-.-,-X-----------------------
------------------,-X-.-.-.-.-.-.-.-.-.-.-.-.-.-.-.-.-.-.-.-.-.-.-.-.-.-.-.-.-.-,-X-----------------------
------------------,-X-X-,-,-,-,-,-,-,-,-,-.-.-,-,-,-,-,-,-.-.-,-,-,-,-,-,-,-,-,-.-X-----------------------
--------------------,-X-X-X-X-X-X-X-X-X-X-X-X-X-X-.-.-.-X-X-X-X-X-X-X-X-X-X-X-X-X-X-----------------------
----------------------------------------,-,-,-X-X-.-.-.-X-------------------------------------------------
----------------------------------------,-X-X-X-.-.-.-.-X-------------------------------------------------
----------------------------------------,-X-,-.-.-.-.-.-X-------------------------------------------------
----------------------------------------,-X-X-X-.-.-.-.-X-------------------------------------------------
--------------------------------------------,-X-.-.-.-.-X-------------------------------------------------
----------------------------------------------,-X-,-,-,-X-------------------------------------------------
----------------------------------------------,-X-.-.-.-X-------------------------------------------------
----------------------------------------------,-X-.-.-.-X-------------------------------------------------
----------------------------------------------,-X-.-E-.-X-------------------------------------------------
----------------------------------------------,-X-.-.-.-X-------------------------------------------------
----------------------------------------------,-X-X-X-X-X-------------------------------------------------
