----------------------------------------------------------------------,-,-X-X-X-,-,-,-----------------------------,-,-,-,-X-X-X-,-----
--------------------------------------------------------------------,-,-X-,-.-,-X-X-X-,-,---------------------,-,-,-X-X-X-,-,-,-X-,---
------------------------------------------------------------------,-,-X-,-.-.-.-H-.-X-X-X---------------------,-X-X-X-H-.-.-,-,-,-X-,-
------------------------------------------------------------------,-X-,-.-.-.-.-.-.-X-X-------------------------,-X-X-.-.-.-.-.-,-,-X-
------------------------------------------------------------------,-X-.-.-.-t2.-.-,-X-,-,-------------------,-,-,-X-X-.-.-t/.-.-,-,-X-
------------------------------------------------------------------,-X-.-.-.-.-.-,-,-,-X-X-------------------,-X-X-.-,-,-.-.-.-.-,-,-X-
--------------------------------------------------------------------,-X-.-.-.-,-,-,-.-t2X-,---------------,-,-X-,-.-.-,-,-.-.-H-,-X---
--------------------------------------------------------------------,-X-H-.-,-,-,-,-t2.-.-X-,-----------,-,-X-t/.-,-.-H-,-,-,-,-.-X---
----------------------------------------------------------------------X-X-X-X-,-,-t2.-.-.-.-X-,-,---,-,-,-X-.-.-t/,-.-,-,-,-X-X-X-X---
------------------------------------------------------------------------X-X-,-X-t2.-.-.-.-.-,-X-X-,-,-X-X-.-.-.-.-t/,-,-X-X-,-X-X-----
------------------------------------------------------------------------X---,-X-X-.-.-.-.-.-.-,-X-X-,-X-.-.-.-.-.-.-t/X-X-X---,-X-----
--------------------------------------------------------------------------------,-X-.-.-.-.-.-.-.-X-.-X-.-.-.-.-.-,-X-----------------
----------------------------------------------------------------------------------,-X-,-.-.-.-.-.-.-X-.-.-.-.-,-,-X-------------------
------------------------------------------------------------------,-,-,-,-----------,-X-,-.-.-.-.-.-.-.-.-.-,-,-X---------------------
----,-,-,-,-,-,-------,-,-,-,-,-,-,-,-,-,-,-,-,-,-----------------,-X-X-X---------,-,-X-X-.-.-.-.-.-.-.-.-.-,-X-X---------------------
,-,-,-X-X-X-X-X-,-,-,-,-X-X-X-X-X-X-X-X-X-X-X-X-X-----------------,-X=t>X-------,-,-X.X.X-X-,-.-.-.-.-.-.-,-X-,-X---------------------
X-X>X-X-,-,-,-X-X-X-X-X-.-.-.-.->-.-.-.->-.-.-,-X-X-X-X-X-X-X-X-X-X-X-,-X-X-X-X-X-X-X-X-X.X.X..-.-.-.-.-.-,-X-X-----------------------
X-t>.-.-.-.-.-.-.-.-.-.-.-.-.-.->-.-.-.->-,-,-,-,-<---------------,-,-,---------,-.-.-,-,.,.,..-.-.-.-.-.-,-X-X-----------------------
X-X-X-X-X-X-X-X-X-X-X-X-X-X-X-X->-X-X-X->-X-X-X-X-X-X-X-X-X-X-X-X-X-X-X-X-X-X-X-X-X-X-X-X-X-X..-.-.-.-.-.-.-X-,-,---------------------
------------------------------------------------------------------,-X-X-------------,-X-X-.-.-.-.-.-.-.-.-.-,-X-X---------------------
------------------------------------------------------------------,-X-X-----------,-,-X-.-.-.-.-.-.-.-.-.-.-.-,-X-,-------------------
--------------------------------------------------------------------------------,-,-X-.-.-.-.-.-.-.-.-.-.-.-.-.-.-X-,-----------------
----------------------------------------------------------------------------,-,-,-X-.-.-.-.-.-,-,-,-X-,-.-.-.-.-.-.-X-,-,-------------
----------------------------------------------------------------------,-,---,-X-X-.-.-.-.-.-,-,-X-X-,-X-,-.-.-.-.-.-,-X-X-,-----------
----------------------------------------------------------------------,-X-,-,-X-t1.-.-.-.-.-,-X-X-X-,-X-X-.-.-.-.-.-,-t0X-X-----X-----
--------------------------------------------------------------------,-,-X-X-,-X-,-t1.-.-.-,-X-----------,-X-.-.-.-,-t0,-.-X-,-X-X-----
--------------------------------------------------------------------,-X-X-X-X-,-,-.-t1,-,-X---------------,-X-,-.-t0,-.-,-,-X-X-X-X---
--------------------------------------------------------------------,-X-H-.-.-,-,-H-,-t1X-------------------,-X-t0.-.-,-,-.-.-H-,-X---
------------------------------------------------------------------,-,-X-.-.-.-.-,-,-,-X-X-------------------,-X-X-.-,-,-.-.-.-.-.-X-,-
------------------------------------------------------------------,-X-,-.-.-t1.-.-,-X-,-X---------------------,-X-X-,-.-.-t0.-.-,-,-X-
------------------------------------------------------------------,-X-,-,-.-.-.-.-.-X---------------------------,-,-X-.-.-.-.-,-,-,-X-
------------------------------------------------------------------,-X-,-,-.-.-.-H-.-X-X-----------------------,-,-X-X-H-.-.-,-,-,-,-X-
--------------------------------------------------------------------,-X-,-,-.-.-,-,-X-X-X---------------------,-X-X-X-,-.-,-,-,-,-X---
----------------------------------------------------------------------,-X-,-,-,-X-X-X-----------------------------,-X-X-X-,-,-,-X-----
------------------------------------------------------------------------,-X-X-X-----------------------------------------,-X-X-X-------
