----------------------------------------------------------------------------------------------------------------------------------------X-X-X-------------
----------------------------------------------------------------------------------------------------------------------------------------X-,-X-------------
------------------------------------------------------------------------------------------------------------------------------,-,-------X-X-X-------------
--------------------------------------------------------------------------------------------------------------------------,-,-,-X-------,-X-X-------------
------------------------------------------------------------------------------------------------------------------------,-,-X-X-X-------------------------
--------------------------------------------------------------------------------------------------------------------,-,-X-X-.-.-X-------X-X-X-------------
----------------------------------------------------------------------------------------------------------------,-,-,-X-.-.-.-.-X-------X-,-X-------------
--------------------------------------------------------------------------------------------------------------,-,-X-X-.-.-.-.-.-X-------X-X-X-------------
----------------------------------------------------------------------------------------------------------,-,-,-X-,-,-,-.-.-.-.-X-------,-X-X-------------
--------------------------------------------------------------------------------------------------------,-,-X-X-.-,-,-t3.-.-.-.-X-------------------------
----------------------------------------------------------------------------------------------------,-,-X-X-.-.-.-.-.-.-t3,-,-.-X-------X-X-X-------------
------------------------------------------------------------------------------------------------,-,-,-X-.-.-.-.-.-.-.-.-,-t3,-.-X-------X-,-X-------------
----------------------------------------------------------------------------------------------,-,-X-X-.-.-.-.-.-.-.-.-.-,-,-.-.-X-------X-X-X-------------
------------------------------------------------------------------------------------------,-,-,-X-.-.-.-.-.-.-.-.-.-.-.-.-.-.-.-X-------,-X-X-------------
----------------------------------------------------------------------------------------,-,-X-X-.-.-.-.-.-.-.-.-.-.-.-.-.-.-.-.-X-------------------------
------------------------------------------------------------------------------------,-,-X-X-.-.-.-.-.-.-.-.-.-.-.-.-.-.-.-.-.-.-X-------------------------
--------------------------------------------------------------------------------,-,-,-X-.-.-.-.-.-.-.-.-.-.-.-.-.-.-.-.-.-.-.-.-X-------------------------
------------------------------------------------------------------------------,-,-X-X-.-.-.-.-.-.-.-.-.-.-.-.-.-.-.-.-.-.-.-.-.-X-------------------------
--------------------------------------------------------------------------,-,-,-X-.-.-.-.-.-.-.-.-.-.-.-.-.-.-.-.-.-.-.-.-.-.-.-X-------------------------
------------------------------------------------------------------------,-,-X-X-.-.-.-.-.-.-.-.-.-.-.-.-.-.-.-.-.-.-.-.-.-.-.-.-X-------------------------
--------------------------------------------------------------------,-,-X-X-.-.-.-.-.-.-.-.-.-.-.-.-.-.-.-.-.-.-.-.-.-.-.-.-.-.-X-------------------------
----------------------------------------------------------------,-,-,-X-.-.-.-.-.-.-.-.-.-.-.-.-.-.-.-.-.-.-.-.-.-.-.-.-.-.-.-.-X-------------------------
--------------------------------------------------------------,-,-X-X-.-.-.-.-.-.-.-.-.-.-.-.-.-.-.-.-.-.-.-.-.-.-.-.-.-.-.-.-.-X-------------------------
----------------------------------------------------------,-,-,-X-.-.-.-.-.-.-.-.-.-.-.-.-.-.-.-.-.-.-.-.-.-.-.-.-.-.-.-.-.-.-.-X-------------------------
--------------------------------------------------------,-,-X-X-,-.-.-.-.-.-.-.-.-.-.-.-.-.-.-.-.-.-.-.-.-.-.-.-.-.-.-.-.-.-.-.-X-------------------------
----------------------------------------------------,-,-X-X-,-.-,-.-.-.-.-.-.-.-.-.-.-.-.-.-.-.-.-.-.-.-.-.-.-.-.-.-.-.-.-.-.-.-X-------------------------
------------------------------------------------,-,-,-X-,-,-.-.-,-,-.-.-.-.-.-.-.-.-.-.-.-.-.-.-.-.-.-.-.-.-.-.-.-.-.-.-.-.-.-.-X-------------------------
----------------------------------------------,-,-X-X-,-.-.-.-.-.-,-.-.-.-.-.-.-.-.-.-.-.-.-.-.-.-.-.-.-.-.-.-.-.-.-.-.-.-.-.-.-X-------------------------
------------------------------------------,-,-,-X-,-,-.-.-.-.-.-,-,-,-,-.-.-.-.-.-.-.-.-.-.-.-.-.-.-.-.-.-.-.-.-.-.-.-.-.-.-.-.-X-------------------------
----------------------------------------,-,-X-X-.-,-.-.-.-.-.-.-,-,-,-.-,-.-.-.-.-.-.-.-.-.-.-.-.-.-.-.-.-.-.-.-.-.-.-.-.-.-.-.-X-------------------------
------------------------------------,-,-X-X-.-.-,-,-.-.-.-.-.-.-,-,-,-,-,-,-,-.-.-.-.-.-.-.-.-.-.-.-.-.-.-.-.-.-.-.-.-.-.-.-.-.-X-------------------------
--------------------------------,-,-,-X-.-.-.-,-,-.-.-.-.-.-.-.-,-.-.-,-,-,-,-,-.-.-.-.-.-.-.-.-.-.-.-.-.-.-.-.-.-.-.-.-.-.-.-.-X-------------------------
------------------------------,-,-X-X-.-.-.-,-,-.-.-.-.-.-.-.-.-,-,-,-,-,-.-,-,-,-,-.-.-.-.-.-.-.-.-.-.-.-.-.-.-.-.-.-.-.-.-.-.-X-------------------------
--------------------------,-,-,-X-.-.-.-.-.-,-.-.-.-.-.-.-.-.-.-,-,-,-.-,-,-.-,-,-,-,-.-.-.-.-.-.-.-.-.-.-.-.-.-.-.-.-.-.-.-.-.-X-------------------------
------------------------,-,-X-X-.-.-.-.-.-,-,-.-.-.-.-.-.-.-.-.-,-.-,-.-.-,-,-.-,-,-,-,-,-.-.-.-.-.-.-.-.-.-.-.-.-.-.-.-.-.-.-.-X-------------------------
--------------------,-,-X-X-.-.-.-.-.-.-,-,-.-.-.-.-.-.-.-.-.-.-,-,-,-,-.-.-,-,-.-.-,-,-,-,-.-.-.-.-.-.-.-.-.-.-.-.-.-.-.-.-.-.-X-------------------------
----------------,-,-,-X-.-.-.-.-.-.-.-,-,-.-.-.-.-.-.-.-.-.-.-.-,-,-,-,-,-.-.-,-.-.-.-,-,-,-,-,-.-.-.-.-.-.-.-.-.-.-.-.-.-.-.-.-X-------------------------
--------------,-,-X-X-.-.-.-.-.-.-.-.-,-.-.-.-.-.-.-.-.-.-.-.-.-,-,-.-,-,-.-.-,-,-.-.-.-,-,-,-,-,-.-.-.-.-.-.-.-.-.-.-.-.-.-.-.-X-------------------------
----------,-,-,-X-.-.-.-.-.-.-.-.-.-,-,-.-.-.-.-.-.-.-.-.-.-.-.-,-,-.-,-,-,-.-.-,-,-.-.-.-.-,-,-,-,-,-.-.-.-.-.-.-.-.-.-.-.-.-.-X-------------------------
--------,-,-X-X-,-,-,-.-.-.-.-.-.-,-,-.-.-.-.-.-.-.-.-.-.-.-.-.-,-,-.-.-,-,-,-.-.-,-.-.-t3.-.-,-,-,-,-,-.-.-.-.-.-.-.-.-.-.-.-.-X-----------,-,-,-,-------
----,-,-X-X-.-.-,-.-,-.-.-.-.-.-,-,-.-.-.-.-.-.-.-.-.-.-.-.-.-.-,-,-.-.-.-,-,-,-.-,-,-.-.-,-,-,-.-,-,-,-,-,-.-.-.-.-.-.-.-.-.-,-X-,-,-,-,-,-,-X-X-X-,-,---
,-,-,-X-.-.-.-.-,-t.t..-.-.-.-.-,-.-.-.-.-.-.-.-.-.-.-.-.-.-.-.-,-,-.-.-.-.-,-,-.-.-,-,-,-,-,-,-,-,-,-,-,-,-,-,-,-,-,-,-,-,-,-,-X-X-X-X-X-X-X-,-,-,-X-X-,-
,-X-X-.-.-.-.-.-.-t.t..-.-.-.-,-,-.-.-.-.-.-.-.-.-.-.-.-.-.-.-.-,-,-.-.-.-.-,-,-,-.-.-.-.-.-.-,-.-.-.-,-,-,-,-.-.-.-.-.-.-.-,-,-.-,-.-,-,-.-.-,->->->-.-X-
X-.-.-.-.-.-.-.-,-t.t..-.-.-.-,-,-.-.-.-.-.-.-.-.-.-.-.-.-.-.-.-,-,-.-.-t..-,-,-,-<-,-,-,-,-,-,-.-.-.-,-,-,-,-.-.-.-.-.-.-.-,-,-.-,-.-,-,-.-.-,->-.->-,-X-
,-X-X-.-.-.-.-.-,-t.t..-.-.-.-.-,-,-.-.-.-.-.-.-.-.-.-.-.-.-.-.-,-,-.-.-.-.-,-,-.-,-,-,-,-,-,-,-,-,-,-,-,-,-,-,-,-,-,-,-,-,-,-,-.-,-,-,-,-.-.-,->->->-X---
----,-X-X-.-.-.-,-,-,-.-.-.-.-.-.-,-.-.-.-.-.-.-.-.-.-.-.-.-.-.-,-,-.-.-.-,-,-,-.-,-,-.-.-.-.-.-.-,-,-,-,-,-.-.-.-.-.-.-.-.-.-,-X-X-X-X-X-X-X-X-X-X-X-----
------,-,-X-.-.-.-.-.-.-.-.-.-.-.-,-,-.-.-.-.-.-.-.-.-.-.-.-.-.-,-,-.-.-,-,-,-.-,-,-.-.-.-.-.-,-,-,-,-,-.-.-.-.-.-.-.-.-.-.-.-.-X-------------------------
----------,-X-X-.-.-.-.-.-.-.-.-.-.-,-,-.-.-.-.-.-.-.-.-.-.-.-.-,-,-.-,-,-,-.-,-,-.-.-.-t5,-,-,-,-,-,-.-.-.-.-.-.-.-.-.-.-.-.-.-X-------------------------
--------------,-X-.-.-.-.-.-.-.-.-.-.-,-,-.-.-.-.-.-.-.-.-.-.-.-,-,-.-,-,-,-.-,-,-.-.-.-,-,-,-,-,-.-.-.-.-.-.-.-.-.-.-.-.-.-.-.-X-------------------------
----------------,-X-X-.-.-.-.-.-.-.-.-.-,-.-.-.-.-.-.-.-.-.-.-.-,-,-,-,-,-.-,-,-.-.-,-,-,-,-,-,-.-.-.-.-.-.-.-.-.-.-.-.-.-.-.-.-X-------------------------
--------------------,-X-X-.-.-.-.-.-.-.-,-,-.-.-.-.-.-.-.-.-.-.-,-,-,-,-.-,-,-.-.-,-,-,-,-,-.-.-.-.-.-.-.-.-.-.-.-.-.-.-.-.-.-.-X-------------------------
----------------------,-,-X-.-.-.-.-.-.-.-,-,-.-.-.-.-.-.-.-.-.-,-,-,-.-.-,-.-,-,-,-,-,-,-.-.-.-.-.-.-.-.-.-.-.-.-.-.-.-.-.-.-.-X-------------------------
--------------------------,-X-X-.-.-.-.-.-.-,-,-.-.-.-.-.-.-.-.-,-,-,-,-,-,-,-,-,-,-,-.-.-.-.-.-.-.-.-.-.-.-.-.-.-.-.-.-.-.-.-.-X-------------------------
------------------------------,-X-.-.-.-.-.-.-,-.-.-.-.-.-.-.-.-,-,-,-,-,-,-,-,-,-,-.-.-.-.-.-.-.-.-.-.-.-.-.-.-.-.-.-.-.-.-.-.-X-------------------------
--------------------------------,-X-X-.-.-.-.-,-,-.-.-.-.-.-.-.-,-.-,-,-,-,-,-,-.-.-.-.-.-.-.-.-.-.-.-.-.-.-.-.-.-.-.-.-.-.-.-.-X-------------------------
------------------------------------,-X-X-.-.-.-,-,-.-.-.-.-.-.-,-,-,-,-,-,-,-.-.-.-.-.-.-.-.-.-.-.-.-.-.-.-.-.-.-.-.-.-.-.-.-.-X-------------------------
--------------------------------------,-,-X-.-.-.-,-,-.-.-.-.-.-,-,-,-.-,-.-.-.-.-.-.-.-.-.-.-.-.-.-.-.-.-.-.-.-.-.-.-.-.-.-.-.-X-------------------------
------------------------------------------,-X-X-.-.-,-.-.-.-.-.-,-,-,-,-.-.-.-.-.-.-.-.-.-.-.-.-.-.-.-.-.-.-.-.-.-.-.-.-.-.-.-.-X-------------------------
----------------------------------------------,-X-.-,-,-.-.-.-.-.-,-.-.-.-.-.-.-.-.-.-.-.-.-.-.-.-.-.-.-.-.-.-.-.-.-.-.-.-.-.-.-X-------------------------
------------------------------------------------,-X-X-,-,-.-.-.-,-,-.-.-.-.-.-.-.-.-.-.-.-.-.-.-.-.-.-.-.-.-.-.-.-.-.-.-.-.-.-.-X-------------------------
----------------------------------------------------,-X-X-,-,-,-,-.-.-.-.-.-.-.-.-.-.-.-.-.-.-.-.-.-.-.-.-.-.-.-.-.-.-.-.-.-.-.-X-------------------------
------------------------------------------------------,-,-X-.-,-,-.-.-.-.-.-.-.-.-.-.-.-.-.-.-.-.-.-.-.-.-.-.-.-.-.-.-.-.-.-.-.-X-------------------------
----------------------------------------------------------,-X-X-.-.-.-.-.-.-.-.-.-.-.-.-.-.-.-.-.-.-.-.-.-.-.-.-.-.-.-.-.-.-.-.-X-------------------------
--------------------------------------------------------------,-X-.-.-.-.-.-.-.-.-.-.-.-.-.-.-.-.-.-.-.-.-.-.-.-.-.-.-.-.-.-.-.-X-------------------------
----------------------------------------------------------------,-X-X-.-.-.-.-.-.-.-.-.-.-.-.-.-.-.-.-.-.-.-.-.-.-.-.-.-.-.-.-.-X-------------------------
--------------------------------------------------------------------,-X-X-.-.-.-.-.-.-.-.-.-.-.-.-.-.-.-.-.-.-.-.-.-.-.-.-.-.-.-X-------------------------
----------------------------------------------------------------------,-,-X-.-.-.-.-.-.-.-.-.-.-.-.-.-.-.-.-.-.-.-.-.-.-.-.-.-.-X-------------------------
--------------------------------------------------------------------------,-X-X-.-.-.-.-.-.-.-.-.-.-.-.-.-.-.-.-.-.-.-.-.-.-.-.-X-------------------------
------------------------------------------------------------------------------,-X-.-.-.-.-.-.-.-.-.-.-.-.-.-.-.-.-.-.-.-.-.-.-.-X-------------------------
--------------------------------------------------------------------------------,-X-X-.-.-.-.-.-.-.-.-.-.-.-.-.-.-.-.-.-.-.-.-.-X-------------------------
------------------------------------------------------------------------------------,-X-X-.-.-.-.-.-.-.-.-.-.-.-.-.-.-.-.-.-.-.-X-------------------------
--------------------------------------------------------------------------------------,-,-X-.-.-.-.-.-.-.-.-.-.-.-.-.-.-.-.-.-.-X-------------------------
------------------------------------------------------------------------------------------,-X-X-.-.-.-.-.-.-.-.-.-.-.-.-,-,-.-.-X-------------------------
----------------------------------------------------------------------------------------------,-X-.-.-.-.-.-.-.-.-.-.-.-,-,-,-.-X-------------------------
------------------------------------------------------------------------------------------------,-X-X-.-.-.-.-.-.-.-.-.-,-t5,-.-X-------------------------
----------------------------------------------------------------------------------------------------,-X-X-.-.-.-.-,-,-,-t5.-.-.-X-------------------------
------------------------------------------------------------------------------------------------------,-,-X-.-.-.-,-,-t5.-.-.-.-X-------------------------
----------------------------------------------------------------------------------------------------------,-X-X-.-,-,-.-.-.-.-.-X-------------------------
--------------------------------------------------------------------------------------------------------------,-X-.-.-.-.-.-.-.-X-------------------------
----------------------------------------------------------------------------------------------------------------,-X-X-.-.-.-.-.-X-------------------------
--------------------------------------------------------------------------------------------------------------------,-X-X-.-.-.-X-------------------------
----------------------------------------------------------------------------------------------------------------------,-,-X-.-.-X-------------------------
--------------------------------------------------------------------------------------------------------------------------,-X-X-X-------------------------
------------------------------------------------------------------------------------------------------------------------------,-X-------------------------
