--------------------------------------------------------------------------------------------------------------------------------,-,-X~X-,-,-,-,-----------------------------------------------------------------------------------------------------------------------------------
----------------------------------------------------------------------------------------------------------------------------,-,-,-X~.~.~X~X~X~X-,-,-,-----------------------------------------------------------,-,-,-,-,-,-,-,---------------------------------------------------
--------------------------------------------------------------------------------------------------------------------------,-,-X-X~.~.~.~.~.~.~.~X~X~X~,-------------------------------------------------------,-,-X-X-X-X-X-X-X-,-------------------------------------------------
------------------------------------------------------------------------------------------------------------------------,-,-X-.~.~.~.~.~.~.~.~.~.~.~.~X-,-------------------------------------------------,-,-,-X-.-.-.-.-.-.-.-X-,---------------------------------,-,-----------
----------------------------------------------------------------------------------------------------------------------,-,-X-.~.~.~.~.~.~.~.~.~.~.~.~.~.~X-,---------------------------------------------,-,-X-X-.-.-.-.-.-.-.-.-.-X-,---------------------------,-,-,-X-,---------
--------------------------------------------------------------------------------------------------------------------,-,-X~.~.~.~.~.~.~.~,~X~X~X~X~.~.~.~.~X-------------------------------------------,-,-X-.-.-.-.-.-.-.-.-.-.-.-.-X-,-------,-,-,-,---------,-,-X-X-.-X-,-,-----
----------------------------------------------------------------------------------------------------------------,-,-,-X~.~.~.~,~X~X-X-X-X-,-X-X-X~.~.~.~.~X~,-----------------------------------------,-X-.-.-.-.-.-.-.-.-.-.-.-.-.-.-X-------,-X-X-X-----,-,-,-X-.-.-.-.-X-X-,---
--------------------------------------------------------------------------------------------------------------,-,-X-X~.~.~.~,~X~,-,-X-X-X~X~.~.~.~.~.~.~.~.~X~,-------,-,-,-,-,-,-------------------,-,-X-.-.-.-.-.-.-.-.-.-.-.-.-.-.-X-------,-X-.-X---,-,-X-X-.-.-.-.-.-.-.-X-,-
------------------------------------------------------------------------------------------------------------,-,-X-.~.~.~.~,~X~,-X~X~.~.~.~.~.~.~.~.~.~.~.~.~.~X~,---,-,-X-X-X-X-X-,-----------------,-X-.-.-.-.-.-.-.-.-.-.-.-.-.-.-.-X-----,-,-X-+-X-,-,-X-.-A-.-.-.-.-.-H-.-.-X-
----------------------------------------------------------------------------------------------------------,-,-X-.~.~.~.~.~X~,-X~.~.~.~.~.~.~.~.~.~.~,~,~,~,~,~,~X-,-,-X-.-.-.-.-.-X-,-----,-,-,-,-,-,-X-.-.-.-.-.-.-.-.-.-.-.-.-.-.-.-X-,-,-,-X-E-:-E-X-,-X-.-.-.-.-.-.-.-.-.-.-X-
----------------------------------------------------------------------------------------------------------,-X~.~.~.~.~.~X~X-X~.~.~.~.~.~.~.~.~.~,~,~,~.~.-.-.-.-X-X-X-.-.-.-.-.-.-.-X-----,-X-X-X-X-X-.-.-.-.-.-.-.-.-.-.-.-.-.-.-.-.-X-X-X-X-.-.-.-.-,-X5X5.-.-.-.->->->-.-.-.-X-
------------------------------------------,-,-,-,-,-,-,-,-,-,-,-,-,-,-,-,-,-,-,-,-,-,-,-,-,-,-,-,---------,-X~.~.~.~.~X~X-.~.~.~.~.~.~.~.~.~,~,~,~.~.-.-.-.-.-.-.-.-.-.-.-.-.-.-.-.-X-----,-X-.-,-+-.-.-.-.-.-.-.-.-.-.-.-A-.-.-.-.-.-.-+-.-E-.-E-.-E-E-.5,5.-H-.-.->-.->-H-.-.-X-
----------------------------------------,-,-X-X-X-X-X-X-X-X-X-X-X-X-X-X-X-X-X-X-X-X-X-X-X-X-X-X-X---------,-X~.~.~,~X~X~.~.~.~.~.~.~.~.~,~,~,~.-.-.-.-.-.-.-.-.-.-A-.-.-.-.-.-.-E-.-X-----,-X-.-X-X-X-.-.-.-.-.-.-.-.-.-.-.-.-.-.-.-.-X-X-X-X-.-E-.-E-,-X5X5.-.-.-.->->->-.-.-.-X-
--------------------------------------,-,-X-.-.-.-.-.-.-.-.-.-.-.-.-.-.-.-.-.-.-.-.-.-.-.-.-.-.-X---------,-X~.~,~X~,-X~.~.~.~.~.~.~.~,~,~.~.-.-.-.-.-.-.-.-.-.-.-.-.-.-.-.-.-.-.-.-X-----,-X-.-X-,-X-.-.-.-.-.-.-.-.-.-.-.-.-.-.-.-.-X-----,-X-.-.-,-X-,-X-.-.-.-.-.-.-.-.-.-.-X-
------------------------------------,-,-X-.-.-.-.-.-.-.-.-.-.-.-.-.-.-.-.-.-.-.-.-.-.-.-.-.-.-.-X---------,-X~.~X~,-X-.~.~.~.~.~.~.~.~,~.-.-.-.-.-.-,-,-,-,-,-,-X-X-X-.-.-.-.-E-.-,-X-----,-X-.-X---,-X-.-.-.-.-.-.-.-.-.-.-.-.-.-.-.-X-------,-X-X-X---,-X-.-A-.-.-.-.-.-H-.-,-X-
----------------------------------,-,-X-.-.-.-.-.-.-.-.-.-.-.-.-.-.-.-.-.-.-.-.-.-.-.-.-.-.-.-.-X---------,-X~.~X~,-X~.~.~.~.~.~.~.~,~,~.-.-.-.-,-,-,~.~.~.~.~.~X~--,-X-.-E-.-.-,-X-------,-X-E-X---,-X-.-.-.-.-.-.-.-.-.-.-.-.-.-.-.-X-------------------,-X-X-.-.-:-.-.-.-,-X---
--------------------------------,-,-X-.-.-.-.-.-.-.-.-.-.-.-.-.-.-.-.-.-<-.-.-.-.-.-.-.-.-.-:-.-X---------,-X~.~X~X-.~.~.~.~.~.~.~.~,~.-.-.-.-,-,-.~.~.~.~.~.~.~X~----,-X-.-.-,-X---------,-X-.-X-----,-X-.-.-.-.-.-.-.-.-.-.-.-.-.-,-X-----------------------,-X-.-.-.-,-X-X-----
------------------------------,-,-X-.-.-.-.-.-.-.-.-.-.-.-.-.-.-.-.-.-.-.-.-.-.-.-.-.-.-.-.-.-.-X---------,-X~.~X~X~.~.~.~.~.~.~.~,~,~.-.-.-,-,-.~.~.~.~.~.~.~.~X~------,-X-.-X-----------,-X-.-X-------,-X-.-.-.-.-.-.-.-.-.-.-.-,-X---------------------------,-X-X-,-X---------
----------------------------,-,-X-.-.-.-.-.-.-.-.-.-.-.-.-.-.-.-.-.-.-.-.-.-.-.-.-.-.-.-.-.-.-.-X---------,-X~.~X~X~.~.~.~.~.~.~.~,~.-.-W-,-,-.~.~.~.~.~.~.~.~.~X~------,-X-.-X-----------,-X-.-X---------,-X-X-.-.-.-.-.-.-.-.-,-X---------------------------------,-X-----------
--------------------------,-,-X-.-.-.-.-.-.-E-.-.-.-.-.-.-.-.-.-.-.-.-.-.-.-.-.-.-.-.-.-.-.-.-.-X---------,-X~.~X~X~.~.~.~.~.~.~,~,~.-.-.-,-.~.~.~.~.~.~.~.~.~.~X~------,-X-.-X-----------,-X-.-X-------------,-X-.-.-.-.-.-.-,-X-------------------------------------------------
------------------------,-,-X-.-.-.-.-.-.-.-.-.-.-.-.-.-.-.-.-.-.-.-.-.-.-.-.-.-.-.-.-.-.-.-.-.-X---------,-X~.~X~X~.~.~.~.~.~.~,~.-.-.-,-,-.~.~.~.~.~.~.~.~.~.~X~------,-X-.-X-----------,-X-.-X---------------,-X-X-X-X-X-X-X---------------------------------------------------
----------------------,-,-X-.-.-.-.-.-.-.-.-.-.-.-.-.-.-.-.-.-.-.-.-.-.-.-.-.-.-.-.-.-.-.-.-.-.-X---------,-X~.~X~X~.~.~.~.~.~.~,~.-.-.-,-.~.~.~.~.~.~.~.~.~.~,~X-------,-X-.-X-----------,-X-.-X---------------------------------------------------------------------------------
--------------------,-,-X-.-.-.-.-.-.-.-.-.-.-.-.-.-.-.-.-.-.-.-.-.-.-.-.-.-.-.-.-.-.-.-.-.-.-.-X---------,-X~.~X~X~.~.~.~.~.~,~,~.-.-.-,-.~.~.~.~.~.~.~.~.~.~X~--------,-X-.-X-----------,-X-.-X---------------------------------------------------------------------------------
------------------,-,-X-.-.-.-.-.-.-.-.-.-.-.-.-.-.-.-.-.-.-.-.-.-.-.-.-.-.-.-.-.-.-.-.-.-.-.-.-X---------,-X~.~X~X~.~.~.~.~.~,~.~.-.-.-,-.~.~.~.~.~.~.~.~.~,~X---------,-X-.-X-----------,-X-.-X---------------------------------------------------------------------------------
----------------,-,-X-.-.-.-.-.-.-.-.-.-.-.-.-.-.-.-.-.-.-.-.-.-.-.-.-.-.-.-.-.-.-.-.-.-.-.-.-.-X---------,-X~.~X~X-.~.~.~.~.~,~.~.-.-.-,-.~.~.~.~.~.~.~.~.~X~----------,-X-.-X-----------,-X-.-X---------------------------------------------------------------------------------
--------------,-,-X-.-.-.-.-.-.-.-.-.-.-.-.-.-.-.-.-.-.-.-.-.-.-.-.-.-.-.-.-.-.-.-.-.-.-.-.-.-.-X---------,-X~.~X~,-X~.~.~.~.~,~,-.-.-,-,-.~.~.~.~.~.~.~.~,~X---------,-,-X-.-X-----------,-X-.-X---------------------------------------------------------------------------------
------------,-,-X-.-.-.-.-.-.-.-.-.-.-.-.-.-.-.-.-.-.-.-.-.-.-.-.-.-.-.-.-.-.-.-.-.-.-.-.-.-.-.-X---------,-X~.~X~,-X~.~.~.~.~.~,~.-.-,-.~.~.~.~.~.~.~.~.~X~--------,-,-X-.-,-X-------,-,-X-X-.-X---------------------------------------------------------------------------------
----------,-,-X-.-.-.-.-.-.-.-.-.-.-.-.-.-.-.-.-.-.-.-.-.-.-.-.-.-.-.-.-.-.-.-.-.-.-.-.-.-.-.-.-X---------,-X~.~X~,-X-.~.~.~.~.~,~.-.-,-.~.~.~.~.~.~.~.~,~X~------,-,-X-.-,-X-----,-,-X-X-.-.-.-X---------------------------------------------------------------------------------
--------,-,-X-.-.-.-.-.-.-.-.-.-.-.-.-.-.-.-.-.-.-.-.-.-.-.-.-.-.-.-.-.-.-.-.-.-.-.-.-.-.-.-.-.-X---------,-X~.~X~,-X-.~.~.~,~,~,~.-.-,-.~.~.~.~.~.~.~,~X~------,-,-X-.-,-X-------,-X-.-.-.-E-.-X---------------------------------------------------------------------------------
------,-,-X-.-.-.-.-.-.-.-.-.-.-.-.-.-.-.-.-.-.-.-.-.-.-.-.-.-.-.-.-.-.-.-.-.-.-.-.-.-.-.-.-.-.-X---------,-X~,~X~,-,-X~,~,~,-.-.-.-.-,-,-.~.~.~.~.~.~X~--------,-X-.-,-X---------,-X-.-.-.-.-.-X---------------------------------------------------------------------------------
----,-,-X-.-.-.-.-.-.-.-.-.-.-.-.-.-.-.-.-.-.-.-.-.-.-.-.-.-.-.-.-.-.-.-.-.-.-.-.-.-.-.-.-.-.-.-X---------,-X~,~X-X-X-X-,-,-.-.-.-.-.-.-,-.~.~.~.~.~,~X-------,-,-X-,-X-----------,-X-.-.-.-.-.-X---------------------------------------------------------------------------------
--,-,-X-.-.-.-.-.-.-.-.-.-.-.-.-.-.-.-.-.-.-.-.-.-.-.-.-.-.-.-.-.-.-.-.-.-.-.-.-.-.-.-.-.-.-.-.-X---------,-X~.~,~.-.-.-.-,-,-,-,-,-,-,-,-,-.~.~,~X~X~------,-,-X-.-X-------------,-X-.-.-.-.-.-X---------------------------------------------------------------------------------
,-,-X-.-.-.-.-.-.-.-.-.-.-.-.-.-.-.-.-.-.-.-.-.-.-.-.-.-.-.-.-.-.-.-.-.-.-.-.-.-.-.-.-.-.-.-.-.-X---------,-X~.~,~,~.-.-.-,-X-X-X-.-.-.-X-X-X~X-X---------,-,-X-.-,-X-------------,-X-.-X-X-X-X-X---------------------------------------------------------------------------------
,-X-.-.-.-.-.-.-.-.-.-.-.-.-.-.-.-.-.-.-.-.-.-.-.-.-.-.-.-.-.-.-.-.-.-.-.-.-.-.-.-.-.-.-.-.-.-.-X---------,-X~.~.~,~,-.-.-X---,-X-.-.-,-X-,-,-,-,-,-,-,-,-,-X-.-,-X---------------,-X-.-X-----------------------------------------------------------------------------------------
X-.-.-.-.-.-.-.-.-.-.-.-.-.-.-.-.-.-.-.-.-.-.-.-.-.-.-.-.-.-.-.-.-.-.-.-.-.-.-.-.-.-.-.-.-.-.-.-X---------,-X~.~.~.~,~.-,-X---,-X-,-,-,-X-X-X-X-X-X-X-X-X-X-.-,-X-----------------,-X-.-X-----------------------------------------------------------------------------------------
X-.-.-.-.-.-.-.-.-.-.-.-.-.-.-.-.-.-.-.-.-.-.-.-.-.-.-.-.-.-.-.-.-.-.-.-.-.-.-.-.-.-.-.-.-.-.-.-X---------,-X~.~.~.~,~,~X---,-,-X-.-.-.-+-.-.-.-.-.-.-.-:-,-,-X-------------------,-X-E-X-----------------------------------------------------------------------------------------
X-.-.-.-.-.-.-.-.-.-.-.-.-.-.-.-.-.-.-.-.-.-.-.-.-.-.-.-.-.-.-.-.-.-.-.-.-.-.-.-.-.-.-.-.-.-.-.-X---------,-X~X~X~X~X~X~X-,-,-X-.-.-.-,-X-X-X-X-X-X-X-X-X-X-X-,-------------------,-X-.-X-----------------------------------------------------------------------------------------
X-.-.-.-.-.-.-.-.-.-.-.-.-.-.-.-.-.-.-.-.-.-.-.-.-.-.-.-.-.-.-.-.-.-.-.-.-.-.-.-.-.-.-.-.-.-.-.-X.----------------------,-,-X-.-.-.-.-X-------------,-,-X-.-X-X-,-,---------------,-X-.-X-----------------------------------------------------------------------------------------
X-.-.-.-.-.-.-.-.-.-.-.-.-.-.-.-.-.-.-.-.-.-.-.-.-.-.-.-.-.-.-.-.-.-.-.-.-.-.-.-.-.-.-.-.-.-.-.-X.------------------,-,-,-X-.-.-H-.-,-X-----------,-,-X-.-.-.-.-X-X-,-,-----------,-X-.-X-----------------------------------------------------------------------------------------
X-.-.-.-.-.-.-.-.-.-.-.-.-.-.-.-.-.-.-.-.-.-.-.-.-.-.-.-.-.-.-.-.-.-.-.-.-.-.-.-.-.-.-.-.-.-.-,-X.,-,-,-,-,-,-,-,-,-,-X-X-.-.-.-.-.-X-----------,-,-X-.-.-.-.-.-.-.-X-X-,-,-------,-X-.-X-----------------------------------------------------------------------------------------
X-.-.-.-.-.-.-.-.-.-.-.-.-.-.-.-.-.-.-.-.-.-.-.-.-.-.-.-.-.-.-.-.-.-.-.-.-.-.-.-.-.-.-.-.-A-.-,-XNXNX-X-X-X-X-X-X-X-X-.-.-.-.-.-.-,-X-----------,-X-.-.-.-.-.-.-.-.-.-.-X-X-,-,---,-X-.-X-----------------------------------------------------------------------------------------
X-.-.-.-.-.-.-.-.-.-.-<-.-.-.-.-.-.-.-.-.-.-.-.-.-.-.-.-.-.-.-.-.-.-.-.-E-.-.-.-.-.-.-.-.-.-.-,-+N+N.-.-.-.-.-.-E-.-.-.-.-.-.-.-,-X-----------,-,-X-.-.-.-.-.-.-.-.-.-.-.-.-X-X-,-,-X-.-X-----------------------------------------------------------------------------------------
X-.-.-.-.-.-.-.-.-.-.-.-.-<-.-.-.-.-.-.-.-.-.-.-.-.-.-.-.-.-.-.-.-.-.-.-.-.-.-.-.-.-.-.-H-.-.-,-+N+N.-.-.-.-:-.-.-.-.-.-<-.-.-,-X-----------,-,-X-.-.-.-.-.-.-.-.-.-.-.-.-.-.-.-X-,-X-.-X-----------------------------------------------------------------------------------------
X-.-.-.-.-.-.-.-.-.-.-.-.-.-.-.-.-.-.-.-.-.-.-.-.-.-.-.-.-.-.-.-.-.-.-.-.-.-.-.-.-.-.-.-.-A-.-,-+N+NE-.-.-.-.-.-.-.-.-.-.-,-X-X-----------,-,-X-.-.-.-.-.-.-:-.-.-.-.-.-.-.-.-.-X-,-X-.-X-----------------------------------------------------------------------------------------
X-.-.-.-.-.-:-.-.-.-<-.-.-.-.-.-.-.-.-.-.-.-.-.-.-.-.-.-.-.-.-.-.-.-.-.-.-.-.-.-.-.-.-.-.-.-.-,-XNXNX-X-X-X-X-X-X-.-.-.-X-X-----------,-,-,-X-.-.-.-.-.-.-.-.-.-.-.-.-.-.-.-.-.-X-,-X-.-X-----------------------------------------------------------------------------------------
X-.-.-.-.-.-.-.-.-.-.-.-.-<-.-.-.-.-.-.-.-.-.-.-.-.-.-.-.-.-.-.-.-.-.-.-.-.-.-.-.-.-.-.-.-.-.-.-X.------------,-X-.-.-.-X-------,-,-,-,-X-X-,-.-.-.-.-.-.-.-.-.-.-.-.-.-.-.-E-.-X-,-X-.-X-----------------------------------------------------------------------------------------
X-.-.-.-.-.-.-.-.-.-.-.-<-.-.-.-.-.-.-.-.-.-.-.-.-.-.-.-.-.-.-.-.-.-.-.-.-.-.-.-.-.-.-.-.-.-.-.-X.------------,-X-.-.-.-X-,-----,-X-X-X-,-.-,-.-.-.-.-.-.-.-.-.-.-.-.-.-.-.-.-.-X-,-X-.-X-----------------------------------------------------------------------------------------
X-.-.-.-.-.-.-.-.-.-.-.-.-.-.-.-.-.-.-.-.-.-.-.-.-.-.-.-.-.-.-.-.-.-.-.-.-.-.-.-.-.-.-.-.-.-.-.-X.------------,-X-.-H-.-.-X-,-,-,-X-.-.-,-.-,-,-.-.-.-.-E-.-.-.-.-.-.-.-.-.-.-.-X-,-X-.-X-----------------------------------------------------------------------------------------
X-.-.-.-.-.-.-.-.-.-.-.-.-.-.-.-.-.-.-.-.-.-.-.-.-.-.-.-.-.-.-.-.-.-.-.-.-.-.-.-.-.-.-.-.-.-.-.-X-------------,-X-.-.-.-.-.-X-X-X7X7.-.-,-,-.-,-.-.-.-.-.-.-.-.-.-.-.-.-.-.-.-.-X-,-X-.-X-----------------------------------------------------------------------------------------
X-.-.-.-.-.-.-.-.-.-.-.-.-.-.-.-.-.-.-.-.-.-.-.-.-.-.-.-.-.-.-.-.-.-.-.-.-.-.-.-.-.-.-.-.-.-.-.-X---------------,-X-.-.-.-.-.-.-,7,7.-.-.-,-.-,-,-.-.-.-.-.-.-.-E-.-.-.-.-.-.-.-X-,-X-E-X-----------------------------------------------------------------------------------------
X-.-.-.-.-.-.-.-.-.-.-.-.-.-.-.-.-.-.-.-.-.-.-.-.-.-.-.-.-.-.-.-.-.-.-.-.-.-.-.-.-.-.-.-.-.-.-.-X-----------------,-X-X-.-.-:-.-,7,7.-.-<-,-,-.-,-,-.-.-.-.-.-.-.-.-.-.-.-.-.-.-X-,-X-.-X-----------------------------------------------------------------------------------------
,-X-.-.-.-.-.-.-.-.-.-.-.-.-.-.-.-.-.-.-.-.-.-.-.-.-.-.-.-.-.-.-.-.-.-.-.-.-.-.-.-.-.-.-.-.-.-.-X---------------------,-X-.-.-.-,7,7.-.-.-.-,-.-.-,-.-.-.-.-.-.-.-.-.-.-.-.-.-.-X-,-X-.-X-----------------------------------------------------------------------------------------
--,-X-.-.-.-.-.-.-.-.-.-.-.-.-.-.-.-.-.-.-.-.-.-.-.-.-.-.-.-.-.-.-.-.-.-.-.-.-.-.-.-.-.-.-.-.-.-X-----------------------,-X-X-X-X7X7.-.-.-.-,-,-.-,-,-.-.-.-.-.-.-.-.-.-.-.-.-.-X-,-X-.-X-----------------------------------------------------------------------------------------
----,-X-.-.-.-.-.-.-.-.-.-.-.-.-.-.-.-.-.-.-.-.-.-.-.-.-.-.-.-.-.-.-.-.-.-.-.-.-.-.-.-.-.-.-.-.-X-------------------------------,-X-.-.-.-.-.-,-,-.-,-.-.-.-.-.-.-.-E-.-.-:-.-.-X-,-X-.-X-----------------------------------------------------------------------------------------
------,-X-.-.-.-.-.-.-.-.-.-.-.-.-.-.-.-.-.-.-.-.-.-.-.-.-.-.-.-.-.-.-.-.-.-.-.-.-.-.-.-.-.-.-.-X-------------------------------,-X-.-.-.-.-.-.-,-.-,-,-.-.-.-.-.-.-.-.-.-.-.-.-X-,-X-.-X-----------------------------------------------------------------------------------------
--------,-X-.-.-.-.-.-.-.-.-.-.-.-.-.-.-.-.-.-.-.-.-.-.-.-.-.-.-.-.-.-.-.-.-.-.-.-.-.-.-.-.-.-.-X---------------------------------,-X-.-.-.-.-.-,-,-.-,-,-.-.-.-.-.-.-.-.-.-.-.-X-,-X-.-X-----------------------------------------------------------------------------------------
----------,-X-.-.-.-.-.-.-.-.-.-.-.-.-.-.-.-.-.-.-.-.-.-.-.-.-.-.-.-.-.-.-.-.-.-.-.-.-.-.-.-.-.-X---------------------------------,-X-.-H-.-.-.-.-,-.-.-,-.-.-.-.-.-.-.-.-.-.-.-X-,-X-.-X-----------------------------------------------------------------------------------------
------------,-X-.-.-.-.-.-.-.-.-.-.-.-.-.-.-.-.-.-.-.-.-.-.-.-.-.-.-.-.-.-.-.-.-.-.-.-.-.-.-.-.-X-----------------------------------,-X-.-.-.-.-.-,-,-.-,-,-.-.-.-.-E-.-.-.-.-.-X-,-X-.-X-----------------------------------------------------------------------------------------
--------------,-X-.-.-.-.-.-.-.-.-.-.-.-.-.-.-.-.-.-.-.-.-.-.-.-.-.-.-.-.-.-.-.-.-.-.-.-.-.-.-.-X-------------------------------------,-X-.-.-.-.-.-,-.-.-,-.-.-.-.-.-.-.-.-.-,-X-,-X-.-X-----------------------------------------------------------------------------------------
----------------,-X-.-.-.-.-.-.-.-.-.-.-.-.-.-.-.-.-.-.-.-.-.-.-.-.-.-.-.-.-.-.-.-.-.-.-.-.-.-.-X---------------------------------------,-X-.-.-.-.-,-,-.-,-,-.-.-.-.-.-.-,-X-X---,-X-.-X-----------------------------------------------------------------------------------------
------------------,-X-.-.-.-.-.-.-.-.-.-.-.-.-.-.-.-.-.-.-.-.-.-.-.-.-.-.-.-.-.-.-.-.-.-.-.-.-.-X---------------------------------------,-X-.-.-:-.-.-,-.-.-,-.-.-.-.-,-X-X-------,-X-.-X-----------------------------------------------------------------------------------------
--------------------,-X-.-.-.-.-.-.-.-.-.-.-.-.-.-.-.-.-.-.-.-.-.-.-.-.-.-.-.-.-.-.-.-.-.-.-.-.-X-----------------------------------------,-X-.-.-.-.-,-,-,-,-.-.-,-X-X-----------,-X-.-X-----------------------------------------------------------------------------------------
----------------------,-X-.-.-.-.-.-.-.-.-.-.-.-E-.-.-.-.-.-.-.-.-.-.-.-.-.-.-.-.-.-.-.-.-.-.-.-X-------------------------------------------,-X-X-X-X-X-X-+-X-X-X-X-------------,-,-X-.-X-----------------------------------------------------------------------------------------
------------------------,-X-.-.-.-.-.-.-.-.-.-.-.-.-.-.-.-.-.-.-.-.-.-.-.-.-.-.-.-.-.-.-.-.-.-.-X-----------------------------------------------------,-X-+-X-,-,-,-,-,-,-,-,-,-,-X-.-.-X-----------------------------------------------------------------------------------------
--------------------------,-X-.-.-.-.-.-.-.-.-.-.-.-.-.-.-.-.-.-.-.-.-.-.-.-.-.-.-.-.-.-.-.-.-.-X-----------------------------------------------------,-X-.-X-X-X-X-X-X-X-X-X-X-X-.-.-,-X-----------------------------------------------------------------------------------------
----------------------------,-X-.-.-.-.-.-.-.-.-.-.-.-.-.-.-.-.-.-.-.-.-.-.-.-.-.-.-.-.-.-.-.-.-X-----------------------------------------------------,-X-.-A-.-.-.-.-.-.-.-.-.-E-.-,-X-------------------------------------------------------------------------------------------
------------------------------,-X-.-.-.-.-.-.-.-.-.-.-.-.-.-.-.-.-.-.-.-.-.-.-.-.-.-.-.-.-.-.-.-X-----------------------------------------------------,-X-X-X-X-X-X-X-X-X-X-X-X-X-X-X---------------------------------------------------------------------------------------------
--------------------------------,-X-.-.-.-.-.-.-.-.-.-.-.-.-.-.-.-.-.-.-.-.-.-.-.-.-.-.-.-.-.-.-X---------------------------------------------------------------------------------------------------------------------------------------------------------------------------------
----------------------------------,-X-.-.-.-.-.-.-.-.-.-.-.-.-.-.-.-.-.-.-.-.-.-.-.-.-.-.-.-.-.-X---------------------------------------------------------------------------------------------------------------------------------------------------------------------------------
------------------------------------,-X-.-.-.-.-.-.-.-.-.-.-.-.-.-.-.-.-.-.-.-.-.-.-.-.-.-.-.-.-X---------------------------------------------------------------------------------------------------------------------------------------------------------------------------------
--------------------------------------,-X-.-.-.-.-.-.-.-.-.-.-.-.-.-.-.-.-.-.-.-.-.-.-.-.-.-.-.-X---------------------------------------------------------------------------------------------------------------------------------------------------------------------------------
----------------------------------------,-X-.-.-.-.-.-.-.-.-.-.-.-.-.-.-.-.-.-.-.-.-.-.-.-.-.-.-X---------------------------------------------------------------------------------------------------------------------------------------------------------------------------------
------------------------------------------,-X-X-X-X-X-X-X-X-X-X-X-X-X-X-X-X-X-X-X-X-X-X-X-X-X-X-X---------------------------------------------------------------------------------------------------------------------------------------------------------------------------------
