--------------------------------------------------------------------------,-,-,-X-,---------------------------------------------------------------------
----------------------------------------------------------------------,-,-,-X-X-.-X---------------------------------------------------------------------
------------------------------------------------------------------,-,-,-X-X-.-.-.-,-X-------------------------------------------------------------------
--------------------------------------------------------------,-,-,-X-X-.-.-.-.-.-.-X-,-----------------------------------------------------------------
----------------------------------------------------------,-,-,-X-X-.-.-.-.-.-.-.-.-.-X-,---------------------------------------------------------------
------------------------------------------------------,-,-,-X-X-.-.-.-.-.-.-.-.-.-.-.-.-X---------------------------------------------------------------
--------------------------------------------------,-,-,-X-X-,-,-,-,-,-.-.-.-A-A-.-.-.-.-,-X-------------------------------------------------------------
----------------------------------------------,-,-,-X-X-,-,-,-,-,-,-,-,-,-,-.-.-W-.-.-.-.-X-,-----------------------------------------------------------
------------------------------------------,-,-,-X-X-.-,-,-.-.-.-.-.-.-.-.-,-,-,-,-A-.-,-,-,-X-,---------------------------------------------------------
--------------------------------------,-,-,-X-X-.-.-.-,-,-.-.-.-.-.-.-.-.-.-.-.-,-A-,-,---,-,-X---------------------------------------------------------
----------------------------------,-,-,-X-X-.-.-.-.-.-,-,-.-.-.-.-.-.-.-.-.-.-.-,-.-,-------,-.-X-------------------------------------------------------
------------------------------,-,-,-X-X-.-.-.-.-.-.-.-,-,-.-.-.-.-.-.-.-.-.-.-H-,-,-,---------,-X-,-----------------------------------------------------
----------------------------,-,-X-X-.-.-.-.-.-.-.-.-.-,-,-.-.-X-X-X-X-X-X-X-X-X-X-X-X-X-X-X-X-X-X-X-----------------------------------------------------
----------------------------,-X-X-X-X-X-X-X-X-X-X-X-X-X-X-.-.-X-------,-,-,-,-,-,-,-,-,-,-,-,-,-,-------------------------------------------------------
--------------------------------,-,-,-,-,-,-,-,-,-,---,-X-,-,-X-----,-,-X-X-X-X-X-X-X-X-X-X-X-X-X-,-----------------------------------------------------
------------------------------,-,-X-X-X-X-X-X-X-X-X-,-,-X-,-,-X---,-,-X-.-.-.-.-.-.-.-.-.-.-.-.-.-X-,-,-,-----------------------------------------------
----------------------------,-,-X-.-.-.-.-.-.-H-H-,-X-.-X-.-.-,-X-,-X-,-,-,-,-,-,-,-,-,-,-.-.-.-.-.-X-X-X-,---------------------------------------------
--------------------------,-,-X-.-.-.-.-.-.-.-.-.-.-X-X-.-.-.-.-X-X-X-,-,-,-,-,-,-,-,-,-,-.-.-.-.-.-.-E-.-X-,-------------------------------------------
------------------------,-,-X-.-.-.-E-.-.-E-.-.-.-.-X-X-.-.-.-.-.-.-.-.-.-.-.-.-.-.-.-,-,-,-.-.-.-.-.-.-.-.-X-------------------------------------------
----------------------,-,-X-.-.-E-.-.-.-.-.-.-.-.-.-X-X-.-.-.-.-.-.-.-.-.-E-.-.-.-.-.-,-,-,-.-.-.-.-.-.-.-.-X-------------------------------------------
----------------------,-X-.-.-.-.-.-,-,-,-.-.-.-.-,-X-X-,-.-.-.-,-,-,-,-,-,-,-,-,-,-.-.-,-,-.-.-.-.-.-.-.-E-,-X-----------------------------------------
----------------------,-X-.-.-.-,-,-,---,-,-.-.-.-,-X-X-,-,-,-,-,-----E-----------H-.-.-,-,-.-.-.-.-.-.-.-.-.-X-----------------------------------------
----------------------,-X-.-.-E-,-------,-,-.-.-.-,-X-X-,-,-,-,-H-E---------------,-.-.-,-,-.-.-.-.-H-.-.-E-.-X-----------------------------------------
----------------------,-X-.-.-.-,-H-----,-.-.-.-.-,-,-.-.-.-,-,-,-----,-,-,-,-,-,-,-.-.-E-,-,-.-.-.-.-.-.-.-.-X-----------------------------------------
----------------------,-X-.-E-.-,-------,-.-.-.-.-,-,-.-.-.-.-,-,-E-,-,-,-.-.-.-.-.-.-.-,-,-,-.-.-.-.-.-.-.-.-X-----------------------------------------
----------------------,-X-.-.-.-,-----E-,-.-.-.-.-E-,-.-.-E-.-,-.-,-.-,-,-,-,-,-,-,-,-,-.-,-,-.-.-.-.-.-.-E-X-,-----------------------------------------
----------------------,-X-.-E-.-,-------,-.-.-.-.-,-,-.-.-.-.-,-.-,-,-E-,-.-.-.-.-.-.-,-.-,-,-.-.-.-.-.-.-.-X-------------------------------------------
----------------------,-X-.-.-.-,---,-,-,-.-.-.-.-,-,-.-.-.-.-,-,-,-,-.-.-.-.-.-.-.-.-,-.-E-,-.-.-.-.-.-.-,-X-------------------------------------------
----------------------,-X-,-,-,-,-E-,-,-,-,-,-E-,-E-,-,-E-,-E-,-,-.-.-.-.-.-.-.-.-.-.-,-.-,-,-,-.-.-.-E-,-X---------------------------------------------
----------------------,-X-X@+`X@X-,-.-.-.-.-.-.-.-.-.-.-.-.-.-.-.-.-.-.-.-.-.-.-.-.-.-,-.-.-,-,-.-,-X-X-X-----------------------------------------------
----------------,-,-,-,-,-X-+-X-X-.-.-.-.-E-.-.-.-.-.-.-.-.-E-.-.-.-.-.-.-.-.-.-.-.-.-,-,-E-,-,-,-X-----------------------------------------------------
----------------,-X-X-X-X-X@E@X@.-.-.-.-.-.-.-.-.-.-.-.-.-.-.-.-.-.-.-.-.-.-.-.-E-.-.-,-.-.-,-X-X-----------------------,-,-----------------------------
----------------,->-E-.-.-,-,-X-.-A-.-.-.-.-.-.-.-.-.-.-.-.-.-.-.-.-.-.-.-.-.-.-.-.-.-,-,-,-,-X-------------------------,-X-----------------------------
----------------,->-.-.-.-,-X-X-,-,-,-.-.-.-.-.-.-.-.-.-.-.-.-.-E-.-.-.-.-.-.-.-.-.-.-,-.-.-.-X-------------------------,-X-,---------------------------
----------------,-X-E-.-.-,-X-X-,-.-,-,-,-E-.-.-.-.-.-.-.-.-.-.-.-.-.-.-.-.-.-.-.-.-.-,-,-,-,-X-------------------------,-X-X---------------------------
----------------,-X-X-X-X-X-,-X-,-,-,-.-,-,-,-,-,-,-,-,-,-,-,-,-,-,-.-.-.-.-.-.-.-.-.-,-.-.-.-X---------------------------,-X-,-------------------------
--------------------------,-X-.-.-.-,-,-.-.-.-E-.-E-,-.-E-.-.-.-X-X-,-,-.-.-.-.-.-.-.-,-,-,-,-X---------------------------,-X-X-------------------------
--------------------------,-X-.-.-.-,-E-.-.-.-.-.-.-.-.-.-.-.-.-X-X-.-,-.-.-E-.-.-.-.-,-.-.-.-X---------------------------,-X-X-------------------------
--------------------------,-X-.-.-.-E-.-.-.-.-.-.-.-.-.-.-.-.-.-X-X-,-E-,-.-.-.-.-.-.-,-.-.-.-X---------------------------,-X-X-,-----------------------
------------------------,-,-X-.-E-.-,-.-.-.-.-.-.-.-.-.-.-.-.-.-X-X-.-.-,-.-.-.-E-.-.-,-.-.-.-X---------------------------,-X-.-X-----------------------
------------------------,-X-.-.-.-.-,-.-.-.-.-.-.-,-,-,-.-.-.-.-.-.-.-.-,-.-.-.-.-.-.-,-.-.-.-X---------------------------,-X-.-X-,---------------------
------------------------,-X-.-.-.-.-,-.-.-.-.-.-,-W-A-A-,-.-.-.-.-.-.-.-E-.-.-.-.-.-E-,-.-.-.-X-------------------------,-,-X-.-.-X---------------------
------------------------,-X-.-.-.-.-,-.-.-.-.-.-,-------,-.-.-.-.-.-.-.-,-.-.-.-.-.-.-,-E-.-.-X-------------------------,-X-.-.-.-X---------------------
------------------------,-X-.-.-.-.-,-.-.-.-.-.-,-A-----,-,-.-.-.-.-.-.-,-.-.-.-.-.-,-,-.-.-E-X-----------------------,-,-X-.-.-.-X-,-------------------
------------------------,-X-.-.-.-.-,-.-.-.-.-.-,-A---E---,-,-,-.-.-.-E-,-.-.-.-.-.-,-.-.-.-.-X---------------------,-,-X-.-.-.-.-.-X-------------------
------------------------,-X-.-.-.-.-,-.-.-.-.-.-,-------------,-.-.-.-.-,-.-.-.-.-.-,-.-.-.-.-X---------------,-,-,-,-X-.-.-.-.-.-.-X-------------------
------------------------,-X-.-.-.-.-,-.-.-.-.-.-,-,-,-,-,-,-E-,-.-.-.-E-,-.-.-.-.-.-,-.-.-.-.-X-------------,-,-X-X-X-.-.-.-.-.-.-.-X-,-----------------
------------------------,-X-.-E-.-.-,-.-.-.-.-.-.-.-.-.-.-,---,-.-.-.-.-,-.-.-.-.-.-,-,-,-.-.-X-----------,-,-X-.-.-.-.-.-.-.-.-.-.-.-X-----------------
------------------------,-X-.-.-.-.-,-.-.-.-.-.-.-.-.-.-A-,---,-.-.-.-E-,-.-.-.-.-.-.-.-,-,-,-X-----------,-X-.-.-.-.-.-.-.-.-.-.-.-.-X-,---------------
------------------------,-X-.-.-.-E-,-.-.-.-E-.-.-.-.-.-.-,---,-.-.-.-.-,-.-.-.-.-.-.-.-.-.-,-X-----------,-X-.-.-.-.-.-.-.-.-.-.-.-.-.-X---------------
------------------------,-X-,-,-,-,-,-,-.-.-.-.-.-.-.-.-.-,---,-.-.-.-.-,-.-.-.-.-.-.-.-.-.-.-X-----------,-X-.-.-.-.-.-.-.-.-.-.-.-.-.-X---------------
------------------------,-X-.-.-.-.-.-,-.-.-.-.-.-.-.-.-H-,---,-.-A-.-.-,-.-.-.-.-.-.-.-.-.-.-X-----------,-X-.-.-.-.-.-.-.-.-.-.-.-.-.-X-,-------------
------------------------,-X-.-.-.-.-,-,-,-,-.-.-.-.-.-,-,-,---,-X-X-X-X-X-X-.-.-.-.-.-.-.-.-.-X-----------,-X-.-.-.-.-.-.-.-.-.-.-.-.-.-.-X-------------
------------------------,-X-.-.-,-,-,-,-,-,-.-.-.-.-.-,-------,-X-X-X-X-X-X-.-.-.-.-.-.-.-.-.-X-----------,-X-.-.-.-.-.-.-.-.-.-.-.-.-.-.-X-------------
------------------------,-X-,-,-,-.-,-,-.-,-E-.-.-.-,-,-----E-,-.-H-A-A-H-.-.-.-.-.-.-.-.-.-,-X-----------,-X-.-.-.-.-.-.-.-.-.-.-.-.-.-.-X-,-----------
------------------------,-X-,-.-.-.-,-.-.-,-.-.-.-.-,---------,-.-.-.-.-.-.-.-.-.-.-.-.-,-,-,-X-----------,-X-.-.-.-.-.-.-.-.-.-.-.-.-.-.-.-X-----------
--------------------,-,-,-,-X-X-.-,-,-.-E-,-.-.-.-.-,-----E---,-.-H-A-A-H-.-.-.-.-.-,-,-,-.-.-X-----------,-X-.-.-.-.-.-.-.-.-.-.-.-.-.-.-.-X-----------
------------,-,-,-,-,-X-X-X-,-,-X-,-.-.-.-,-,-,-,-,-,-A-------,-X-X-X-X-X-X-.-.-,-,-,-E-.-.-.-X-----------,-X-.-.-.-.-.-.-.-.-.-.-.-.-.-.-.-X-,---------
----,-,-,-,-,-X-X-X-X-.~.~.~X~,-,-X-X-X-X-X-X-.-.-X-X-X-X-X-X-X-X-,-,-,-,-X-X-X-X-X-X-X-.-.-X-X-----------,-X-.-.-.-.-.-.-.-.-.-.-.-.-.-.-.-.-X---------
,-,-,-X-X-X-X-.-.~.~.~.~.~.~.~X~X-,-,-,-,-,-X-,-,-X-X-X-X-X-X-X-X-X-X-X-X-X-X-X-X-X-,-X-.-.-X-,-----------,-X-.-.-.-.-.-.-.-.-.-.-.-.-.-.-.-.-X---------
X-X-X-.-.-.~.~.~.~.~.~.~.~.~.~.~.~X~X~X~X~X-X-.-.-X-X-H-.-.-.-.-.-.-.-X-X-.-.-.-E-X-X-X-.-.-X-X-----------,-X-.-.-.-.-.-.-.-.-.-.-.-.-.-.-.-.-X-,-------
X-.-.~.~.~.~.~.~.~.~.~.~.~.~.~.~.~.~.~.~,~,-.-.-.-,-.-H-.-.-.-E-.-E-.-.-.-.-E-.-.-X-X-.-.-E-.-X-----------,-X-.-.-.-.-.-.-.-.-.-.-.-.-.-.-.-.-.-X-------
X-.-.~.~.~.~.~.~.~.~.~.~.~.~.~.~.~.~.~.~,~,-.-.-.-,-.-.-.-.-.-.-.-.-.-.-.-E-.-,-E-X-X-E-.-.-.-X-----------,-X-.-.-.-.-.-.-.-.-.-.-.-.-.-.-.-.-.-X-------
X-.-.~.~.~.~.~.~.~.~.~.~.~.~.~.~.~.~.~.~,~,-.-.-.-,-.-.-.-.-.-.-.-.-.-X-X-X-X-X-X-X-,-.-.-.-E-X-----------,-X-.-.-.-.-.-.-.-.-.-.-.-.-.-.-.-.-.-X-,-----
X-.-.~.~.~.~.~.~.~.~.~.~.~.~.~.~.~.~.~.~,~,-,-H-,-,-.-.-.-.-.-.-.-.-.-X-X-X-X-X-X-,-,-.-.-.-.-X-----------,-X-.-.-.-.-.-.-.-.-.-.-.-.-.-.-.-.-.-.-X-----
X-.-.~.~.~.~.~.~.~.~.~.~.~.~.~.~.~.~.~.~.~,~,-,-,-,-.-.-.-.-.-.-.-.-.-.-.-.-.-.-.-.-.-.-.-.-.-X-----------,-X-.-.-.-.-.-.-.-.-.-.-.-.-.-.-.-.-.-.-X-----
X-.-.~.~.~.~.~.~.~.~.~.~.~.~.~.~.~.~.~.~.~.~.~.~,~,-.-.-.-.-.-.-E-.-.-.-.-.-.-.-.-.-.-.-.-.-.-X-----------,-X-.-.-.-.-.-.-.-.-.-.-.-.-.-.-.-.-.-.-X-,---
X-.-.~.~.~.~.~.~.~.~.~.~.~.~.~.~.~.~.~.~.~.~.~.~,~,-.-.-.-.-.-.-.-.-.-.-.-.-.-.-.-.-.-.-.-.-.-X-----------,-X-X-X-X-X-X-X-X-X-X-X-X-X-.-.-.-.-.-.-.-X---
X-.-.~.~.~.~.~.~.~.~.~.~.~.~.~.~.~.~.~.~.~.~.~.~,~,-.-.-.-.-.-.-.-.-.-X-X-X-X-X-X-X-X-.-.-.-.-X-,-,-,-,-,-,-,-,-,-,-,-,-,-,-,-,-,-,-X-,-,-,-,-,-,-,-X---
X-.-.~.~.~.~.~.~.~.~.~.~.~.~.~.~.~.~.~.~.~.~.~.~,~,-.-.-.-.-.-.-.-.-.-X-X-X-X-,-X-X-X-.-.-.-.-X-,-X-X-X-X-X-X-X-X-X-X-X-X-X-X-X-X-,-X-.-.-.-.-.-.-.-X---
X-.-.~.~.~.~.~.~.~.~.~.~.~.~.~.~.~.~.~.~.~.~.~.~,~,-,-.-.-.-.-.-.-.-.-X-X-.-.-.-.-X-X-,-,-,-,-X-,-X-.-.-,-.-.-,-.-.-E-.-.-.-.-.-X-,-X-.-.-.-.-.-.-.-X---
X-.-.~.~.~.~.~.~.~.~.~.~.~.~.~.~.~.~.~.~.~.~.~.~.~,~,-,-.-.-.-.-.-.-.-X-X-.-.-.-E-X-X-.-.-.-.-X-,-X-.-.-,-,-.-,-.-.-,-.-.-E-.-.-X-,-X-.-.-.-.-.-.-.-X---
X-.-.~.~.~.~.~.~.~.~.~.~.~.~.~.~.~.~.~.~.~.~.~.~.~.~,~,-,-.-.-.-.-.-.-.-.-E-.-.-.-X-X-.-.-.-.-X-,-X-.-E-.-,-.-,-.-.-,-.-.-.-.-.-X-X-X-.-.-.-.-.-.-.-X---
X-.-.~.~.~.~.~.~.~.~.~.~.~.~.~.~.~.~.~.~.~.~.~.~.~.~.~,~,-,-.-.-.-E-.-.-.-.-.-E-X-X-X-,-,-,-,-X-,-X-,-,-,-X-X-X-X-X-X-X-.-.-.-.-X-X-X-.-.-.-.-.-.-.-X---
X-.-.~.~.~.~.~.~.~.~.~.~.~.~.~.~.~.~.~,~,~,~,~,~,~,~,~.~,~X-X-.-.-.-.-X-X-.-.-X-X-,-X-.-.-.-.-X-,-X-.-.-.-X-X-X-X-X-X-X-.-.-.-.-X-X-X-.-.-.-.-.-.-.-X---
X-.-.~.~.~.~.~.~.~.~.~.~.~.~.~.~.~.~,~,~.-.-.-.-.-.-,-,~.~X~,-X-X-X-X-X-X-X-X-X-,-X-,-,-.-.-.-X-,-X-,-,-,-X-X-A-.-.-.-.-.-.-.-.-X-X-X-.-.-.-.-.-.-.-X---
X-.-.~.~.~.~.~.~.~.~.~.~.~.~.~.~.~,~,~.-.-.-.-.-E-.-.-,-,~X~,-X-X-X-X-X-X-X-X-X-X-.-E-,-,-,-.-X-,-X-.-.-.-X-X-.-.-.-.-.-.-.-.-.-X-X-X-.-.-.-.-.-.-.-X---
X-.-.~.~.~.~.~.~.~.~.~.~.~.~.~.~,~,~.-.-.-.-.-.-.-.-.-.-,-X~X-,-,-.-.-,-.-.-,-.-,-,-.-.-.-,-,-X-,-X-.-.-.-X-X-.-.-.-.-.-.-E-.-.-X-X-X-.-.-.-.-.-.-.-X---
X-.-.~.~.~.~.~.~.~.~.~.~.~.~.~,~,~.-E-.-,-,-,-,-E-,-.-.-.-,-.-.-,-.-.-,-.-.-,-.-.-,-.-.-.-.-,-X-,-X-.-.-.-X-X-.-.-.-.-.-.-.-.-.-X-,-X-.-.-.-.-.-.-.-X---
X-.-.~.~.~.~.~.~.~.~.~.~.~.~,~,~.-.-.-,-,-,-,-,-,-,-,-.-.-,-.-.-,-,-.-,-.-.-,-.-.-,-,-.-E-,-X-,-,-X-,-,-,-X-X-.-B-.-.-.-.-.-.-.-X-,-X-.-.-.-.-.-.-.-X---
X-.-.~.~.~.~.~.~.~.~.~.~.~,~,~.-.-.-,-,-,-,-,-,-.-,-,-,-.-,-.-.-.-,-,-,-.-.-,-.-.-.-,-,-,-X-,-,-X-.-.-.-.-.-X-X-.-E-.-.-.-.-.-E-X-,-X-,-,-,-,-,-,-,-X---
X-.-.~.~.~.~.~.~.~.~.~.~,~,~.-.-.-,-,-,-,-,-.-,-,-.-,-,-,-,-,-.-.-.-,-X-X-X-X-X-X-X-X-X-X-,-,-X-.-E-.-.-.-E-,-X-,-B-.-.-.-.-.-.-X-X-X-.-.-.-.-.-.-.-X---
X-.-.~.~.~.~.~.~.~.~.~,~,~.-E-.-,-,-,-,-.-.-.-.-,-,-,-,-,-,-,-,-,-,-,-X-,-,-,-,-,-,-,-,-,-,-X-.-.-.-.-.-.-.-.-,-,-,-.-.-.-.-.-.-X-X-X-E-.-E-.-.-.-.-X---
X-.-.~.~.~.~.~.~.~.~.~,~.-.-.-,-,-,-,-.-.-.-.-.-.-.-,-,-,-,-.-.-.-.-.-,-X-X-X-X-X-X-X-X-X-X-.-.-.-.-.-.-.-.-.-.-,-X-X-.-.-.-.-H-X-,-X-,-,-,-,-,-,-,-X---
X-.-.~.~.~.~.~.~.~.~.~,~.-.-.-,-,-.-,-.-.-.-.-.-A-.-.-,-.-.-.-.-.-.-.-,-.-.-,-.-.-.-.-.-X-X-.-.-.-.-E-.-.-.-.-.-,-X-X-,-,-,-,-,-X-X-X-,-,-,-,-,-,-,-X-,-
X-.-.~.~.~.~.~.~.~.~.~,~.-.-.-,-,-.-,-,-.-.-.-.-.-.-,-,-.-.-.-.-.-.-.-,-.-.-,-.-.-.-.-.-,-,-.-.-.-.-.-.-.-.-.-.-,-.-.-.-.-.-.-.-,-,-.-E-.-.-.-.-.-<-X-X-
X-.-.~.~.~.~.~.~.~.~.~,~.-.-.-,-,-.-.-,-.-.-W-.-.-.-,-.-.-.-.-.-.-.-.-,-.-.-,-.-.-.-.-.-,-,-.-.-.-.-.-.-.-.-.-.-,-.-.-.-.-W-.-.-,-,-.-.-.-.-.-.-.-.-<-X-
X-.-.~.~.~.~.~.~.~.~.~,~.-.-.-,-,-.-.-,-.-.-.-.-.-,-,-.-.-.-.-.-.-.-.-,-.-.-,-.-E-.-.-.-,-,-.-.-.-.-.-.-.-.-.-.-,-.-.-.-.-.-.-.-,-,-,-,-E-,-.-.-.-<-X-X-
X-.-.~.~.~.~.~.~.~.~.~,~.-.-.-,-,-,-,-,-.-.-.-.-A-,-.-.-,-,-,-.-.-.-.-,-.-.-,-E-.-.-.-.-X-X-.-.-.-.-.-E-.-.-.-.-,-X-X-,-,-,-,-,-X-X-X-H-.-X-X-.-.-<-X---
X-.-.~.~.~.~.~.~.~.~.~,~,-.-.-.-,-,-,-.-.-.-.-,-,-,-.-,-,-,-,-,-,-,-,-,-X-X-X-,-,-,-,-,-X-X-.-.-.-.-.-.-.-.-.-,-,-X-X-.-.-.-E-H-X-,-X-.-.-X-X-,-,-,-X---
X-.-.~.~.~.~.~.~.~.~.~.~,~,-E-.-.-,-,-,-.-,-,-,-.-.-,-,-,-,-,-,-.-.-.-X-,-,-X-,-,-,-,-,-X-,-X-.-,-,-,-,-,-,-,-,-,-,-.-.-.-.-.-.-X-X-X-.-.-X-X-.-.-.-X---
X-.-.~.~.~.~.~.~.~.~.~.~.~,~,-.-.-.-,-,-,-,-.-.-.-,-,-,-.-.-,-,-,-,-,-X-X~,-X-.-.-.-.-.-.-X-,-X-X-X-.-.-.-.-.-,-,-.-.-.-.-.-.-.-.-.-.-.-.-X-X-H-.-.-X---
X-.-.~.~.~.~.~.~.~.~.~.~.~.~,~,-.-.-.-,-,-,-,-,-,-,-,-.-.-,-,-.~.~.~.~.~X~,-X-,-,-,-,-,-,-,-X-X-X-X-,-,-,-,-,-,-.-.-.-.-.-.-.-.-.-.-.-.-.-X-X-.-.-.-X---
X-.-.~.~.~.~.~.~.~.~.~.~.~.~.~,~,-.-.-.-,-,-,-,-,-,-.-.-,-,-.~.~.~.~.~.~X~,-X-E-.-.-.-.-.-.-.-.-,-.-.-.-.-.-.-.-.-.-.-.-.-.-.-.-.-.-.-.-.-X-X-.-.-.-X---
X-.-.~.~.~.~.~.~.~.~.~.~.~.~.~.~,~,-.-.-.-.-.-.-.-.-.-E-,-.~.~.~.~.~.~.~X~,-X-.-.-.-.-.-.-.-.-.-,-.-.-.-.-.-.-.-.-.-.-.-.-.-.-,-,-,-,-.-,-X-X-.-.-.-X---
X-.-.~.~.~.~.~.~.~.~.~.~.~.~.~.~.~,~,-E-.-.-.-.-.-.-.-,-,~.~.~.~.~.~.~.~X~,-X-.-.-E-H-.-.-.-.-.-,-.-.-.-.-.-.-.-.-.-.-.-.-.-.-,-X-,-X-,-X-X-.-.-.-.-X---
X-.-.~.~.~.~.~.~.~.~.~.~.~.~.~.~.~.~,~,-.-.-.-.-.-.-,-,~.~.~.~.~.~.~.~.~X~,-X-.-.-.-.-.-.-.-.-.-,-E-.-.-.-E-.-.-.-.-.-.-.-E-.-,-X-X-X-X-,-X-.-.-.-.-X---
X-.-.~.~.~.~.~.~.~.~.~.~.~.~.~.~.~.~.~,~,-,-,-,-,-,-,-.~.~.~.~.~.~.~.~.~X~,-X-.-.-.-.-.-E-.-.-.-,-.-.-.-.-.-.-.-.-.-.-.-.-.-.-X-,-,-X-X-X-.-.-.-.-.-X---
X-.-.~.~.~.~.~.~.~.~.~.~.~.~.~.~.~.~.~.~.~.~.~.~.~.~.~.~.~.~.~.~.~.~.~.~.~X~,-X-.-.-.-.-.-.-.-.-,-.-.-.-.-.-.-E-.-.-.-.-.-.-,-X-X-X-A-E-.-.-.-.-.-.-X---
X-.-.~.~.~.~.~.~.~.~.~.~.~.~.~.~.~.~.~.~.~.~.~.~.~.~.~.~.~.~.~.~.~.~.~.~.~.~X~,-X-X-X-X-X-X-X-X-X-.-.-.-.-.-X-X-X-X-X-X-X-X-X-X-.-A-.-.-.-.-.-.-.-.-X---
X-.-.~.~.~.~.~.~.~.~.~.~.~.~.~.~.~.~.~.~.~.~.~.~.~.~.~.~.~.~.~.~.~.~.~.~.~.~.~X~X~X~X~X~X~X~X~X~X-,-,-,-,-,-X-X-X-X-X-X-X-X-X-.-A-.-.-.-.-.-.-.-.-.-X---
X-.-.~.~.~.~.~.~.~.~.~.~.~.~.~.~.~.~.~.~.~.~.~.~.~.~.~.~.~.~.~.~.~.~.~.~.~.~.~.~.~.~.~.~.~.~.~,~,-.-.-.-.-.-.-.-.-.-.-.-.-.-.-A-.-.-.-.-.-.-.-.-.-.-X---
X-.-.~.~.~.~.~.~.~.~.~.~.~.~.~.~.~.~.~.~.~.~.~.~.~.~.~.~.~.~.~.~.~.~.~.~.~.~.~.~.~.~.~.~.~.~.~,~,-.-.-.-.-.-.-.-.-.-.-.-.-.-.-.-.-.-.-.-.-.-.-.-E-.-X---
X-.-.~.~.~.~.~.~.~.~.~.~.~.~.~.~.~.~.~.~.~.~.~.~.~.~.~.~.~.~.~.~.~.~.~.~.~.~.~.~.~.~.~.~.~.~.~,~,-,-,-,-,-,-E-,-,-E-,-,-,-,-,-,-,-E-,-,-,-,-,-,-,-,-X---
X-.-.~.~.~.~.~.~.~.~.~.~.~.~.~.~.~.~.~.~.~.~.~.~.~.~.~.~.~.~.~.~.~.~.~.~.~.~.~.~.~.~.~.~.~.~,~,~,-,-,-,-,-,-,-,-,-,-,-,-,-,-,-,-,-,-,-,-,-,-,-,-,-,-X---
X-X-X-X-X-X-X-X-X-X-X-X-X-X-X-X-X-X-X-X-X-X-X-X-X-X-X-X-X-X-X-X-X-X-X-X-X-X-X-X-X-X-X-X-X-X-X-X-X-X-X-X-X-X-X-X-.-.-.-.-.-.-.-.-.-.-.-.-,-,-X-X-X-X-X---
--------------------------------------------------------------------------------------------------------------,-X-X-X-X-X-X-X-X-X-X-X-X-X-X-------------
