----------------------------------------------------------------------------------------,-X-X-X-,-,-,-,-,-,-,-------------------------------------------
----------------------------------------------------------------------------------------,-X-.-.-X-X-X-X-X-X-,-,-,-,-,-,-,-------------------------------
----------------------------------------------------------------------------------------,-X-.-.-.-.-,-,-,-,-X-X-X-X-X-X-,-,-,-,-,-,-,-------------------
----------------------------------------------------------------------------------------,-X-.-.-.-,-,-.-.-.-.-,-,-,-,-,-X-X-X-X-X-X-,-,-,-,-------------
----------------------------------------------------------------------------------------,-X-.-.-,-,-,-,-,-,-,-,-,-,-,-,-,-,-,-,-,-,-X-X-X-X-,-----------
----------------------------------------------------------------------------------------,-X-.-,-,-,-,-.-.-.-.-,-,-,-,-,-,-,-.-.-.-.-.-.-.-.-X-,---------
----------------------------------------------------------------------------------------,-X-,-,-,-,-,-,-,-,-,-,-.-.-.-.-.~,-,-,-,-,-.-.-.-.-.-X-,-------
----------------------------------------------------------------------------------------,-X-,-,-,-.-,-.~.~.~.~.~.~.~.~.~.~.~.~.~.~,-,-,-,-.-.-.-X-,-----
----------------------------------------------------------------------------------------,-X-,-,-.-,-,-.~.~.~.~.~.~.~.~.~.~.~.~.~.~.~.~.~,~.-.-.-.-X-----
----------------------------------------------------------------------------------------,-X-,-,-.-,-.~.~.~.~.~.~.~.~.~.~.~.~.~.~.~.~.~.~,~.-.-.-.-X-----
------------------------------------------------------------------,-,-------------------,-X-,-,-,-,-.~.~.~.~.~.~.~.~.~.~.~.~.~.~.~.~.~.~,~.-.-.-.-X-----
------------------------------------------------------------------,-X-------------------,-X-,-,-,-,~.~.~.~.~.~.~.~.~.~H~.~.~.~.~.~.~.~.~,~.-.-.-.-X-----
------------------------------------------------------------------,-X-------------------,-X-,-,-.-,-.~.~.~.~.~.~.~.~.~.~.~.~.~.~.~.~.~.~,~.-.-.-.-X-----
------------------------------------------------------------------,-X-------------------,-X-,-,-.-,-,-.~.~.~.~.~.~.~.~.~.~.~.~.~.~.~.~.~,~.-.-.-.-X-----
------------------------------------------------------------------,-X-------------------,-X-,-,-.-.-,-,-.~.~.~.~.~.~.~.~.~.~.~.~.~.~.~.~,~.-.-.-.-X-----
------------------------------------------,-,-,-,-,-,-,-,-,-,-,-,-,-X-,-,-,-,-------------X-,-,-.-.-.-,-,~,~.~.~.~.~.~.~.~.~.~.~.~.~.~,~,~.-.-.-.-X-----
------------------------------------------,-X-X-X-X-X-X-X-X-X-X-X-X-X-X-X-X-X-------------,-X-,-.-.-.-.-.-,-,-,~.~.~.~.~.~.~.~.~.~,~,~,-.-.-.-.-.-X-----
------------------------------------------,-X-H-.-.-.-.-.-.-.-.-.-.-.-.-.-.-,-X-----------,-X-,-.-.-.-.-.-.-.-,-X-X~X~,~,~,~X~X~,~,-.-.-.-.-.-.-.-X-----
------------------------------------------,-X-.-.-.-E-.-.-A-.-.-.-.-.-A-.-.-H-X-----------,-X-,-.-.-.-.-.-.-.-.-X-,-X-,-,-,-X-X-.-.-.-.-.-.-.-.-.-X-----
------------------------------------------,-X-.-.-.-.-.-.-.-.-.-.-.-.-.-.-.-.-,-X---------,-X-,-.-.-.-.-.-.-.-,-X-,-X-,-,-,-,-X-.-.-.-.-.-.-.-.-.-X-----
------------------------------------------,-X-.-.-.-.-.-.-.-.-.-.-.-.-.-.-E-.-.-X---------,-X-,-.-.-.-.-.-.-.-,-X-X-,-.-.-,-,-X-.-.-.-.-.-.-.-.-.-X-----
------------------------------------------,-X-E-.-.-.-.-X-X-A-.-A-.-A-X-X-.-.-.-,-X-------,-X-,-.-.-.-.-.-.-.-,-.-,-,-.-,-,-,-,-.-.-.-.-.-.-.-.-.-X-----
------------------------------------------,-X-.-.-.-.-.-X-X-.-.-.-.-.-X-X-.-.-.-.-X-------,-X-,-.-.-.-.-.-.-.-,-.-,-,-,-,---,-,-.-.-.-.-.-.-.-.-.-X-----
------------------------------------------,-X-.-.-.-.-.-+-+-.-.-.-.-W-.-.-E-.-.-.-X-------,-X-,-.-.-.-.-.-.-.-,-.-,---------,-,-.-.-.-.-.-.-.-.-.-X-----
------------------------------------------,-X-.-.-.-.-.-X-X-.-.-.-.-.-X-X-.-.-.-.-X-------,-X-,-.-.-.-.-.-.-.-,-X-X---------,-X-.-.-.-.-.-.-.-.-.-X-----
------------------------------------------,-X-.-.-.-.-.-X-X-A-.-A-.-A-X-X-.-.-.-.-X-------,-X-,-.-.-.-.-.-.-.-,-X-X-,-,-,-,-,-X-.-.-.-.-.-.-.-.-.-X-----
------------------------------------------,-X-.-.-.-.-.-.-.-.-.-.-.-.-.-.-.-.-.-.-X-------,-X-,-.-.-.-.-.-.-,-X-,-X-.-.-.-.-.-X-X-.-.-.-.-.-.-.-.-X-----
------------------------------------------,-X-.-.-.-.-.-.-.-.-.-.-.-.-.-.-.-.-.-.-X-------,-X-,-.-.-.-.-.-,-X-,-X-.-.-.-.-.-.-.-X-X-X-.-.-.-.-.-.-X-----
------------------------------------------,-X-.-.-.-.-.-.-A-.-.-.-.-.-A-.-.-.-.-.-X-------,-X-,-.-.-.-.-,-X-,-,-X-.-.-.-.-.-.-.-X-,-,-X-.-.-.-.-.-X-----
------------------------------------------,-X-.-.-.-.-.-.-.-.-.-.-.-.-.-.-.-.-.-,-X-------,-X-,-.-.-.-,-X---,-X-.-.-.-.-.-.-.-.-.-X---,-X-.-.-.-.-X-----
------------------------------------------,-X-.-.-.-.-.-.-.-.-.-A-.-.-.-.-.-.-,-,-X-,-,-,-,-X-X-.-.-.-X-----,-X-.-.-.-.-.-.-.-,-,-X-----,-X-X-X-X-X-----
------------------------------------------,-X-.-.-.-.-.-.-.-.-.-.-.-.-.-.-.-,-,-.-X-X-X-X-X-X-X-.-.-.-X-----X-,-,-,-,-,-,-,-,-,-----X-------------------
------------------------------------------,-X-.-.-.-.-.-,-A-,-E-,-,-,-A-,-.-,-.-.-,-.-.-.-E-X-X-.-.-.-X---X-------,-,-,-,-,-----------X-----------------
------------------------------------------,-X-.-.-.-.-,-,-.-.-.-.-.-.-.-,-.-,-.-.-,-.-E-.-,-X-X-.-.-.-X-,-X---------,-.-.-,-----------X-----------------
------------------------------------,-,-,-,-X-.-.-.-.-,-.-,-,-,-,-,-,-.-,-.-,-.-.-,-.-.-H-X---,-X-.-.-.-X-X---------,-,-,-,-----------X-----------------
----------------,-,-,-,-,-,-,-,-,-,-,-X-X-X-XC.-.-.-.-,-X-X-A-.-.-,-A-X-X-.-E-.-.-,-.-.-E-X-,---X-.-.-.-X-X-,-,-,-,-,-,-,-,-,-,-,-,---X-----------------
----------------,-X-X-X-X-X-X-X-X-X-,-X-.-.-.C.-.-.-.-,-X-X].-.-.-,-.-X-X-.-,-.-.-,-.-.-.-.-X---,-X-.-.-X-X-,-.-.-,-,-,-,-,-,-.-.-,E--X-----------------
--------,-,-,-,-,-X-.-,-.-,-H-,-,-X-X-.-.-.-.C.-.-.-.-E-.-+].-.-.-,-K-.-,-.-,-.-.-,-.-,-,-E-X-,-,-X-.-.-X-X-,-.-.-,-,-,-,-,-,-.-.-,E--X-----------------
--------,-X-X-X-X-X-,-,-,-,-,-.-.-X-X-.-.-.-.C.-.-.-.-,-X-X].-.-.-,-,-X-X-.-,-,-,-X-X-X-X-X-X-X-X-,-X-.-X-X-,-,-,-,-,-,-,-,-,-,-,-,E--X-----------------
--------,-X-W-.-.-,-,-,-A-.-,-.-.-X-X-.-.-X-XC.-.-.-.-,-X-X-A-,-,-,-A-X-X-.-E-,-X---,-X-,-,-.-.-A-X-X-.-X-X---------------------------X-----------------
--------,-X-X-X-X-X-.-,-,-,-,-,-,-X-Xc+c+cXcX-.-.-.-.-,-.-.-.-.-.-.-.-.-,-.-.-,-X-,-,-X-E-,-.-.-.-X-X-,-X-X---------------------------X-----------------
----------------,-X-H-,-,-.-.-,-.-X-X-.-.-X-X-.-.-.-.-,-,-,-,-,-,-,-,-,-,-.-,-X-X-X-X-X-,-,-,-,-,-,-X-K-X-X---------------------------X-----------------
----------------,-X-.-,-,-,-,-,-.-X-X-.-.-X-X-.-.-.-E-.-.-A-.-.-.-.-.-A-.-.-H-X-X-.-.-.-,-,-,-.-.-.-,D,-X-X-X-X-,-,-,-,-,-,-,-------X-X-----------------
----------------,-X-A-,-H-.-A-,-.-X2X-.-.-X2X-H-.-.-.-.-.-.-.-.-.-.-.-.-.-.-X-X-.-.-,-,-,-,-.-.-.-.-.-.DX-X-,-X-X-X-.-.-.-.-X-X-X-X---------------------
----------------,-X-X-X-X-X-X-X-.-.2.-.-.-X2X-X-X-X-X-X-X-X-X-X-X-X-X-X-X-X-X-X-.-.-,-.-,-,-.-.-.-.-.-,-,-.-X-X-X-X-.-.-.-.-X-X-------------------------
--------------------,-,->->-,-,-X-X2X-.-.-X2X-,-,-E-----,-,-,-E-H-H-X-------,-X-X-X-,-,-,-,-,-.-.-,-,-,-.-,-,-.-X-X-.-.-.-.-.-X-------------------------
,-,-,-,-,-,-,-----,-,-X-.-.-X-X-,-,-X2,2,2X2X-E-.-,-----,-.-.-.-H-H-X-----------,-X-.-.-.-.-,-,-,-,-.-.-.-,-X-X-X-X-.-.-.-.-.-X-,-----------------------
X-X-X-X-X-XLXd----,-X-.-.-E-.-,-X-,-X2.2.2X2X-.-.-,-----,-.-.-.-.-,-X-----------,-X-.-.-.-.-.-.-.-.-.-.-.-.-X-,-X-.-.-.-.-.-.-.-X-----------------------
X-E-.-.-.-tLXd------,-X-.-.-.-X-,-X-X-E-.-X-X-.-.-E-X-X-E-.-.-.-.-E-X-----------,-X-.-.-.-.-.-.-.-.-.-.-.-.-X-,-X-.-.-.-.-.-.-.-X-----------------------
X-.-.-.-.-tKXd------,-X-.-.-,-X-,-X-.-.-.-X-X-.-.-,-X-X-,-.-.-.-.-,-X-,-,-,-,-,-,-X....-.-.-.-.-.-.-.-.-.-.-X-,-X-.-.-.-.-.-.-.-X-----------------------
X-.-.-.-.-tKXd--------,-X-+-X---,-X-.-.-E-X-X-E-.-,-X-X-,-.-.-.-.-,-X-X-X-X-X-X-X-X-.-...-.-.-.-.-.-.-,-X-X-X-,-X-,-,-,-,-,-,-,-X-----------------------
X-.-E-.-.-tKXd------,-,-X-+-X---,-X-.-.-.-X-X-.-.-E-X-X-E-.-.-.-.-E-X-X-K-,-tFA-.-.-.-...-.-.-.-A-,-X-X-X-X-X-X-X-+-+-+-+-+-+-+-X-----------------------
X-.-.-.-.-tKXd--,-,-,-X-,-,-X-,-,-X-.-.-.-X-X-E-,-,-X-X-,-,-,-,-,-,-X-X-,-,-,-,-.-.-.-X-X.X-X-X-X-X-X-.-.-.-.-.-B-.-.-.-.-.-.-.-X-----------------------
X-.-.-.-.-tJXd,-,-X-X_,-.-.-,-X-X[X-.-.-.-X-X-,-,-W-X-X-,-,-,-,-,-,-X-X-E-,-.-,-E-tJ.-X-X-X-X-X-X-.-.-.-.-.-.-.-.-.-.-.-.-.-.-.-X-----------------------
X-.-.-E-.-tJXd,-X_+_+_,-.-.-,-,-+[X;.-.-.-.-X-X-X-X-X-X-X-X-+-+-+-X-X-X-tL,-,-:-.-.-A-X-X-.-.-.-.-.-.-.-.-.-.-.-.-.-.-.-.-.-.-.-X---------,-,-,-,-,-,-,-
X-,-,-,-,-tFXdX?+_+_+_,-,-,-,-,-+[,-,-.-.-.-.-.-.-.-X-X-X-X-+-+-+-X.X-X-.-.-.-tK,-,.,.X.X-.-.-.-.-.-.-.-.-.-.-.-.-.-.-.-.-.-.-.-X---------,-X-X-X-X-X-X-
X-------,-tFXdX_+_+_+_,-.-.-,-,-+[+[+[,-.-.-.-.-.-,-+-.-.-.-.-.-.-...-+-,-.-.-,-..,-,-X-X-E-.-.-.-.-.-.-.-.-.-.-.-.-.-.-.-.-.-.-X---------,-X-.-.-.-.-X-
X-------E-tFXdX_+_+_+_,-.-.-,-,-+[+[+[+[X-X-X-X-X-+-.-.-.-.-.-.-.-...-,-+-,-.-E-..,-..X.X-.-.-.-.-.-X-X-,-,-,-,-,-,-,-X-XB,B,-.-X-,-------,-X-.-.-.-.-X-
X-X-X-X-X-XFXdX_+_+_+_,-.-.-,-,-+[+[+[+[X[----,-X-.-.-.-.-.-.-.-.-.-...-,-X-X-X-X.X-X.X.X-.-.-.-.-.-X-X-.-.-.-.-.-.-.-XBX-.-,B,BXBX-,-----,-X-.-.-.-.-X-
--,-X-X-X-X@XbX_+_+_+_,-.-.-,-,-+[+[+[+[X[X-X-,-X-.-.-.-.-.-.-.-.-.-....,.X.X-,-,-X-X-X-X-.-.-.-.-.-,-.-.-.-.-.-.-.-.-.B.-.-.-,-,-,-X-----,-X-.-W-.-.-X-
--,-X-E-.-t@XbX_+_+_+_,-.-.-.-,-,-,-,-,-,-,-,-X-X-.-.-.-.-.-.-.-.-.-.-.-,-.-X-X-X-.-.-,-.-.-.-.-.-.-,-.-.-.-.-.-.-.-.-.B.-.-A-,-,-X-------,-X-.-.-.-.-X-
--,-X-.-.-t@Xb,-X_+_+_,-,-.-.-.-.-.-.-.-.-.-,-.-L-.-.-.-.-.-.-<-.-.-.-.-A-.-+-.-.-.-.-,-.-.-.-.-.-.-t@.-.-.-.-.-.-.-.-.B.-.-.-,-X-X-------,-X-.-.-.-.-X-
--,-X-,-,-tIXb--,-X_+_+_,-,-.-.-.-.-.-.-.-.-,-.-L-.-.-.-.-.-<-<-.-.-.-W-,-.-+-.-.-.-.-,-.-E-.-.-.-.-,-.-tI.-.-.-.-.-.-.BA-.-W-A-X-,-------,-X-.-.-.-.-X-
----X---,-tIXb--,-X-+_+_+_,-,-,-,-,-,-,-,-,-,-.-L-.-.-.-.-.-.-<-.-.-.-.-A-.-+-.-.-.-.-,-.-.-.-.-.-.-,-.-.-.-.-.-.-.-.-.B.-.-A-B-X-X-,-----,-X-.-.-.-.-X-
----X---E-tIXb----,-X-+_+_+_,---------------,-X-X-.-.-.-.-.-.-.-.-.-.-.-,-X-X-X-X-.-.-,-.-.-.-.-.-.-,-.-.-.-.-.-.-.-.-.B.-.-.-,-,-,-X-----,-X-.-.-.-.-X-
----X-X-X-XIXb,-,-,-,-X_X_X_X_X-X-X-X-X-X-X-X-,-X-,-.-.-.-.-.-.-.-.-.-,-,-X-X---,-X-X-X-X-.-.-.-.-B-,-.-.-.-.-.-.-.-.-.B.-,-,-,-,-X-,-,-,-,-X-.-.-.-.-X-
----------,-X-X-X-X-X-X-X-X-X-X4XTXTXTX-X-X<,-X-.-+-,-.-.-.-.-.-.-.-,-,-+-.-X-,-------,-X-.-.-.-.-.-X-X-,-,-,-,-,-,-,-XBX-,-.-,BXBX-X-X-X-X-XE.-.-.-.-X-
----------,-X-.-.-.-.-.-.-.-.-.4.-+T+T.-E-X<X-.-.-.-+-,-,-,-,-,-,-,-,-+-.-.-.-X-,-----,-X-.-.-.-.-.-X-X-.-.-.-.-.-.-.-X-XB.B.B.-XeX-,-,-,-,-,E.-.-.-.-X-
----------,-X-.-E-.-.-.-.-.-.-.4.-.-XTX-X-X<X-.-.-.-,-X-X-.-.-.-.-X-X-.-.-.-.-.-X-----,-X-.-.-.-.-.-.-.-.-.-.-.-.-.-.-.-.-.-.-.-+e+e.~.~.~,~,E.-.-.-.-X-
--------,-,-X-X-X-X-XT+T+T+TXT.4.-.-.-X-,-X-.-.-.-,-X-,-X-X-+-+-+-X-X-X-.-.-.-.-X-,---,-X-E-.-.-.-.-.-.-.-.-.-.-.-.-.-.-.-.-.-.-+e+e.~.~A~,~,E.-.-.-.-X-
------,-,-X-X-X-X-X-XT+T+T+TXTX4.-.-.-.-X-.-.-.-.-X---,-X-.-.-.-.-.-X-,-X-.-.-.-.-X---,-X-.-.-.-.-.-.-.-.-.-.-.-.-.-.-.-.-.-.-.-+e+e,~,~,~,~,E.-.-.-.-X-
----,-,-X-,-.-,-.-.-.-.-.-.-X-X-.-.-.-.-.-.-.-.-,-X---,-X-,-,-E-,-,-X---,-X-.-.-.-X-,-,-X-.-.-.-.-.-.-.-.-.-.-.-.-.-.-.-.-.-.-,-XeX-.-.-.-.-,E.-.-.-.-X-
--,-,-X-.-,-,-,-.-.-.-.-.-.-X-X-.-.-.-.-.-.-.-,-X-------,-X-.-.-.-X-----,-X-.-.-.-.-X-,-X-X-X-X-X-.-.-.-.-.-.-.-.-.-.-.-.-,-X-X-X-X-X-X-X-X-X-.-.-.-.-X-
--,-X-,-,-,-,-,-.-.-.-.-.-.-X-X-.-.-.-.-.-.-.-X---------,-X-,-,-,-X---,-,-X-.-.-.-.-X-X-X-X-,-,-,-X-X-.-.-.-.-.-.-.-.-.-,-X---------------,-X-.-.-.-.-X-
--,-X-.-.-,-X-X-X-X-X-X-X-X-X-X-X-X-,-,-,-,-X-X-,-----,-,-X-,-,-.-X---,-X-.-.-.-.-.-.-.-.-.-X-X-X-X-,-X-.-.-.-.-.-.-,-X-X-,-,-,-,-,-,-,---,-X-.-.-.-.-X-
--,-X-.-.-.-X-X-X-X-X-X-X-X-X-X-X-X-,-,-,-,-X-X-X-,---,-X-X-.-,-,-X---,-X-.-.-.-.-.-.-.-.-.-.-.-.-.-X-,-X-X-X-.-X-X-X---,-X-X-X-X-X-X-X-,-,-X-.-.-.-.-X-
--,-X-,-,-,-X-X-.-A-.-.-A-.-.-+-.-.-.-.-.-.-.-E-.-X-,-,-X-,-,-.-.-X---,-X-.-.-.-A-.-.-.-.-.-.-,-,-,-,-X-,-,-X-X-X-------,-X-.-.-.-.-.-.-X-,-X-.-.-.-.-X-
--,-X-.-.-,-X-X-.-.-H-.-.-.-.-+-.-.-.-.-.-.-.-.-.-X-X-X-,-.-,-,-,-X---,-X-.-.-.-X-X-X-X-X-X-X-X-X-,-,-,-X-,-----,-,-,-,-,-X-.-X-X-X-X-.-.-X-X-.-.-.-.-X-
--,-X-,-,-,-X-X-.-A-.-.-A-.-.-+-.-.-.-.-.-.-.-.-.-,-.-,-,-.-.-,-X---,-,-X-.-.-.-X-----------,-,-X-.-.-.-.-X-,---,-X-X-X-X-X-.-.-H-X-X-.-,-X-X-.-.-.-.-X-
--,-X-,-.-.-X-X-X-,3,3,-,-X-X-X-X-.-.-.-.-.-.-.-.-,-.-,-,-,-.-,-X---,-X-.-.-.-,-X-,-,-,-,-,-,-,-X-,-,-,-.-.-X---,-X-.-E-X-X-X-X-X-,-X-.-X-,-X-.-.-.-.-X-
--,-X-.-.-.-,-X-X-.-.-.-.-X-X---,-X-.-.-.-.-.-.-.-,-.-.-,-,-,-X---,-,-X-.-.-.-X-,-X-X-X-X-X-X-XP.-.-.-,-,-,-X-,-,-X-.-.-X-,-,-,-X-X-.-.-X-,-X-.-.-.-.-X-
----,-X-.-.-,-.-.-.-.-.-.-E-X---,-X-.-E-.-.-.-.-.-,-.-.-,-,-X---,-,-X-X-,-,-.-X-,-X-E-E-.-.-+P.-.-.-.-.-.-.-.-X-X-XP+P+PXPX-X-X-,-.-.-,-X-,-X-.-.-.-.-X-
------,-X-,-,-.-.-.-.-.-.-.-X---,-X-.-.-.-.-.-.-.-X-X-X-X-X-----,-X-,-,-.-,-,-X-,-X-E-.-.-+P.-.-.-.-.-.-.-.-.-.-.-.-.-.-,-,-,-.-,-.-.-X---,-X-.-.-.-.-X-
--------,-X-X-.-.-.-.-.-.-.-X---,-X-.-.-.-.-.-E-,-X-,-,-,-,-,-,-,-X-,-,-,-,-X---,-X-.-+P+P+P.-.-.-.-.-.-.-.-.-.-.-.-.-.-,-.-,-.-,-,-.-X---,-X-X-X-X-X-X-
------------,-X-X-X-X-X-X-X-X---,-X-.-.-.-.-.-.-,-X-X-X-X-X-X-X-X-.-,-,-,-X---,-,-X-+P+P.-.-.-.-X-X-X-.-.-.-.-.-.-.-.-.-,-,-,-.-.-,-,-X-----------------
--------------------------------,-X-.-.-.-.-.-.-,-X-.-.-.-.-.-X-X-.-.-.-X-,-,-X-X-XP.-.-.-.-.-X-X-X-.-X-X-.-.-X-X-X-.-.-.-X-X-X-X-,-X-------------------
--------------------------------,-X-.-.-.-.-.-.-,-X-.-.-.-.-.-X-X-.-.-.-.-X-X-.-.-.-.-.-.-X-X-X-.-.-X-X-.-.-,-X-,-X-.-.-.-X-----,-X-X-------------------
--------------------------------,-X-.-E-.-.-.-.-,-X-.-.-.-.-.-X-X-.-.-.-.-.-.-.-.-.-.-.-.-.-X-X-.-+-+-.-.-.-X---,-X-.-.-.-X-----------------------------
--------------------------------,-X-.-.-.-.-.-.-,-X-.-.-.-.-.-X-X-.-.-.-.-.-.-.-.-.-.-.-.-.-X-.-X-.-.-.-.-,-X---,-X-.-.-.-X-----------------------------
--------------------------------,-X-.-.-.-.-.-E-,-X-.-.-.-.-.-.-X-X-X-.-.-.-.-.-.-.-X-X-.-.-A-X-X-.-.-.-.-X-----,-X-.-.-.-X-----------------------------
------------------------------,-,-X-.-.-.-.-.-.-,-X-.-.-.-.-.-.-X-,-,-X-.-.-.-.-.-.-X-X-.-.-.-X-X-.-.-.-X-,-----,-X-.-.-.-X-----------------------------
--------------------,-,-,-,-,-,-X-.-.-.-.-.-.-.-,-.-.-.-.-.-.-.-X-,-,-X-X-.-.-.-.-,-X-X-.-.-.-X-X-.-.-,-X-------,-X-.-.-.-X-----------------------------
------------------,-,-X-X-X-X-X-.-.-.-.-.-.-.-.-,-.-.-.-.-.-.-.-X-,-X-.-,-.-.-.-.-X-,-X-.-.-.-X-X-.-.-X---------,-X-.-.-.-X-----------------------------
--------------,-,-X-X-.-.-.-X-X-.-E-.-.-.-.-.-.-,-.-.-.-.-.-.-.-X-.-X-,-,-,-.-.-.-X-,-X-.-.-.-X-X-.-.-X---------,-X-.-.-.-X-----------------------------
------------,-,-X-.-.-.-.-.-.-.-.-.-.-.-.-.-.-.-,-.-.-.-.-.-.-.-X-X-.-,-,-,-.-.-,-X-,-X-.-.-.-X-X-.-.-X---------,-X-X-,-,-X-,---------------------------
------------,-X-.-E-.-E-.-E-.-.-.-.-.-.-.-E-.-.-,-.-.-.-.-.-.-.-X-X-,-.-,-,-,-,-X-----X-.-.-.-.-X-.-.-X---,-,-,-,-X-X-.-,-X-,---------------------------
------------,-X-.-.-.-.-.-.-.-.-.-.-.-.-.-.-.-.-,-.-.-.-.-.-.-.-X-X-,-,-.-,-X-X-------,-X-.-.-.-.-.-.-X-,-,-X-X-X-.-.-.-,-,-X---------------------------
------------,-X-.-E-.-H-,-X-X-X-,-,-,-,-,-,-,-,-B-X-.-.-.-.-.-.-X-X-.-,-,-X-,-----------X-.-.-.-.-.-.-XhX-X-.-.-.-.-.-,-X0X-----------------------------
------------,-X-.-.-,-X-X-,-X-X-X-.-.-.-.-X-X-X-X-X-.-.-.-.-.-.-X-X-.-.-,-X-,-,---------,-X-.-.-.-.-+h+h,-,-,-.-.-.-.-X0--------------------------------
------------,-X-.-E-,-X-X-X-.-.-.-.-.-.-.-.-.-.-.-.-.-.-.-.-.-.-X-X-.-.-.-.-X-X-,-,-,-,-,-,-X-X-.-+h+h+h+h,-,-,-,-.-X-,---------------------------------
----------,-,-X-.-.-,-X-.-.-.-.-.-.-.-.-.-.-.-.-.-.-.-.-.-.-.-.-X-X-.-.-.-.-.-.-X-X-X-X-X-X-X-X-Xh+h+h+h+h,-X-X-A-,-X-----------------------------------
--------,-,-X-X-.-E-,-X-.-.-.-.-.-.-.-.-.-.-.-.-.-.-.-.-.-.-.-.-X-X-.-.-.-.-.-.-.-.-.-.-.-.-.-.-,-+h+h+h+hXh----X-X-------------------------------------
--------,-X-,-,-.-.-,-.-.-.-.-.-.-.-.-.-.-.-.-.-.-.-.-.-.-.-.-.-.-X-X-.-.-.-.-.-.-.-.-.-.-.-.-.-.-,-+h+hXh----------------------------------------------
------,-,-X-,-,-.-E-,-.-.-.-.-.-.-.-.-.-.-.-.-.-.-.-.-.-.-.-.-.-.-X-X-.-.-.-.-.-.-.-.-.-.-.-.-.-.-.-,-Xh------------------------------------------------
------,-X-.-,-,-.-.-,-.-.-.-.-.-.-.-.-.-.-.-.-.-.-.-.-.-.-.-.-.-.-X-,-X-.-.-,-X-X-X-X-X-X-X-.-.-.-,-X---------------------------------------------------
--------,-X-,-,-.-E-,-.-.-.-.-.-.-.-.-.-.-.-.-.-.-.-.-.-.-.-.-.-.-.-X-X-X-X-X-,-,-,-,-,-,-,-X-X-X-X-,---------------------------------------------------
--------,-X-,-,-.-.-,-.-.-.-.-.-.-.-.-.-.-.-.-.-.-.-.-.-.-.-.-.-.-.-X-X-X-X-X-X-X-X-X-X-X-X-X-X-X-X-X---------------------------------------------------
----------,-X-X-.-E-,-X-.-.-.-.-.-.-.-.-.-.-.-.-.-.-.-.-.-.-.-.-.-.-.-.-.-.-.-.-.-.-.-.-.-,-,-X-X-------------------------------------------------------
------------,-X-.-.-E-X-.-.-.-.-.-.-.-.-.-.-.-.-.-.-.-.-.-.-.-.-.-.-.-.-.-.-.-.-.-.-.-,-X-X-X-----------------------------------------------------------
------------,-X-X-+-X-X-.-.-.-.-.-.-.-.-.-.-.-.-.-.-.-.-.-.-.-.-.-.-.-.-.-.-.-.-,-X-X-X-----------------------------------------------------------------
----------,-,-X-X-.-X-X-.-.-.-.-.-.-.-.-.-.-.-.-.-.-.-.-.-.-.-.-.-.-.-.-.-,-,-X-X-----------------------------------------------------------------------
--------,-,-X-X-.-E-,-X-.-.-.-.-.-.-.-.-.-.-.-.-.-.-.-.-.-.-.-.-.-.-.-,-X-X-X---------------------------------------------------------------------------
--------,-X-,-,-.-.-,-.-.-.-.-.-.-.-.-.-.-.-.-.-.-.-.-.-.-.-.-.-,-X-X-X---------------------------------------------------------------------------------
------,-,-X-,-,-.-E-,-.-.-.-.-.-.-.-.-.-.-.-.-.-.-.-.-.-.-,-,-X-X---------------------------------------------------------------------------------------
------,-X-.-,-,-.-.-,-.-.-.-.-.-.-.-.-.-.-.-.-.-.-.-.-,-X-X-X-------------------------------------------------------------------------------------------
--------,-X-,-,-.-E-,-.-.-.-.-.-.-.-.-.-.-.-.-.-,-X-X-X-------------------------------------------------------------------------------------------------
--------,-X-,-,-.-.-,-.-.-.-.-.-.-.-.-.-,-X-X-X-X-------------------------------------------------------------------------------------------------------
----------,-X-X-.-.-,-X-.-.-.-.-,-X-X-X-X---------------------------------------------------------------------------------------------------------------
------------,-X-X=X=X=X-,-X-X-X-X-----------------------------------------------------------------------------------------------------------------------
--------------------,-X-X-------------------------------------------------------------------------------------------------------------------------------
