--------------------------------------------------------------------------------,-,-X-X-X-X-X-X-X-X-X-X-X-X-X-X-X-X-X-X-X-,-------------------------------------------------------
------------------------------------------------------------------------------,-,-X-.-.-.-.-.-.-.-.-.-.-.-.-.-.-.-.-.-.-.-X-,-----------------------------------------------------
----------------------------------------------------------------------------,-,-X-.-.-.-.-.-.-.-.-.-.-.-.-.-.-.-.-.-.-.-.-.-X-,---------------------------------------------------
--------------------------------------------------------------------------,-,-X-.-.-.-.-.-.-.-.-.-.-.-.-.-.-.-.-.-.-.-.-.-.-.-X-,-------------------------------------------------
--------------------------------------------------------------------------,-X-.-.-.-.-.-.-.-.-.-.-.-.-.-.-.-.-.-.-.-.-.-.-.-.-.-X-------------------------------------------------
--------------------------------------------------------------------------,-X-.-.-.-.-.-.-.-.-.-.-.-.-.-.-.-.-.-.-.-.-.-.-.-.-.-X-------------------------------------------------
--------------------------------------------------------------------------,-X-.-.-.-.-.-.-.-.-.-.-.-.-.-.-.-.-.-.-.-.-.-.-.-.-.-X-------------------------------------------------
--------------------------------------------------------------------------,-X-.-.-.-.-.-.-.-.-.-.-.-.-.-.-.-.-.-.-.-.-.-.-.-.-.-X-------------------------------------------------
--------------------------------------------------------------------------,-X-.-.-.-.-.-.-.-.-.-.-.-.-.-.-.-.-.-.-.-.-.-.-.-.-.-X-------------------------------------------------
--------------------------------------------------------------------------,-X-.-.-.-.-.-.-.-.-.-.-.-.-.-.-.-.-.-.-.-.-.-.-.-.-.-X-------------------------------------------------
--------------------------------------------------------------------------,-X-.-.-.-.-.-.-.-.-.-.-.-.-.-.-.-.-.-.-.-.-.-.-.-.-.-X-------------------------------------------------
--------------------------------------------------------------------------,-X-.-.-.-.-.-.-.-.-.-.-.-.-.-.-.-.-.-.-.-.-.-.-.-.-.-X-------------------------------------------------
--------------------------------------------------------------------------,-X-.-.-.-.-.-.-.-.-.-,-,-,-,-,-,-.-.-.-.-.-.-.-.-.-.-X-------------------------------------------------
--------------------------------------------------------------------------,-X-.-.-.-.-.-.-.-.-X-X-X-.-.-.-X-X-.-.-.-.-.-.-.-.-.-X-------------------------------------------------
--------------------------------------------------------------------------,-X-.-.-.-.-.-.-.-.-X-,-X-,-,-,-X-X-.-.-.-.-.-.-.-.-.-X-------------------------------------------------
--------------------------------------------------------------------------,-X-.-.-.-.-.-.-.-,-X-,-X-,-<-,-,-X-.-.-.-.-.-.-.-.-.-X-------------------------------------------------
--------------------------------------------------------------------------,-X-.-.-.-.-.-.-.-,-X-X-,-.-.-,-,-X-.-.-.-.-.-.-.-.-.-X-------------------------------------------------
--------------------------------------------------------------------------,-X-.-.-.-.-.-.-.-,-.-,-,-.-H-,-,-,-.-.-.-.-.-.-.-.-.-X-------------------------------------------------
--------------------------------------------------------------------------,-X-.-.-.-.-.-.-.-,-.-,-E-,-,-.-,-,-.-.-.-.-.-.-.-.-.-X-------------------------------------------------
--------------------------------------------------------------------------,-X-.-.-.-.-.-.-.-,-.-,-.-.-E-.-,-,-.-.-.-.-.-.-.-.-.-X-------------------------------------------------
--------------------------------------------------------------------------,-X-.-.-.-.-.-.-.-,-X-X-.-.-.-.-,-X-.-.-.-.-.-.-.-.-.-X-------------------------------------------------
--------------------------------------------------------------------------,-X-.-.-.-.-.-.-.-,-X-X-:-.-.-.-,-X-.-.-.-.-.-.-.-.-.-X-------------------------------------------------
--------------------------------------------------------------------------,-X-.-.-.-.-.-.-,-X-,-X-.-.-.-.-.-X-X-.-.-.-.-.-.-.-.-X-------------------------------------------------
--------------------------------------------------------------------------,-X-.-.-.-.-.-,-X-,-X-.-.-.-.-.-.-.-X-X-X-.-.-.-.-.-.-X-------------------------------------------------
--------------------------------------------------------------------------,-X-.-.-.-.-,-X-,-,-X-.-.-.-.-.-.-.-X-,-,-X-.-.-.-.-.-X-------------------------------------------------
--------------------------------------------------------------------------,-X-.-.-.-,-X---,-X-.-.-.-.-.-.-.-.-.-X---,-X-.-.-.-.-X-------------------------------------------------
--------------------------------------------------------------------------,-X-X-X-X-X---,-,-X-.-.-.-.-.-.-.-,-,-X-,---,-X-X-X-X-X-------------------------------------------------
--------------------------------------------------------------------------------------,-,-X-,-,-,-,-,-,-,-,-,-.-.-X-,-------------------------------------------------------------
--------------------------------------------------------------------------------------,-X-.-.-.-,-,-.-.-,-.-.-.-.-.-X-------------------------------------------------------------
--------------------------------------------------------------------------------------,-X-.-.-.-.-,-,-,-,-.-.-.-.-.-X-------------------------------------------------------------
--------------------------------------------------------------------------------------,-X-.-.-.-.-,-,-,-,-.-.-.-.-.-X-------------------------------------------------------------
--------------------------------------------------------------------------------------,-X-,-E-,-,-,-,-,-,-,-,-E-,-.-X-------------------------------------------------------------
--------------------------------------------------------------------------------------,-X-,-.-.-,-,-,-,-,-,-.-.-,0.-X-------------------------------------------------------------
--------------------------------------------------------------------------------------,-X-,-.-.-,-,-,-,-,-,-.-.-,0.-X-------------------------------------------------------------
--------------------------------------------------------------------------------------,-X-,-,-,-,-,-,-,-,-,-,-,-,0.-X-------------------------------------------------------------
--------------------------------------------------------------------------------------,-X-.-.-.-.-.-.-.-.-.-.-.-.-.-X-------------------------------------------------------------
--------------------------------------------------------------------------------------,-X-.-.-.-.-.-.-.-.-.-.-.-.-.-X-------------------------------------------------------------
--------------------------------------------------------------------------------------,-X-.-.-.-.-.-.-.-.-.-.-.-.-.-X-------------------------------------------------------------
--------------------------------------------------------------------------------------,-X-X-X-.-:-.-.-.-.-.-.-.-,-X-X-------------------------------------------------------------
--------------------------------------------------------------------------------------------,-X-X-.-.-.-.-X-X-X-X-----------------------------------------------------------------
----------------------------------------------------------------------------------------------,-X-.-.-.-.-X-X---------------------------------------------------------------------
----------------------------------------------------------------------------------------------,-X-.-.-.-.-.-X---------------------------------------------------------------------
--------------------------------------------------------------------------------------------,-,-X-.-.-.-.-.-X-,-------------------------------------------------------------------
--------------------------------------------------------------------------------------------,-X-.-.-.-.-.-.-.-X-------------------------------------------------------------------
--------------------------------------------------------------------------------------------,-X-.-.-.-.-.-.-.-X-------------------------------------------------------------------
--------------------------------------------------------------------------------,-,-,-,-,-,-,-X-.-.-.-.-.-.-.-X-,-,-,-,-,---------------------------------------------------------
--------------------------------------------------------------------------------,-X-X-X-X-X-X-X-,-,-,-,-,-,-,-X-X-X-X-X-X---------------------------------------------------------
--------------------------------------------------------------------------------,-X-.-.-.-.-.-.-.-.-.-.-.-.-.-.-.-.-.-W-X---------------------------------------------------------
--------------------------------------------------------------------------------,-X-.-.-.-.-.-.-.-.-.-.-.-.-.-.-.-.-B-.-X---------------------------------------------------------
--------------------------------------------------------------------------------,-X-.-.-.-.-.-.-.-.-.-.-.-.-.-.-.-.-.-B-X---------------------------------------------------------
------------------------------------------------------------------------------,-,-X-.-.-.-.-.-.-.-.-.-.-.-.-.-.-.-.-.-.-X---------------------------------------------------------
----------------------------------------------------------------------------,-,-X-.-.-.-.-.-.-.-B-.-.-.-.-.-.-.-.-.-.-.-,-X-------------------------------------------------------
----------------------------------------------------------------------------,-.-X-.-.-.-.-.-X-X-,-,-,-,-,-,-,-X-X-.-.-.-.-X-------------------------------------------------------
--------------------------------------------------------------------------,-,-X-.-.-.-.-.-.-X-X-.-.-.-.-.-.-.-X-X-.-.-.-.-,-X-----------------------------------------------------
--------------------------------------------------------------------------,-X-<-.-.-.-.-.-.-,-,-.-.-.-.-.-.-.-,-.-.-.-.-.-.-X-----------------------------------------------------
------------------------------------------------------------------------,-,-X-<-.-.-.-.-.-.-,-,-,-.-.-.-.-.-.-,-.-.-.-.-.-.-X-----------------------------------------------------
------------------------------------------------------------------------,-X-X-.-.-.-.-.-.-.-,-.-,-,-:-.-.-.-.-,-.-.-.-.-.-.-X-----------------------------------------------------
------------------------------------------------------------------------,-X-.-<-.-<-.-.-.-.-,-.-.-,-,-,-.-.-.-,-.-.-.-.-.-.-X-----------------------------------------------------
------------------------------------------------------------------------,-X-X-<-.-.-.-.-.-.-,-.-.-.-.-,-,-.-.-,-.-.-.-.-:-.-X-----------------------------------------------------
--------------------------------------------------------------------------,-X-.-.-.-.-.-.-.-,-.-.-.-.-.-,-,-.-,-.-.-.-.-.-.-X-----------------------------------------------------
--------------------------------------------------------------------------,-X-.-.-.-.-.-.-.-,-.-.-.-.-.-.-,-,-,-.-.-.-.-.-B-X-----------------------------------------------------
----------------------------------------------------------------------------,-X-.-.-.-.-.-.-X-X-.-.-.-.-.-.-,-X-X-.-.-.-.-.-X-,-,-,-,-,-------------------------------------------
------------------------------------------------------------------------------X-.-.-.-.-.-.-X-X-.-.-.-.-.-.-.-X-X-.-.-.-.-.-X-X-X-X-X-X-,-,-,-,-,-,-------------------------------
------------------------------------------------------------------------------,-X-.-.-.-.-.-,-.-.-.-.-.-.-.-,-,-.-.-.-.-.-.-.-.-.-.-.-.-X-X-X-X-X-X-------------------------------
--------------------------------------------------------------------------------,-X-.-.-.-.-,-,-.-.-.-.-.-.-,-.-.-.-.-.-.-.-.-.-.-.-.-.-.-.-.-.-.-X-,-----------------------------
--------------------------------------------------------------------------------,-X-.-.-.-.-.-,-.-.-B-.-.-.-,-.-.-.-.-.-.-.-.-.-.-.-.-.-.-.-.-.-.-.-X-----------------------------
--------------------------------------------------------------------------,-,-,-,-X-X-.-.-.-X-X-,-,-X-X-X-,-,-X-X-X-X-X-X-X-X-X-X-X-X-.-.-.-.-.-.-.-X-,---------------------------
--------------------------------------------------------------------------,-X-X-X-X-X1,1,1,1X1X-,-,-X-X-X-,-,-X-X-X-X-X-X-,---------,-X-X-X-X-X-.-.-.-X---------------------------
--------------------------------------------------------------------------,-X-.-A-.-.-.-A-.-.-.-A-.-.-.-.-.-.-.-.-.-.-.-.-X-----------------,-X-.-.-.-X-,-------------------------
------------------------------------------------------------------------,-,-X-.-.-.-.-.-.-.-.-.-.-.-.-.-.-.-.-.-.-.-.-.-.-X-,-----------------,-X-.-.-.-X-------------------------
------------------------------------------------------------------------,-X-.-.-.-.-.-.-.-.-.-.-.-.-.-.-.-.-.-.-.-.-.-.-.-.-X-----------------,-X-.-.-.-X-------------------------
------------------------------------------------------------------------,-X-.-.-.-.-.-.-.-.-.-.-.-.-.-.-.-.-.-.-.-.-.-.-.-.-X-----------------,-X-.-:-.-X-------------------------
----------------------------------------------------------------------,-,-X-.-.-.-.-.-.-.-.-.-.-.-.-.-.-.-.-.-.-.-.-.-.-.-.-X-----------------,-X-+-+-+-X-------------------------
----------------------------------------------------------------------,-X-.-.-.-.-.-.-.-.-.-.-.-.-.-.-.-.-.-.-.-.-.-.-.-.-.-X-,-,-,-,-,-,-,-,-,-X-.-.-.-X-,-,-,-,-,-,-,-,-,-,-,-,-
--------------------------------------------------------------------,-,-X-.-.-.-.-.-.-.-.-.-.-.-.-.-.-.-.-.-.-.-.-.-.-.-.-.-X-,-X-X-X-X-X-X-X-,-X-.-.-.-X-,-X-X-X-X-X-X-X-X-X-X-X-
--------------------------------------------------------------------,-X-.-.-.-.-.-.-.-.-.-.-.-.-.-.-.-.-.-.-.-.-.-.-.-.-.-,-X-,-X-.-.-.-.-.-X-,-X-.-.-.-X-,-X-.-.-.-.-.-.-.-.-.-X-
--------------------------------------------------------------------,-X-.-.-.-.-.-.-.-.-.-.-.-.-.-.-.-.-.-.-.-.-.-.-.-.-.-,-XQXQX-,-,-,-,-,-X-X-X-.-.-.-X-X-X-,-,-,-,-,-,-,-.-.-X-
--------------------------------------------------------------------,-X-.-.-.-.-.-.-.-.-.-.-.-.-.-.-W-.-.-.-.-.-.-.-.-.-.-,-+Q+Q.-,-.-.-E-.-.-.-.-.-.-.-.-.-.-.-.-.-.-.-.-,-.-.-X-
--------------------------------------------------------------------,-X-.-.-.-.-.-.-.-.-.-.-.-.-.-.-.-.-.-.-.-.-.-.-.-.-.-,-+Q+Q.-,-.-.-.-.-.-.-.-.-.-.-.-.-.-.-.-.-.-.-.-,-.-.-X-
--------------------------------------------------------------------,-X-.-.-.-.-.-.-.-.-.-.-.-.-.-.-.-.-.-.-.-.-.-.-.-.-.-,-+Q+Q.-,-.-.-.-.-.-.-.-.-.-.-.-.-.-.-.-.-.-.-.-,-.-.-X-
--------------------------------------------------------------------,-X-.-.-.-.-.-.-.-.-.-.-.-.-.-.-.-.-.-.-.-.-.-.-.-.-<-,-+Q+Q.-,-.-.-.-.-.-.-.-.-.-.-.-.-.-.-.-.-.-.-.-:-.-.-X-
------------------------------------------------------------------,-,-X-.-.-.-.-.-.-.-.-.-.-.-.-.-H-.-.-.-.-.-.-.-.-.-.-.-,-+Q+Q.-,-.-.-.-.-.-.-.-.-.-.-.-.-.-.-.-.-.-.-.-,-.-.-X-
------------------------------------------------------------------,-X-.-.-.-.-.-.-.-.-.-.-.-.-.-.-.-.-.-.-.-.-.-.-.-.-.-,-,-+Q+Q.-,-.-.-.-.-.-.-.-.-.-.-.-.-.-.-.-.-.-.-.-,-.-.-X-
------------------------------------------------------------------,-X-.-.-.-.-.-.-.-.-.-.-.-.-.-.-.-.-.-.-.-.-.-.-.-.-,-,-+Q+Q+Q.-,-.-.-.-.-.-.-.-.-.-.-.-.-.-.-.-.-.-.-.-,-.-.-X-
------------------------------------------------------------------,-X-.-A-.-.-.-.-.-.-.-.-.-.-.-.-.-A-.-.-.-.-.-.-.-.-,-+Q+Q+Q+Q.-,-.-.-.-.-.-.-.-.-.-.-.-.-.-.-.-.-.-.-E-,-.-.-X-
------------------------------------------------------------------,-X-.-.-.-.-.-.-.-.-.-.-.-.-.-.-.-.-.-.-.-.-.-.-.-.-,-+Q+Q+Q+Q.-,-.-.-.-.-.-.-.-.-.-.-.-.-.-.-.-.-.-.-.-,-.-.-X-
------------------------------------------------------------------,-X-X-.-.-.-.-.-.-.-.-.-.-.-.-.-.-.-.-.-.-.-.-.-.-.-,-+Q+Q+Q+Q.-,-.-.-.-.-.-.-.-.-.-.-.-.-.-.-.-.-.-.-.-,-.-.-X-
--------------------------------------------------------,-,-,-,-,-,-,-,-X-X-.-.-.-.-.-.-.-.-.-.-.-.-.-.-.-.-.-.-.-.-.-,-+Q+Q+Q+Q.-,-.-.-.-.-.-.-.-.-.-.-.-.-.-.-.-.-.-.-.-,-.-.-X-
----------------------------------------------------,-,-,-X-X-X-X-X-X-X-X-X-.-.-.-.-.-.-.-.-.-.-.-.-.-.-.-.-.-.-.-.-.-,-+Q+Q+Q+Q.-,-.-.-.-.-.-.-.-.-.-.-.-.-.-.-.-.-.-.-.-,-.-.-X-
--------------------------------------------------,-,-X-X-,-,-,-,-,-.-.-.-.-.-.-.-.-.-.-.-.-.-.-.-.-.-.-.-.-.-.-.-.-.-,-+Q+Q+Q+Q.-,-.-.-.-.-.-.-.-.-.-.-.-.-.-.-.-.-.-.-.-,-.-.-X-
--------------------------------------------------,-X-.-.-,-,-,-,-,-.-.-.-.-.-.-.-.-.-.-.-.-.-.-.-.-.-.-.-.-.-.-.-.-.-,-+Q+Q+Q+Q.-,-.-.-:-.-.-X-X-,-,-,-,-,-,-,-X-X-.-.-.-,-.-.-X-
------------------------------------------------,-,-X-.-.-,-,-,-,-,-.-.-.-.-.-.-.-.-.-.-.-.-.-.-.-.-.-.-.-.-.-.-.-.-.-,-+Q+Q+Q+Q.-,-.-.-.-.-.-X-X-,-,-,-,-,-,-,-X-X-.-.-.-,-.-.-X-
------------------------------------------------,-X-.-A-,-X-X-X-X-X-X-X-X-X-.-.-.-.-.-.-.-.-.-.-.-.-.-.-.-.-.-.-.-.-.-,-XQXQXQXQX-X-X-.-.-.-.-X-X-,-,-,-,-,-,-,-X-X-.-.-.-,-.-.-X-
----------------------------------------------,-,-X-.-.-X---------,-,-,-X-X-.-.-.-.-.-.-.-.-.-.-.-.-.-.-.-.-.-.-.-.-.-.-X---------,-X-.-.-.-.-X-X-.-.-.-.-.-.-.-X-X-.-.-.-,-.-.-X-
----------------------------------------------,-X-E-.-.-X---------,-X-X-.-.-.-.-.-.-.-.-.-.-.-.-.-.-.-.-.-.-.-.-.-.-.-,-X---------,-X-.-.-.-.-X-X-.-:-.-.-.-.-.-X-X-.-.-.-,-.-.-X-
----------------------------------------------,-X-.-.-:-X---------,-X-.-.-.-.-.-.-.-.-.-.-.-.-.-.-.-.-.-.-.-.-.-.-,-X-X-----------,-X-.-.-.-.-X-X-E-.-.-E-.-E-.-X-X-.-.-.-,-.-.-X-
----------------------------------------------,-X-.-H-.-X---------,-X-.-A-.-.-.-.-.-.-.-.-.-.-.-.-.-.-.-.-.-.-.-,-X---------------,-X-.-.-.-.-X-X-X-X-X-X-X-X-X-X-X-.-.-.-,-.-.-X-
----------------------------------------------,-X-.-.-.-X---------,-X-.-.-.-.-.-.-.-.-.-.-.-.-.-.-.-.-.-.-.-.-.-X-----------------,-X-.-.-.-.-X-X-X-X-X-X-X-X-X-X-X-.-.-.-,-.-.-X-
----------------------------------------------,-X-.-.-.-X-,---------,-X-.-.-.-.-.-.-.-.-.-.-.-.-.-.-.-.-.-.-.-,-X-----------------,-X-.-.-.-.-.-.-.-.-.-.-.-.-:-.-.-.-.-.-,-.-.-X-
------------------------------------------------,-X-.-.-.-X---------,-X-.-.-.-.-.-.-.-.-.-.-.-.-.-.-.-.-.-.-,-X-------------------,-X-.-.-.-.-.-.-.-.-.-.-.-.-.-.-.-.-.-.-,-.-.-X-
------------------------------------------------,-X-.-A-.-X-,-------,-X-.-.-.-.-.-.-.-.-.-.-.-.-.-.-.-.-.-.-X---------------------,-X-.-.-.-.-.-.-.-.-.-.-.-.-.-.-.-.-.-.-,-.-.-X-
--------------------------------------------------,-X-.-.-.-X-,-----,-X-.-.-.-.-.-.-.-.-.-.-.-.-.-.-.-.-.-.-X---------------------,-X-,-,-,-,-,-,-,-,-,-E-,-,-,-,-,-,-,-,-,-.-.-X-
--------------------------------------------------,-X-.-E-.-.-X-,---,-X-.-.-.-.-.-.-.-.-.-.-.-.-.-.-.-.-.-.-X---------------------,-X-X-X-.-.-.-X-X-X-.-.-.-.-.-.-.-.-.-.-.-.-.-X-
----------------------------------------------------,-X-.-.-.-.-X-----,-X-.-.-.-.-.-.-.-.-.-.-.-.-.-.-.-.-.-X---------------------,-,-X-.-.-.-.-X-,-X-.-.-.-.-.-.-.-.-.-.-.-.-.-X-
----------------------------------------------------,-X-.-.-A-.-X-,---,-X-.-.-.-.-.-.-.-.-.-.-.-.-.-.-.-.-.-X---------------------,-.-X-.-.-.-.-X-,-X-X-X-X-X-X-X-X-X-X-X-X-X-X-X-
------------------------------------------------------,-X-.-.-,-,-X---,-X-.-.-.-.-.-.-.-.-.-.-.-.-.-.-.-.-.-X-------------------,-,-X-.-.-.-.-.-X---------------------------------
------------------------------------------------------,-X-,-,-,-.-X-,---,-X-.-.-.-.-.-.-.-.-.-.-.-.-.-.-.-.-X-------------------,-X-.-.-.-.-.-.-X---------------------------------
------------------,-,-,-,-,-,-,-,-,-,-,-,-,-,-,---------,-X-.-.-.-.-X---,-X-.-.-.-.-.-.-.-.-.-.-.-.-.-.-.-.-X-------------------,-X-,-,-.-.-.-.-X---------------------------------
------------------,-X-X-X-X-X-X-X-X-X-X-X-X-X-X---------,-X-.-.-,-,-X-----,-X-.-.-.-.-.-.-.-,-,-,-,-,-,-,-,-X-------------------,-X-.-,-,-,-.-.-X---------------------------------
------------------,-X-.-.-.-.-.-.-E-.-E-.-.-A-X-----------,-X-,-,-,-X-----,-X-X-X-X-X-X-X-X-X-X-.-.-.-.-.-.-X-,-,-,-,-,-,-,---,-,-X-.-.-.-,-,-,-X---------------------------------
------------------,-X-.-.-.-.-.-.-.-.-.-.-.-.-X-----------,-X-,-,-,-X---------,-X-X~X~X~X~X~X~X-,-,-,-,-,-,-X-X~X~X-X-X-X-X---,-X-X-.-.-.-.-.-,-X---------------------------------
------------------,-X-.-.-.-.-.-.-.-.-.-.-A-<-X-----------,-X-,-,-,-X-------,-,-X-.~.~.~.~.~.~.~.~.~.~.~.~.~.~.~,~./:-.-A-X-,-,-X-,-.-.-.-.-.-X-----------------------------------
------------------,-X-.-.-.-.-.-.-.-.-B-.-.-,-X-----------,-X-,-,-,-X-------,-X-,-,~.~.~.~.~.~.~.~.~.~.~.~.~.~.~,~./.-.-.-X-,-X-.-,-,-.-E-.-,-X-----------------------------------
------------------,-X-.-.-.-.-X-X-.-.-.-.-.-X-------------,-X-,-,-,-X-------,-X-A-,~.~.~.~.~.~.~.~.~,~,-,~.~.~.~,~.-./.-.-X-,-X-.-.-,-,-.-.-X-------------------------------------
,-,-,-,-,-,-,-----,-X-.-.-.-H-X-X-.-.-.-.-.-X-,-,---------,-X-.-.-.-X-----,-,-X-.-,~.~.~.~.~.~.~.~.~,~.-,-,~.~.~,~.-.-./.-X-X-.-.-.-.-,-.-,-X-------------------------------------
X-X->->->-X-X-,-,-,-X-.-.-.-.-X-X-.-.-.-.-.-X-X-X-,-,-,-,-,-X-+-+-+-X-,-,-,-X-.-,-,~.~.~.~.~.~.~.~,~,-.-.-,-,~.~,~.-.-./.-.-.-.-E-.-.-,-,-X---------------------------------------
X-.-.-.-.-.-X-,-X-X-X-.-.-.-.-.-.-B-.-:-.-.-.-.-.-X-X-X-X-X-X-+-+-+-X-X-X-X-X-.-,-,~.~.~.~.~.~.~.~,~.-.-.-.-,-,~,~.-.-.-./.-.-.-.-.-.-,-X-X---------------------------------------
X-.-.-.-.-.-X-X-X-.-.-.-.-.-.-.-.-.-.-.-.-.-.-.-.-.-+-.-.-.-.-.-:-.-.-.-.-.-.-.-.-,-,-.~.~.~.~.~,~,-E-.-.-.-.-,-,~.-.-.-.-./.-.-.-,-X-X-------------------------------------------
X-E-.-A-.-.-+-+-.-.-.-.-.-.-E-.-.-.-.-.-.-.-.-.-.-.-+-.-A-.-.-.-.-.-.-.-.-.-.-.-.-.-E-,-,~.~.~.~,~.-.-,-,~,-.-.-E-.-.-.-.-./.-,-X-X-----------------------------------------------
X-.-.-.-.-.-X-X-X-.-.-.-.-.-.-.-.-.-.-.-.-.-.-.-.-.-+-.-.-.-.-.-.-.-.-.-.-.-.-.-E-.-.-.-,-,~.~,~,-.-.-,-.~,~.-.-.-.-.-.-X-X-X/X---------------------------------------------------
X-.-.-H-.-.-X-,-X-X-X-.-.-.-.-.-.-.-.-E-.-.-.-.-,-X-X-X-X-X-X-X-X-X-X-X-X-X-X-.-.-.-.-:-.-,-,~,~.-.-,-,~.~,~,~.-.-.-.-,-X---------------------------------------------------------
X-X-X-X-X-X-X-----,-X-.-.-.-.-X-X-.-.-.-.-.-X-X-X-------------------------,-X-.-.-.-.-.-.-.-,-,~.-.-,-.~.~.~,~,~.-.-.-X-----------------------------------------------------------
------------------,-X-.-.-.-.-X-X-.-.-.-.-.-X-,---------------------------,-X-.-,-,~,~,-.-E-.-.-.-,-,~.~.~.~.~,~.-.-,-X-----------------------------------------------------------
------------------,-X-.-.-.-.-.-.-.-.-.-B-.-.-X-------,-,-,-,-,-,-,-,-,---,-X-.-,-.~.~,~,-.-.-.-.-,-.~.~.~.~.~,~.~.-X-------------------------------------------------------------
------------------,-X-.-.-.-.-.-.-.-.-.-.-.-.-X-------,-X-X-X-X-X-X-X-X-----,-X-,~.~.~.~,~,~.-.-,-,~.~.~.~.~.~,~,~.-X-------------------------------------------------------------
------------------,-X-.-.-.-.-.-.-.-.-.-.-A-W-X-------,-X-.-.-.-.-H-.-X-----,-X-.~.~.~.~.~,~,~,-,-.~.~.~.~.~.~.~,~,-X-------------------------------------------------------------
------------------,-X-:-.-.-.-.-.-E-.-E-.-.-A-X-------,-X-W-.-A-.-.-.-X-----,-X-,~,~,~.~.~.~.~,~,-.~.~.~.~.~.~.~,~X-,-------------------------------------------------------------
------------------,-X-.-.-.-.-.-.-.-.-.-.-.-.-X-------,-X-.-.-.-.-.-.-X-,---,-X-,~.~,-,~.~.~.~.~.~.~.~.~.~.~.~,~,~X-X-,-,---------------------------------------------------------
------------------,-X-X-X-X-X-X-X-X-X-X-X-X-X-X-------,-X-.-.-.-.-.-.-X-X-,-,-X-X-.-.-,~.~.~.~.~.~.~.~.~.~,~,~,~.-.-.-X-X-,-,-----------------------------------------------------
------------------------------------------------------,-X-.-.-.-.-.-.-.-.-X-X-.-,-A-E-,-,~.~.~.~.~.~.~.~,~,~.~.-.-.-.-.-.-X-X-----------------------------------------------------
--------------------------------------------------------,-X-.-.-.-.-.-.-.-.-.-.-,-,-<-.-,-.~.~.~.~.~,~X~X~X-X-.-.-.-.-.-.-.-X-----------------------------------------------------
--------------------------------------------------------,-X-.-.-.-.-.-.-.-.-.-.-.-,-X-X-,-.~,~X~X~X-X-----,-,-X-X-.-.-.-.-.-X-----------------------------------------------------
--------------------------------------------------------,-X-.-.-.-.-.-.-.-.-.-.-.-,-X-,-X-X-X-----------------,-,-X-.-.-.-.-X-----------------------------------------------------
----------------------------------------------------------,-X-,-,-.-.-.-.-.-.-.-,-X-------------------------,-,-,-X-.-.-.-.-X-----------------------------------------------------
----------------------------------------------------------,-X/./X/X-X-X-X-X-X-X-X-,-,-,-,-,-,-------------,-,-X-X-.-.-.-.-.-X-----------------------------------------------------
----------------------------------------------------------,-X/./X/,---,-,-,-,-,-X-X-X-X-X-X-X-,-,-------,-,-X-.-.-.-.-.-.-.-X-----------------------------------------------------
----------------------------------------------------------,-X/./X/,-,-,-X-X-X-X-.-.-.-.-.-.-.-X-,-,-,-,-,-X-.-.-.-.-.-.-.-,-X-----------------------------------------------------
----------------------------------------------------------,-X-.-.-X-X-X-.-.-.-.-.-.-.-.-.-.-.-.-X-X-,-X-X-.-.-.-.-.-.-,-X-X-------------------------------------------------------
----------------------------------------------------------,-X-.-.-.-.-.-.-.-A-.-.-.-.-.-.-.-.-.-.-.-X-.-.-.-.-.-.-,-X-X-----------------------------------------------------------
----------------------------------------------------------,-X-.-.-.-.-.-.-.-,-,-X-X-X-X-X-X-X-.-.-.-.-.-.-.-.-,-,-X---------------------------------------------------------------
------------------------------------------------------------,-X-X-.-,-,-X-X-X-X-------------,-X-.-.-.-.-.-.-,-X-X-----------------------------------------------------------------
----------------------------------------------------------------,-X-X-X-----------------------,-X-.-.-.-,-X-X---------------------------------------------------------------------
------------------------------------------------------------------------------------------------,-X-,-X-X-------------------------------------------------------------------------
--------------------------------------------------------------------------------------------------,-X-----------------------------------------------------------------------------
