--------------------------,-X-X-X-X-X-X-X-X-X-X---------------------------------------------------------------------------------------------------------------
--------------------------,-X-.-.-.-.-.-.-.-.-X---------------------------------------------------------------------------------------------------------------
--------------------------,-X-<-.-<-<-.-<-.-.-X-----------,-,-,-,-,-,-,-,-------------------------------------------------------------------------------------
--------------------------,-X-.-.-.-.-.-.-.-.-X-----------,-X-X-X-X-X-X-X-,-,---------------------------------------------------------------------------------
--------------------------,-X-.-.-.-.-.-.-.-.-X-----------,-X-.-.-.-W-,-X9X-X---------------------------------------------------------------------------------
--------------------------,-X-.-.-.-.-.-.-.-.-X-----------,-X-E-.-E-.-,-t9.-X---------------------------------------------------------------------------------
--------------------------,-X-X-X-.-.-.-X-X-X-X-------,-,-,-X-.-.-.-A-,-X9X-X---------------------------------------------------------------------------------
--------------,-,-,-,-,-,-,-,-,-X-+-+-+-X-X-X-----,-,-,-X-X-X-.-.-.-.-.-X-,-,-,-,-----------------------------------------------------------------------------
--------------,-X-X-X-X-X-X-X-X-X-.-.-.-X-X-X-----,-X0X0X0X0X-X-,-X-X-X-X-X-X-X-X-----------------------------------------------------------------------------
--------------,-X-.-.-.-.-.-.-.-.-.-.-.-.-.-X-,-,-,-X0E0.0,0X-.0.0.0X0E-.-.-.-,-X-,-,-------------------------------------------------------------------------
--------------,-X-.-E-.-.-.-.-.-.-.-<-.-.-.-X-X-X-X-X0.0.0,0,0.0.0.0.0.-A-.-W-,-X1X-X-------------------------------------------------------------------------
--------------,-X-.-.-.-.-.-.-.-.-.-.-.-.-.-.-.-,-.-.0.0.0,0,0.0.0.0.0E-t<.-.-,-t1.-X-------------------------------------------------------------------------
--------------,-X-.-E-.-.-.-.-.-.-.-.-.-.-.-.-.-,-.-E0.0.0,0X-X0X0X0X0.-A-.-A-,-X1X-X-------------------------------------------------------------------------
--------------,-X-.-.-.-.-.-.-.-.-.-.-.-.-.-.-.-,-.-.-.-<-,-X-X---,-X-.-.-.-.-.-X-----------------------------------------------------------------------------
--------------,-X-X-.-.-.-.-A-.-A-.-W-.-A-.-.-.-E-.-E-.-.-,-X-X---,-X-X-X-X-X-X-X-----------------------------------------------------------------------------
----------------,-X-.-.-.-.-.-.-.-.-.-.-.-.-.-.-,-.-.-.-.-,-X-,-----------------------------------------------------------------------------------------------
----------------,-X-X-.-.-X-X-X-X-.-.-.-X-X-X-,-X-X-X-.-.-,-X-X-----------------------------------------------------------------------------------------------
------------------,-X-.-.-X-X-X-X.,.,.,.X.X-X-.-X-X-X-.-.-,-X-X-,-,-,-,-,-,-,-,-,-----------------------------------------------------------------------------
------------------,-X-.-.-,-.-.-....E......-.-E-.-.-.-.-.-.-X---,-X-X-X-X-X-X-X-X-----------------------------------------------------------------------------
------------------,-X-.-.-,-.-.-...........-.-.-.-.-.-.-.-.-X---,-X-.-.-.-.-.-.-X-----------------------------------------------------------------------------
------------------,-X-E-.-,-.-.-...........-.-.-.-.-.-.-.-.-X---,-X-H-.-E-.-A-.-X-----------------------------------------------------------------------------
------------------,-X-.-.-,-.-.-...........-.-.-.-.-.-.-E-.-X---,-X-.-.-.-.-.-.-X-----------------------------------------------------------------------------
--------------,-,-,-X-X-X-X-X-X-X-+-+-+-X-X-X-.-.-X-X-X-X-X-X---,-X-E-.-E-.-E-.-X-----------------------------------------------------------------------------
--------------,-X-X-X-X-X-X-X-X-X-+-+-+-X-X-X-X-X-X-X-X-X-,-,-,-,-X-.-.-.-W-.-.-X-----------------------------------------------------------------------------
--,-,-,-------,-X-.-.-.-.-.-.-.-.-.-.-.-.-.-.-.-.-.-.-.-X-,-X-X-X-X-E-,-E-,-E-,-X-----------------------------------------------------------------------------
,-,-X-X-,-,-,-,-X-.-.-.-.-.-.-.-.-.-.-.-.-.-.-.-.-.-.-.-X-,-X-E-X-X-X-X-.-.-.-.-X-,-,-------------------------------------------------------------------------
,-X-X-X-X-X-X~X~X~,-,-.-.-.-.-.-t1.-<-.-.-.-.-.-.-.-,-,-X-,-X-.-X-X-X-X-,-,-,-,-X-X-X-,-----------------------------------------------------------------------
,-X-.-.-,-X-X-.~.~.~,~,-,-,-,-,-,-,-,-,-,-,-,-,-,-,-,-,-X-,-X-E-X-X-X-.-.-.-.-.-.-,-X-X-----------------------------------------------------------------------
,-X-H-.-E-.-,-.~.~.~.~.~,~,-,-,-.-.-.-.-,-,-.-,-,-.-.-,-X-X-X-,-X-X-X-.-.-.-.-.-.-,-X-X-----------------------------------------------------------------------
,-X-.-.-,-.-,-.~.~.~.~.~,~,-,-,-,-,-,-,-,-,-,-,-.-.-.-,-.-,-,-,-.-.-,-.-.-,-,-,-,-.-X-----------------------,-,-,-,-,-,---------------------------------------
,-X-.-.-E-.-,-.~.~.~.~.~,~,-,-,-,-,-,-,-,-.-,-.-.-.-.-,-.-.-,-,-.-.-,-.-.-,-.-.-,-.-X-----------------------,-X-X-X-X-X---------------------------------------
X-X-.-.-,-.-,-.~.~.~.~.~,~,-,-,-,-,-,-,-,-,-,-.-.-.-.-,-.-.-,-,-.-.-,-.-.-,-.-K-,-.-X-,-,-,-,-,-,-,-,-,-,-,-,-X-.-.-.-X---------------------------------------
X-X-.-.-E-.-,-.~.~.~.~,~,~.-.-.-.-.-.-.-.-.-.-.-.-.-.-,-.-.-,-,-.-.-,-.-.-,-,-,-,-.-X-,-X-X-X-X-X-X-X-X-X-X-X-X-E-E-.-X---------------------------------------
,-X-.-.-,-.-,-.~.~.~,~,~.-.-.-.-.-.-.-.-.-.-.-.-.-.-.-,-.-,-,-,-.-.-,-.-.-.-.-.-.-,-X-,-X-.-.-.-.-.-.-.-A-.-X-X-H-.-.-X---------------------------------------
,-X-.-.-,-X-X-X~X~,~,~.-.-.-.-.-.-.-.-.-.-.-.-.-.-.-.-,-X-X-X-X-X-X-X-.-.-.-.-.-.-,-X-X-X-.-.-.-H-.-A-.-.-.-X-X-E-.-E-X---------------------------------------
,-X-.-.-.-,-X-X-X-.-.-.-.-.-.-.-.-,-,-,-,-.-.-.-.-.-.-,-X-,-,-,-,-X-X-.-.-.-.-.-.-,-X-X-X-.-A-.-.-t6.-.-.-.-X-X-.-.-.-X---,-,-,-,-----------------------------
,-X-.-.-A-,-X-.-,-.-.-.-.-.-.-.-,-,-.4.4,4,-.-.-.-.-,-,-X-X-X-X-X-X-X-X-X-X-X-X-X-X-X-,-X-.-.-.-.-.-.-.-.-.-X-X-E-,-E-X---,-X-X-X-----------------------------
,-X-.-.-.-,-X-E-,-.-.-.-.-.-.-,-,-.4.4.4.4,4,-.-.-.-,-.-,-.-.-.-X-,-,-,-,-,-,-,-,-,-,-,-X-.-X-X-X-.-X-X-X-.-X-X-.-.-.-X-,-,-X-.-X-,-,-------------------------
,-X-.-.-W-,-X-.-,-.-.-.-.-.-.-,-.4.4.4.4.4.4,4.-.-,-,-.-,-.-.-.-X-X-X-X-X-X-X-X-X-X-X-X-X-E-X-X-X-E-X-X-X-E-X-X-,-,-,-X-X-X-X6t6X6X-X-,-,-,-,-----------------
,-X-.-.-.-,-X-E-,-.-.-.-.-.-.-,-.4.4.4H4.4.4,4.-.-,-.-.-,-.-.-.-X-X-.-H-,-.-.-.-.-.-.-,-,-,-.-,-,-,-.-,-,-,-.-.-.-.-,-.-.-.-.-.-.-,-X-X-X-X-X-,-,-,-,-,-,-----
,-X-.-.-A-,-X-.-,-.-.-.-.-.-.-,-,4.4.4.4.4,4,4.-.-,-.-.-,-.-.-.-X-X-.-.-,-.-.-.-.-.-.-.-.-.-.-.-.-.-.-.-.-.-.-.-.-,-,-.-.-.-.-.-.-,-,-E-.-E-X-,-X-X-X-X-X-----
,-X-.-.-.-,-X-E-,-.-.-.-.-.-.-.-,-,4.4.4,4,4.-.-.-,-.-.-,-.-.-.-L-L-.-.-,-.-.-.-.-.-.-.-.-.-.-.-.-.-.-.-.-.-.-.-.-,-.-.-.-.-.-.-.-,-X-X-X-X-X-X-,-,-,-,-X-----
,-X-.-.-.-,-X-X-X-.-.-.-.-.-.-.-.-,-,4,4,4.-.-.-.-,-,-.-,-.-.-.-X-X-.-.-,-.-.-.-.-.-.-.-.-.-.-.-.-.-.-.-.-.-.-.-.-,-.-.-.-.-.-.-.-,-X-X-X-X-.-,-,-,-,->->-,-,-
,-X-.-.-.-.-X-,-X-,-,-,-,-.-.-.-.-.-.-.-.-.-.-.-.-.-,-.-,-.-.-.-X-X-.-,-,-.-.-.-.-.-.-.-.-.-.-.-.-.-.-.-.-.-.-.-.-,-.-.-.-.-.-.-.-,-.-.-,-.-.-,-,-,->-.-.-X-X-
--,-X-.-.-.-,-X-X~.~.~.~,~,-.-.-.-.-.-.-.-.-.-.-.-.-,-,-,-.-.-.-X-X-,-,-.-.-.-.-.-.-<-.-.-.-.-.-.-.-.-.-.-.-.-.-.-,-.4.4.4.-.-.-.-,-.-.-,-.-.-,-,-,->-.-.-.-X-
--,-X-.-.-.-,-X-X~.~.~.~.~,~,-.-.-.-.-.-.-.-.-.-.-.-.-,-.-.-.-.-X-X-.-.-.-.-.-.-.-.-.-.-.-.-.-.-.-.-.-.-.-.-.-.-.-,-.4.4.4.-.-<-.-,-.-.-,-.-.-,-,-,->-.-.-.-X-
--,-X-.-.-.-,-.-,-,~.~.~.~.~,~,-.-.-.-.-.-.-.-.-.-.-.-,-X-X-X-X-X-X-.-.-.-.-.-.-.-.-.-.-.-.-.-.-.-.-.-.-.-.-.-.-.-,-.4.4.4.-.-.-.-,-.-.-,-.-.-,-,-,->-.-.-.-X-
--,-X-.-.-.-,-.-.-,-,~,~.~.~.~,~,-.-.-.-.-.-.-.-.-,-,-,-X-------,-X-.-.-.-.-.-.-.-.-.-.-.-.-.-.-.-.-.-.-.-.-.-.-.-,-.-.-.-.-.-.-.-,-.-.-,-.-.-,-,-,->->-.-,-X-
--,-X-.-.-E-,-.-.-.-.-,~,~.~.~.~,~.-./././././.-,-,-.~.~X~,-,-,-,-X-,-,-,-.-.-.-.-.-.-.-.-.-.-.-.-.-.-.-.-.-.-.-.-,-,-.-.-.-.-.-.-,-X-X-X-X-.-.-,-,-,-,->-X---
--,-X-.-t9.-,-.-.-.-.-.-,~,~.~.~,~.-./././././,-,-.~.~.~X~X~X~X~X~.~.~.~,~,-.-.-.-.-.-.-.-.-.-.-.-.-.-.-.-.-.-.-.-.-,-.-.-.-.-.-.-,-X-X-X-X-X-X-.-,-,-,-X-----
--,-X-.-.-.-E-.-.-.-.-.-.-,~,~.~,~.-./././././,-.~.~.~.~.~.~.~.~.~.~.~.~.~,~.-.-.-.-.-,-,-,-.-,-,-,-.-,-,-,-.-.-.-.-,-,-.-.-.-.-.-,-,-E-.-E-X-,-X-X-X-X-X-----
--,-X-.-.-.-,-.-.-.-.-.-.-.-,~,~,~,-,/,/,/,/,/,-.~.~.~.~.~,~,~,~,~.~.~.~.~,~.-,-,-,-,-,-.-,-,-,-.-,-,-,-.-,-,-,-,-,-,-,-.-,-,-,-,-,-,-.-.-.-X-----------------
--,-X-.-.-.-,-X-X-.-.-.-.-.-.-X-X~X-X/./././X/X-X~X~X~X~X~X~X~.~X~X~X~X~X~X~X-X-X-.-X-X-X-E-X-X-X-E-X-X-X-E-X-.-.-.-X-X-X-X-X5t5X5X-X-X-X-X-X-----------------
--,-X-.-.-.-.-X-X-,-,-,-,-,-,-X-X-X-X-.-.-.-X-------------,-X~W~X~------------,-X4X4X4,-X-.-X-X-X-.-X-X-X-.-X-,-,-,-X-----,-X-.-X-----------------------------
--,-X-.-.-.-.-.-.-.-.-.-.-.-,-.-,-,-.-.-.-.-X-------------,-X~.~X~--------------------,-X-.-.-.-.-.-.-.-.-.-X-.-E-E-X-----,-X-X-X-----------------------------
--,-X-.-.-.-.-.-.-E-.-E-E-.-,-.-,-,-.-.-.-.-X-------------,-X~,~X~--------------------,-X-.-A-.-.-.-.-A-.-.-X-.-.-.-X-----------------------------------------
--,-X-.-.-.-,-,-,-,-<-,-,-,-,-.-,-,-,-,-,-.-X-------------,-X1t1X1--------------------,-X-.-H-.-H-t5.-.-.-.-X-.-E-E-X-----------------------------------------
--,-X-X-X-X-X-X-X-X-X-.-.-.-X-X-X-X-X-X-X-X-X-------------,-X-.-X---------------------,-X-.-.-.-.-.-.-A-.-.-X-.-.-A-X-----------------------------------------
------------,-X-X-,-X-,-,-,-X-------,-X-X-----------------,-X-X-X---------------------,-X-X-X-X-X-X-X-X-X-X-X-.-E-E-X-----------------------------------------
------------------,-X-.-.-.-X-----------------------------------------------------------------------------,-X-.-.-.-X-----------------------------------------
------------------,-X-+-+-+-X-----------------------------------------------------------------------------,-X-X-X-X-X-----------------------------------------
----------,-,-,-,-,-X-+-+-+-X-,-,-,-,-,-,---------------------------------------------------------------------------------------------------------------------
----------,-X~X~X~X~X-,-,-,-X-X~X~X~X~X~X~--------------------------------------------------------------------------------------------------------------------
--,-,-,-,-,-X~.~.~.~.~.~.~.~.~.~.~.~E~.~X~--------------------------------------------------------------------------------------------------------------------
--,-X-X-X-X-X-.~.~.~.~.~.~.~.~.~.~.~.~.~X~--------------------------------------------------------------------------------------------------------------------
--,-X-.-A-.-,-.~.~.~.~,~,~,~,~,~,~,~,~.~X~--------------------------------------------------------------------------------------------------------------------
--,-X-.-E-.-,-.~.~.~.~,~.-.-,-,~.-.-,-.~X~--------------------------------------------------------------------------------------------------------------------
--,-X-.-A-.-,-.~.~.~.~,~.-.-,-,~.-.-,-.~X~,-,-,-,-------------------------------------------------------------------------------------------------------------
--,-X-.-.-.-,-.~.~.~.~,~,-,-,-,~,-,-,-.~X~X~X~X~X~------------------------------------------------------------------------------------------------------------
--,-X-.-H-.-,-,~,~,~,~,~,~,~,~,~,~,~,~.~.~,~t~.~X~------------------------------------------------------------------------------------------------------------
--,-X-X-X-X-X-,~.-.-,-,~.-.-,=,~.-.-,-.~X~X~X~X~X~------------------------------------------------------------------------------------------------------------
----------,-X~,~.-.-,-,~.-.-,=,~.-.-,-.~X~--------------------------------------------------------------------------------------------------------------------
----------,-X~,~,-,-,-,~,-,-,=,~,-,-,-.~X~--------------------------------------------------------------------------------------------------------------------
----------,-X~,~,~,~,~,~,~,~,~,~,~,~,~.~X~--------------------------------------------------------------------------------------------------------------------
----------,-X~,~.-.-,-,~.-.-,-,~.-.-,-.~X~--------------------------------------------------------------------------------------------------------------------
----------,-X~,~.-.-,-,~.-.-,-,~.-.-,-.~X~--------------------------------------------------------------------------------------------------------------------
----------,-X~,~,-,-,-,~,-,-,-,~,-,-,-.~X~--------------------------------------------------------------------------------------------------------------------
----------,-X~,~,~,~,~,~,~,~,~,~,~,~,~.~X~--------------------------------------------------------------------------------------------------------------------
----------,-X~,~.-.-,-,~.-.-,-,~.:.:,:.~X~--------------------------------------------------------------------------------------------------------------------
----------,-X~,~.-.-,-,~.-.-,-,~.:.:,:.~X~--------------------------------------------------------------------------------------------------------------------
----------,-X~,~,-,-,-,~,-,-,-,~,:,:,:.~X~--------------------------------------------------------------------------------------------------------------------
----------,-X~.~.~.~.~.~.~.~.~.~.~.~.~.~X~--------------------------------------------------------------------------------------------------------------------
----------,-X~.~.~.~.~.~.~.~.~.~.~.~.~.~X~--------------------------------------------------------------------------------------------------------------------
----------,-X~.~.~,~,~,~,~E~,~,~,~.~.~.~X~--------------------------------------------------------------------------------------------------------------------
----------,-X~.~.~,~.-.-.-.-.-.-,-.~.~.~X~--------------------------------------------------------------------------------------------------------------------
----------,-X~.~.~,~.-,-,-,-,-.-,-.~.~.~X~--------------------------------------------------------------------------------------------------------------------
----------,-X~X~X~X~X-X-X9t9X9X-X-X~X~X~X~--------------------------------------------------------------------------------------------------------------------
----------------------,-X-.-X---------------------------------------------------------------------------------------------------------------------------------
----------------------,-X-X-X---------------------------------------------------------------------------------------------------------------------------------
