X-X-X-X-X-,-,-,-,-,-,-,-,-,-,-,-,-,-------------------------------------------------------------------------------------------------------------------------------
X-.-.-.-.-X-X-X-X-X-,-X-X-X-X-X-X-X-------------------------------------------------------------------------------------------------------------------------------
X-.-.-.-.-.-.-.-.-X-,-X3,3X4,4,6+WXW------------------------------------------------------------------------------------------------------------------------------
X-.-.-.-.-.-.-.-.-X---X7+T,7,7+W+WXW------------------------------------------------------------------------------------------------------------------------------
X-.-.-.-.-.-.-.-.-X---X-,-.6,6.6.-X-------------------------------------------------------------------------------------------------------------------------------
X-.-.-.-.-.-.-.-.-X---X-,-.6,6.-.-X-------------------------------------------------------------------------------------------------------------------------------
X-.-.-.-.-.-.-.-.-X---X-,-,6,6,-,-X-------------------------------------------------------------------------------------------------------------------------------
X-.-.-.-.-.-.-.-.-X-,-X-,-,-,-,-,-X-------------------------------------------------------------------------------------------------------------------------------
X-.-.-.-.-.-.-.-.-X-,-X-.-.-.-.-.-X-------------------------------------------------------------------------------------------------------------------------------
X-.-.-.-.-.-.-.-.-X-,-X-.-.-.-.-.-X-------------------------------------------------------------------------------------------------------------------------------
X-.-.-.-.-.-.-.-.-X-,-X-.-.-.-.-.-X-------------------------------------------------------------------------------------------------------------------------------
X-.-.-.-.-.-.-.-.-X-,-X-.-.-.-.-.-X-------------------------------------------------------------------------------------------------------------------------------
X-.-.-.-.-.-.-.-.-X-,-X-.-.-.-.-.-X-------------------------------------------------------------------------------------------------------------------------------
X-.-.-.-.-.-.-.-.-X-,-X-.-.-.-.-.-X-------------------------------------------------------------------------------------------------------------------------------
X-.-.-.-.-.-.-.-.-X-,-X-:-,-,-,-,-X-------------------------------------------------------------------------------------------------------------------------------
X-.-.-.-.-.-.-.-.-X-,-X-,-,-,-,-,-X-------------------------------------------------------------------------------------------------------------------------------
X-.-.-.-.-.-.-.-.-X-,-X-.-.-.-.-.-X-,-----------------------------------------------------------------------------------------------------------------------------
X-.-.-.-.-.-.-.-.-X-X-.-.-.-.-:-.-.-X-------------------------------------,-,-------------------------------------------------------------------------------------
X-.-.-.-.-.-.-.-.-X-X-.-.-.-.-.-.-.-X-,-,-,-,-,-,-,-,-,-,-,-,-,-,-,-,-,-,-,-X-,-,---------------------------------------------------------------------------------
X-.-.-.-.-.-.-.-.-X-X-H-.-.-.-.-.-.-X-X-X~X~X~X~X~X~X~X~X~X-X-X-X-X-X~X~X~X~X-X-X-,-,-----------------------------------------------------------------------------
X-.-.-.-.-.-.-.-.-X-X-.-.-.-.-.-.-.-.-,-:~.~.~.~.~.~,~,~.-.-.-.-.-.-,-,~.~X~X-.-.-X-X-,-,-------------------------------------------------------------------------
X-.-.-.-.-.-.-.-.-X-X-.-.-.-.-.-.-.-.-,-,~,~.~.~.~.~,~.-.-,-,-,-,-.-.-,-.~X~X-.-.-.-.-X-X-,-,---------------------------------------------------------------------
X-.-.-.-.-.-.-.-,-X-X-X-,-X-X-,-X-X-X-,-,~,-,~.~.~.~,~.-.-,-.~.~,~.-.-,-.~X~X-.-.-.-.-.-.-X-X-,-,-----------------------------------------------------------------
X-.-.-.-.-.-.-.-,-X-X-X-,-X-X-,-X-X-X-,-,~.-,-,~,~.~,~.-.-,-.~.~,~.-.-,-,~X~X-.-.-.-.-.-.-.-.-X-X-,-,-------------------------------------------------------------
X-.-.-.-.-.-.-.-,-.-,-.-,-.-.-,-,-X-X~.~,~,-,-:~,-,~,~.-.-,-.~.~,~.-.-.-.-X-X-.-.-.-.-.-.-.-.-.-.-X-X-,-,---------------------------------------------------------
X-.-.-.-.-.-.-.-,-.-,-.-,-.-.-.-,-X-X~.~.~,~,-,~.-,~,~.-,-,-.~.~,~.-.-.-.-X-,-X-.-.-.-.-.-.-.-.-.-.-.-X-X-,-,-----------------------------------------------------
,-X-.-.-.-.-.-.-,-.-,-,-,-,-,-,-,-X-X~.~.~.~.~,~,-,-,~,-,-.~.~.~,~.-.-.-.-.-X-X-,-.-.-.-.-.-.-.-.-.-.-.-.-X-X-,-,-------------------------------------------------
,-X-.-.-.-.-.-.-,-.-,-,-,-,-,-,-.-X-X~.~.~.~.~.~.~.~.~.~.~.~.~.~,~.-.-.-.-.-.-.-,-,-.-.-.-.-.-.-.-.-.-.-.-.-.-X-X-,-,---------------------------------------------
,-X-.-.-.-.-.-.-,-,-,-,-,-,-.-.-.-X-X~X~X~X~X~X~X~X~X~X~X~X~X~X~X~X-X-X-X-.-.-.-.-,-,-.-.-.-.-.-.-.-.-.-.-.-.-.-.-X-X-,-,-----------------------------------------
,-X-.-.-.-.-.-.-,-,-,-.-.-.-.-.-.-X-X-X-X-X-X-X-X-,-,-,-,-X-X-X-X-X-X-X-X-.-.-.-.-,-,-,-.-.-.-.-.-.-.-.-.-.-.-.-.-.-.-X-X-,-,-------------------------------------
,-X-.-.-.-.-.-.-.-,-,-.-.-.-.-.-.-.-.-B-B-B-.-.-.-X-X-X-X-.-.-.-B-.-.-,-X-,-.-.-.-.-,-,-X-.-.-.-.-.-.-.-.-.-.-.-.-.-.-.-.-X-X-,-,---------------------------------
,-X-.-.-.-.-.-.-.-,-,-.-.-.-.-.-.-.-.-.-B-B-.-B-.-.-B-.-B-.-B-.-.-.-.-.-,-,-,-.-.-.-.-X-,-X-X-X-X-X-X-X-X-X-X-X-X-X-X-X-X-X-X-X-X---------------------------------
,-X-.-.-.-.-.-.-.-,-,-.-.-.-.-.-.-.-.-.-.-.-.-.-.-.-.-.-.-.-.-.-B-.-.-.-.-,-,-,-.-.-.-.-X-X-X-X-X-X-X-,-X-X-X-X-----------,-X-X-X---------------------------------
,-X-.-.-.-.-.-.-.-,-,-,-.-.-.-.-.-.-.-.-.-.-.-:-.-.-.-.-.-.-.-.-.-.-B-.-E-.-,-,-X-X-.-.-.-,-,-,-,-,-X-,-X-.-.-X-,-,-,-,-,-,-X-.-X---------------------------------
,-X-.-.-.-.-.-.-.-,-,-,-,-,-.-.-.-.-.-.-.-.-.-.-.-.-.-.-.-.-.-.-.-.-.-.-.-.-.-,-X-,-X-.-:-.-.-.-.-.-X-X-X-:-.-X-X-X-X-X-X-X-X-.-X---------------------------------
,-X-.-.-.-.-.-.-.-.-,-,-,-,-,-,-,-.-.-.-.-:-.-.-.-.-.-.-.-.-.-.-.-.-.-.-.-:-.-.-.-X-X-,-.-.-.-.-.-.-.-.-.-.-.-.-.-.-.-.-.-:-.-.-X---------------------------------
,-X-.-.-.-.-.-.-.-.-.-.-,-,-,-,-,-,-,-.-.-.-.-.-.-.-.-.-.-,-,-,-,-:-,-,-,-,-.-.-.-X-X-,-,-.-:-.-:-.-.-.-.-.-.-.-.-.-.-.-.-.-.-.-X---------------------------------
,-X-.-.-.-.-.-.-.-.-.-.-.-.-.-,-,-,-,-,-,-.-.-.-.-.-.-.-.-,-.-.-.-.-.-:-.-,-.-.-.-X-X-.-,-,-,-,-,-,-,-,-,-,-.-.-.-.-.-.-.-.-.-.-X---------------------------------
,-X-.-.-.-.-.-.-.-.-.-.-.-.-.-.-.-,-,-,-,-.-.-.-.-.-.-.-.-,-,-,-,-,-,-,-,-,-.-.-.-X-X-X-X-.-.-.-X-X-X-.-.-X-X-X-.-.-.-.-.-:-.-.-X---------------------------------
,-X-.-.-.-.-.-.-.-.-.-.-.-.-.-.-.-.-.-,-,-.-.-.-.-.-.-.-.-,-X-X-L-L-L-L-X-X-X-X-X-X---,-X-.-.-.-X-,-X-.-.-X-,-X-:-.-.-.-.-.-X-X-X---------------------------------
,-X-.-.-.-.-.-.-.-.-.-.-.-.-.-.-.-.-.-,-,-.-.-.-.-.-.-.-.-.-X-X-.-.-.-.-X-X-X-X-,-----,-X-X-X-X-X-,-X-X-X-X-,-X-.-.-:-.-.-.-X-------------------------------------
,-X-.-.-.-.-.-.-.-.-.-.-.-.-.-.-.-.-.-,-,-.-.-.-.-.-.-.-.-,-X-X-H-.-.-.-,-,-,-X-,-,-,-,-,-,-,-,-,-,-,-,-,-,-,-X-,-,-,-,-,-,-X-,-,---------------------------------
,-X-.-.-.-.-.-.-.-.-.-.-.-.-.-.-.-.-.-,-,-.-.-.-.-.-.-.-.-,-X-X-.-.-,-,-,-.-,-,-X-X-X-X-X-X-X-X-X-X-X-X-X-X-X-X-.-.-.-.-.-.-X-X-X---------------------------------
,-X-.-.-.-.-.-.-.-.-.-.-.-.-.-.-.-.-.-,-,-.-.-.-.-.-.-.-.-,-,-,-,-,-,-.-.-.-,-.-,-.-.-.-,-.-.-.-,-.-.-.-.-,-.-.-.-.-.-.-.-.-.-H-X---------------------------------
,-X-.-.-.-.-.-.-.-.-.-.-.-.-.-.-.-.-.-,-,-.-.-.-.-.-.-.-.-.-,-,-,-.-.-.-.-,-,-.-,-.-:-.-,-.-.-.-,-.-.-.-.-,-.-.-.-.-.-.-.-.-.-.-X---------------------------------
,-X-.-.-.-.-.-.-.-.-.-.-.-.-.-.-.-.-.-,-,-.-.-.-.-.-.-.-.-.-,-,-,-.-.-.-.-,-.-.-,-.-.-.-,-.-.-.-,-.-.-.-.-,-.-.-.-.-.-.-.-.-.-.-X---------------------------------
,-X-.-.-.-.-.-.-.-.-.-.-.-.-.-.-.-.-.-,-,-.-.-.-.-.-.-.-.-.-.-,-,-X-.-.-,-,-.-.-,-.-.-.-,-.-.-.-,-.-.-:-.-,-.-.-.-.-.-.-.-.-.-.-X---------------------------------
,-X-.-.-.-.-.-.-.-.-.-.-.-.-.-.-.-.-.-,-,-.-.-.-.-.-.-.-:-.-.-,-X-,-X-,-,-.-.-.-,-.-.-.-,-.-.-.-,-.-.-.-.-,-.-.-.-.-.-.-.-.-.-.-X---------------------------------
,-X-.-.-.-.-.-.-.-.-.-.-.-.-.-.-.-,-,-,-,-.-.-.-.-.-.-.-.-.-.-.-.-X-X-,-,-,-.-.-,-.-.-.-,-.-.-:-,-.-.-.-.-,-.-.-.-.-.-.-.-:-.-.-X---------------------------------
,-X-.-.-.-.-.-.-.-.-.-.-.-.-,-,-,-,-,-,-,-.-.-.-.-.-.-.-.-.-.-.-.-.-.-,-,-,-,-X-X-,-,-,-,-,-,-,-,-,-,-,-,-,-.-.-.-.-.-.-.-.-.-.-X---------------------------------
,-X-.-.-.-.-.-.-.-.-.-,-,-,-,-,-,-,-,-.-.-.-.-.-.-.-.-:-.-.-.-.-.-.-.-.-.-,-X~X-,-X-.-.-.-,-X-X-X-,-,-,-,-X-X-X-.-.-.-.-.-.-.-,-X---------------------------------
,-X-.-.-.-.-.-.-.-,-,-,-,-,-,-,-.-.-.-.-.-.-.-.-.-.-.-.-.-.-.-.-.-.-.-.-.-,-,-.~X~X~,-,-,-,-X-X-X-,-,-.-.-X-X-,-X-.-.-.-.-.-,-X-----------------------------------
,-X-.-.-.-.-,-,-,-,-,-,-,-.-.-.-.-.-.-.-.-.-.-.-.-.-.-.-.-.-.-.-.-.-.-.-.-.-,-.~.~,~------,-.-,-,-.-,-,-.-.-X---,-X-.-.-.-.-X-------------------------------------
,-X-.-,-,-,-,-,-,-,-,-.-.-.-.-.-.-.-.-.-.-.-.-.-.-.-.-.-.-.-.-.-.-.-.-.-.-.-,-,-.~,~--,-,-,-.-,-,-.-.-,-,-.-X---,-X-,-,-,-,-X-------------------------------------
,-X-,-,-,-,-,-,-.-.-.-.-.-,-,-,-,-.-.-.-.-.-.-.-.-.-.-.-.-.-.-.-.-.-.-.-.-.-.-,-.~,~,-,-.1,1.1,-,-.-.-.-,-,-X---,-X-.-.-.-,-X-------------------------------------
,-X-,-,-,-.-.-.-.-.-.-,-,-,-.-.~,-,-,-.-.-.-.-.-.-.-.-.-.-.-.-.-.-.-.-.-.-.-:-,-.~.~.~.~.~,~,~.-.-.-.-.-.-,-X---,-X-.-.-.-,-X-,-----------------------------------
,-X-,-,-.-.-.-.-,-,-,-,-.-.~.~.~.~.~,-,-,-.-.-.-.-.-.-.-.-.-.-.-.-.-.-.-.-.-.-,-,-.~.~.~.~.~,~.-.-.-.-.-.-.-X---,-X-,-,-,-,-.-X-----------------------------------
,-X-,-,-.-.-,-,-,-.-.~.~.~.~.~.~.~.~.~.~,-,-,-.-.-.-.-.-.-.-.-.-.-.-.-.-.-.-.-.-,-.~.~.~.~.~,~,1.-.-:-.-.-B-X---,-X-.-.-.-,-.-X-----------------------------------
,-X-,-,-.-.-,-.~.~.~.~.~.~.~.~.~.~.~.~.~.~.~,-,-,-.-.-.-.-.-.-.-.-.-.-.-.-.-.-.-,-.~.~.~.~.~.~,~.-.-.-.-.-,-X-,-,-X-.-.-.-,-.-X-----------------------------------
,-X-,-,-.-.-,-.~.~.~.~.~.~.~.~.~.~.~.~.~.~.~.~.~,-,-.-.-.-.-.-.-.-.-.-.-.-:-.-,-,-.~.~.~.~.~.~,~,~.-.-.-,-,-.~X~,-X-,-,-,-,-.-X-,---------------------------------
,-X-,-,-.-.-,-.~.~.~.~.~.~.~.~.~.~.~.~.~.~.~.~.~.~,~.-.-.-.-.-.-.-.-.-.-.-.-,-,-.~.~.~.~.~.~.~.~,~,-,-,-,-.~.~.~X~X-.-.-.-,-.-.-X---------------------------------
,-X-,-,-.-.-,-.~.~.~.~.~.~.~.~.~.~.~.~.~.~.~.~.~.~,~.-.-.-.-.-.-.-.-.-.-.-,-,-.~.~.~.~.~.~.~.~.~.~.~.~.~.~.~.~.~,~,-:-.-.-,-.-.-X---------------------------------
,-X-,-,-.-.-,-.~.~.~.~.~.~.~.~.~.~.~.~.~.~.~.~.~.~,~.-.-.-.-.-.-.-.-:-.-,-,-.~.~.~.~.~.~.~.~.~.~.~.~.~.~.~.~.~.~,~,-,-,-,-,-.-.-X---------------------------------
,-X-,-,-.-.-,-.~.~.~.~.~.~.~.~.~.~.~.~.~.~.~.~.~.~,~.-.-.-.-.-.-.-.-.-,-,-.~.~.~.~.~.~.~.~.~.~.~.~.~.~.~.~.~.~.~,~,-.-.-.-,-.-.-X-,-------------------------------
,-X-,-,-.-.-,-.~.~.~.~.~.~.~.~.~.~.~.~.~.~.~.~.~.~,~.-:-.-.-.-.-.-.-,-,-.~.~.~.~.~.~.~.~.~.~.~.~.~.~.~.~.~.~.~.~,~,-.-.-.-,-,-.-.-X-------------------------------
,-X-,-,-.-.-,-.~.~.~.~.~,~,~,~,~.~.~.~.~.~.~.~.~.~,~.-.-.-.-.-.-.-,-,-.~.~.~.~.~.~.~.~.~.~.~.~.~.~.~.~.~.~.~.~.~,~,-.-.-.-.-,-.-.-X-------------------------------
,-X-,-,-.-.-,-.~.~.~,~,~,~.~.-,~,~,~.~.~.~.~.~.~.~,~.-.-.-.-.-.-.-,-.~.~.~.~.~.~.~.~.~.~.~.~.~.~,~,~,~.~.~.~.~.~,~,-,-,-,-,-,-,-.-X-------------------------------
,-X-,-,-.-.-,-.~,~,~,~.~.-.-.-.-.-,~,~,~.~.~.~.~.~,~.-.-.-.-.-.-.-,-.~.~.~.~.~.~.~.~.~.~.~.~.~.~,~.5,5,5,~.~.~,~X~X-.-.-.-.-.-,-,-X-,-----------------------------
,-X-,-,-.-.-,-.~,~.-.-.-.-.-.-.-.-.-.-,~,~,~.~.~.~,~.-.-.-.-.-.-:-,-.~.~.~.~.~.~.~.~.~.~.~.~,~,~,-,5,5,5,5,~,~X~,-X-,-,-,-,-,-,-,-,-X---,-,-,-,-,-,-,-,-----------
,-X-,-,-.-.-,-.~,~.-.-.-.-.-.-.-.-.-.-.-.-,-.~.~.~,~.-.-.-.-.-.-.-,-.~.~.~.~.~.~.~.~.~.~.~,~,~------------,-X-,-,-X-.-.-.-.-.-.-.-,-X---,-X-X-X-X-X-X-X-----------
,-X-,-,-.-.-,-.~,~.-.-.-.-.-.-.-.-.-.-.-.-,-.~.~.~,~.-.-.-.-.-.-.-,-,~,~,~.~.~,~,~,~.~,~,~,-----------,-,-,-X-,-X-.-.-.-.-.-.-.-.-.-X-,-,-X-.-.-.-.-.-X-,-,-------
,-X-,-,-.-.-,-.~,~.-.-.-.-.-H-.-.-.-.-.-.-,-.~.~.~,~.-.-.-.-,-,-,-X-X~X-,-,~,~,~,-X-X~X~,-,-------:---,-,-,-X-X-.-.-.-.-:-.-.-.-.-.-.-X-X-.-.-.-.-.-.-.-X-X-,-----
,-X-,-,-.-.-,-.~,~.-.-.-.-.-.-.-.-.-.-.-.-,-.~:~.~,~.-.-.-.-,-,-,-X-X-X-.-.2.2.2.-X-X-X-,-,-----------,-,-,-X-X-.-.-.-.-.-.-.-.-.-.-.-:-.-.-.-.-.-.-.-.-,-X-X-,---
,-X-,-,-.-.-,-.~,~.-.-.-.-.-.-.-.-.-.-,-,-,-.~.~.~,~.-.-.-.-,-,-,-X-X-.-.-.-K2.-.-.-X-X-,-,-----------,-,-,-L-.-.-.-.-.-.-.-.-.-.-.-.-,-.-.-.-.-.-.-.-.-,-X-X-X-,-
,-X-,-,-.-.-,-.~,~,-,-.-.-.-.-.-.-,-,-,-.~.~.~.~.~,~.-.-.-.-,-,-,-L-.-.-.-.-.-.-.-.-L-,-,-,-----------,-,-,-L-.-.-.-.-.-.-.-:-.-.-.-.-,-.-.-.-.-.-.-.-.-,-X-X-,-X-
,-X-,-,-.-.-,-.~.~.~,~,~,-,-.-,-,-,-.~.~.~.~.~.~.~,~.-.-.-.-,-,-,-X-X-.-.-.-.-.-.-,-X-X-,-,-----------,-,-,-L-.-.-.-.-.-.-.-.-.-.-.-.-,-.-.-.-.-.-.-.-.-,-X-X-X---
,-X-,-,-.-.-,-.~.~.~.~.~.~,~,~,-.~.~.~.~.~.~.~.~.~,~.-.-.-.-,-,-,-X-X-:-.-.-.-.-.-,-X-X-,-,-----------,-,-,-L-.-.-.-.-.-.-.-.-.-.-.-.-,-.-.-.-.-.-.-.-.-,-X-X-X---
--,-X-,-.-.-,-.~.~.~.~.~.~.~.~.~.~.~.~.~.~.~.~.~.~,~.-.-.-.-.-.-,-.-,-.-.-.-.-.-.-,-,-.-,-,-----------,-,-,-X-X-.-.-.-.-.-.-.-:-.-.-.-,-.-.-.-.-.-.-.-.-,-X-X-----
--,-X-,-.-.-,-.~.~.~.~.~.~.~.~.~.~.~.~.~.~.~.~.~.~,~.-.-.-.-:-.-,-X-X-,-:-,-,-,-:-,-X-X-,---B---------,-,-,-X-X-.-.-.-.-.-.-.-.-.-.-,-X-X-.-.-.-.-:-.-,-X-X-------
--,-X-,-.-.-,-.~.~.~.~.~.~.~.~.~.~.~.~.~.~.~.~.~.~,~.-.-.-.-.-.-.-.-X-X-,-,-,-,-,-,-X-X---B-------:---------X-,-X-.-.-.-.-.-.-.-.-.-X---,-X-:-,-,-,-,-X-----------
--,-X-,-.-.-,-.~.~.~.~.~.~.~.~.~.~.~.~.~.~.~.~.~.~,~.-.-.-.-.-.-.-.-,-X-X-.-.-.-.-X---X---------------------X---,-X-,-,-,-,-,-,-,-,-X-,-,-X-.-.-:-.-.-X-,---------
--,-X-,-.-.-,-.~.~.~.~.~.~.~.~.~.~.~.~.~.~.~.~.~.~,~.-.-.-.-.-.-.-.-,-,-,-,-,-,-,-X---X-------:---------------X-,-,-X-,-.-.-.-.-.-.-.-X-X-.-.-.-.-.-.-.-X---------
--,-X-,-.-.-,-.~.~.~.~.~.~.~.~.~.~.~.~.~.~.~.~,~,~,~.-.-.-.-.-.-.-,-,-.-.-.-:-.-.-X---X-------------------B-----X-X-.-,-,-,-,-,-,-,-,-X-X-.-.-.-.-.-.-.-X---------
--,-X-,-.-.-,-.~.~.~.~.~.~.~.~.~.~.~.~.~.~,~,~,~.-.-.-.-.-.-.-.-.-,-,-,-,-,-,-,-,-X-X-----------------------------,-.-.-,-.-.-.-.-.-.-X-X-.-.-.-.-.-.-.-X---------
--,-X-,-.-.-,-,~,~.~.~.~.~.~.~.~.~.~.~,~,~,~.-.-.-.-.-.-.-.-.-.-.-,-X-X-.-.-.-.-,-X-X-----------------------------,-,-.-,-.-.-.-.-.-.-X-X-.-.-.-.-.-.-.-X---------
--,-X-,-.-.-.-.-,-,-,~.~.~.~.~.~.~,~,~,~.-.-.-.-.-.-.-.-.-.-.-.-.-,-X-X-,-,-,-,-X---X-------------------------------,-.-,-,-,-,-.-.-X-,-X-.-.-.-.-.-.-.-X---------
--,-X-,-,-.-.-.-.-.-,-,-,-,~.~,~,~,~.-.-.-.-.-.-.-.-.-.-.-.-.-.-.-,-X-X-.-.-.-.-X---X-------------------------------,-.-,-.-.-,-,-,-X-,-X-.-.-.-.-.-.-.-X---------
--,-X-,-,-,-,-,-.-.-.-.-.-,-,-,~.-.-.-.-.-.-.-.-.-.-.-.-.-.-.-.-.-,-,-.-.-.-.-.-X---X-----,-,-,-,-----------------,-,-.-,-.-.-.-.-.-X-,-X-.-.-.-.-.-.-.-X---------
--,-X-,-,-.-.-,-,-,-.-.-.-.-.-.-.-.-.-.-.-.-.-.-.-.-.-.-.-.-.-.-,-,-,-,-,-,-,-,-X---X-----,-,-,-,-----------------,-.-.-,-,-:-.-:-.-X-,-X-.-.-.-.-.-.-.-X---------
--,-X-,-,-,-,-.-.-,-,-,-,-.-.-.-.-.-.-.-.-.-.-.-.-.-.-.-.-.-.-.-,-,-.-.-.-.-.-.-X-X-----,-,-.-.-,-,-------------X-X-X-X-X-,-,-,-.-X-,-,-X-.-.-.-.-.-.-.-X---------
--,-X-,-.-.-,-,-,-,-.-.-,-,-,-,-.-.-.-.-.-.-.-.-.-.-.-.-.-.-.-.-,-X-X-,-,-,-,-,-X-X-A---,-A-.-.-.-,-A-------A-X-,-,-,-X-.-.-.-,-,-X---,-X-.-.-.-.-.-.-.-X---------
--,-X-,-.-.-.-.-.-,-,-,-.-.-.-,-,-,-.-.-.-.-.-.-.-.-.-.-.-.-.-.-,-X-X-.-.-.-.-.-X-X-X-X-X-X-XY+Y+YXYX-X-X-X-X-,-X-X-X-,-.-.-.-.-,-X---,-X-.-.-.-.-.-.-:-X---------
--,-X-,-.-.-.-.-.-.-.-,-,-,-,-.-.-,-,-,-.-.-.-.-.-.-.-.-.-.-.-.-,-X-X-.-.-.-.-.-X-X-X-X-X-X-XY+Y+YXYX-X-X-X-X-X-,-.-.-,-,-.-.-,-X-----,-X-.-.-X-X-.-.-.-X---------
--,-X-,-.-.-.-.-.-.-.-.-.-.-,-,-,-.-.-,-.-.-.-.-.-.-.-.-.-.-.-,-,-,-.-.-.-.-.-.-.-.-.-.-.-.-.-:-.-.-.-.-.-.-X-X-,-.-.-.-,-,-.-X-------,-X-.-.-X-X-.-.-.-X---------
--,-X-,-.-.-.-.-.-.-.-.-.-.-.-.-,-,-.-,-.-.-.-.-.-.-.-.-.-.-.-,-.-,-.-.-.-.-:-.-.-.-.-.-.-.-.-.-.-.-.-.-.-.-.-,-,-.-.-.-.-,-,-X-------,-X-.-.-.-.-.-.-.-X---------
--,-X-,-.-.-.-.-.-.-.-.-.-.-.-.-.-,-.-,-.-.-.-.-.-.-.-.-E-.-.-,-.-,-.-.-.-.-.-.-.-.-.-.-.-.-.-.-.-.-.-.-:-.-.-,-,-,-.-.-,-,-X---------,-X-.-.-.-.-.-.-.-X---------
--,-X-,-.-.-.-.-.-.-.-.-.-.-.-.-.-,-.-,-.-.-.-.-.-.-.-.-.-.-.-,-.-,-.-.-.-.-.-.-.-.-.-.-.-.-.-.-.-.-.-.-.-.-.-,-.-,-,-,-X-X---------,-,-X-.-.-.-:-.-.-X-,---------
--,-X-,-.-.-.-.-.-.-.-.-.-.-.-.-.-H-.-,-.-.-.-.-.-.-.-.-.-.-.-,-.-,-.-.-.-.-.-.-.-.-.-.-.-:-.-.-.-.-.-.-.-.-X-X-,-X-X-X-------------,-X-:-.-.-.-.-.-.-X-----------
--,-X-,-.-.-.-.-.-.-.-.-.-.-.-.-.-,-.-,-.-.-,-,-,-,-,-,-.-.-.-,-.-,-,-.-.-.-.-.-.-.-,-,-,-,-,-,-,-,-,-,-,-,-X-X-X-------------------,-X-.-.-.-.-.-.-,-X-----------
--,-X-,-.-.-,-,-,-,-,-,-.-.-.-.-.-,-.-,-.-.-X-X-.-.-,-X-X-.-.-,-,-.-,-.-.-.-.-.-.-.-,-.-.-A-.-.-.-.-.-.-.-.-X---------------------,-,-X-.-.-.-.-.-.-X-------------
--,-X-,-,-,-,-,-XZXZ+ZXZX-,-.-.-.-,-.-,-.-,-X-X-,-,-X-,-X-.-.-.-,-X-X-.-.-H-.-.-.-X-X-X-.-.-.-.-.-.-.-X-X-X-X-------------------,-,-X-.-.-.-.-.-.-,-X-------------
--,-X-,-,-,-+Z+ZX-X:.:X:X-,-,-,-.-,-.-,-.-X-,-X-,-,-X---,-X-.-.-H-X-X-X-X-X-X-X-X-X-,-X-X-X-X-X-X-X-X-X-----------------------,-,-X-.-.-.-.-.-.-,-X---------------
--,-X-X-+Z+Z.-.-.-<-<-<-.-.-.-,-,-X-X-X-X-X-,-X-X-.-X---,-X-X-X-X-X---------------------------------,-,-,-,-,-,-,-,-,-,-,-,-,-,-X-.-.-.-.-.-.-.-X-----------------
--,-X-X-.-.-.-.-<-.-.-.-.-.-.-.-.-X-X-------,-,-X].=X]------------------------------------------,-,-,-X-X-X-X-X-X-X-X-X-X-X-X-X-,-X-.-.-.-.-.-X-,-----------------
--,-X-.-.-.-.-.-.-.-.-.-.-.-.-.-.-.-X-,-,-X-X-X-,-,-X-X-X-------------------------------------,-,-X-X-.-.-.-.-.-.-.-.-.-.-.-.-.-X-X-,-:-.-.-,-X-------------------
--,-X-.-.-.-.-.-.-.-.-.-.-.-.-.-.-.-X-X-X-X-------------X-X-,-,-,-------------------------,-,-X-X-.-.-.-.-.-.-.-.-.-.-.-.-.-.-.-.-.-.-,-X-,-X---------------------
--,-X-.-.-.-.-.-.-.-.-.-.-.-.-.-.-.-.-,-A---------------,-X-X-X-X---------------------,-,-,-X-.-.-.-:-.-.-.-.-.-.-.-.-.-.-.-.-.-.-.-.-.-X-X-----------------------
--,-X-.-.-.-.-.-.-.-.-.-.-.-.-.-.-.-.-,-W---------:-----,-.-.-.->-------------------,-,-X-X-.-.-.-,-,-,-,-,-,-,-,-,-.-.-.-.-.-.-.-.-.-.-.-X-,---------------------
--,-X-.-.-.-.-.-.-.-.-.-.-.-.-.-.-.-.-,-,---------------,-.-.-.->-------------------,-X-.-.-.-,-,-,-,-,-,-,-,-,-,-,-,-,-.-.-.-.-.-.-.-.-.-.-X---------------------
----,-X-.-.-.-.-.-.-.-.-.-.-.-.-.-.-.-,-A---------------,-X-X-X-X-------------------,-X-.-.-,-X-,-.-.-.-.-.-.-.-.-.-.-,-,-X-.-.-.-.-.-.-.-.-X---------------------
------,-X-.-.-.-.-.-.-.-.-.-.-.-:-.-X-X-X-X-,-,-,-,-,-,-X-X-------------------------,-X-.-.-X-X-X-.-.-.-.-.-.-.-.-.-.-.-X-X-X-.-.-.-.-.-.-.-X---------------------
--------,-X-X-X-X-,-,-,-X-X-.-.-.-.-X---,-X-,-,-,-,-,-,-X---,-,-,-,-------,-,-------,-X-.-.-X-X-X-.-.-.-.-.-.-.-.-:-.-,-X-X-X-.-.-.-.-.-.-.-X---------------------
--------------,-X-.-A-.-X-X-.-.-.-.-X-,-,-X-.-.-.-.-.-.-X-,-,-X-X-X-,-,-,-,-X-,---,-,-X-.-.-X-X-X-.-.-.-.-.-.-.-.-.-.-,-X-X-X-.-.-.-.-.-.-.-X---------------------
--------------,-X-X-X-X-X-,-.-.-.-.-.-X-X-.-.-.-.-.-.-.-.-X-X-.-,-X-X-X-X-X-X-X-,-,-X-X-.-.-,-.-,-.-.-,-,-,-,-,-.-.-,-,-.-,-.-.-.-.-.-.-.-.-X---------------------
----------------------,-X-X-.-.-.-.-.-.-.-.-.-.-.-.-.-.-.-.-.-.-,-,-.-.-,-.-.-X-X-X-,-.-.-.-,-.-,-,-,-:-.-.-.-,-,-,-,-.-.-:-.-.-.-.-.-.-.-.-X-,-------------------
--------------------------,-X-.-.-.-.-.-.-.-.-:-.-.-.-.-.-.-.-.-,-:-.-.-,-.-.-.-.-.-,-.-.-.-,-.-.-.-.-.-.-.-.-.-.-.-.-.-.-,-.-.-.-.-.-.-.-.-X-X-------------------
----------------------------,-X-.-.-.-.-.-.-.-:-.-.-.-.-.-.-.-.-,-,-.-.-,-.-.-.-.-.-,-.-.-.-,-.-.-.-.-.-.-.-.-.-.-.-.-.-.-,-.-.-.-.-.-.-.-H-X-X-------------------
------------------------------,-X-.-.-.-.-.-.-.-.-.-.-.-.-.-.-.-,-,-.-.-,-.-.-.-.-.-,-.-.-.-,-,-,-,-,-,-,-,-,-,-,-,-,-,-,-,-.-.-.-.-.-.-.-.-X---------------------
--------------------------------,-X-X-.-.-.-.-.-.-.-:-.-.-.-.-.-,-,-.-.-,-.-,-X-X-X-,-.-.-.-,-,-.-.-.-.-.-.-.-.-.-.-.-.-,-,-.-.-.-.-.-.-.-.-X---------------------
------------------------------------,-X-X-X-.-.-.-.-.-.-.-.-.-.-,-X-X-X-X-X-X-X---,-X-X-.-,-,-X-.-.-.-.-.-.-:-.-.-.-.-.-,-X-.-.-.-.-.-.-.-.-X---------------------
------------------------------------------,-X-X-X-X-X-X-X-X-X-X-X-X-,-,-,-,-,-,-,-,-,-X-.-,-X-X-X-.-.-.-.-.-.-.-.-.-.-.-X-X.X-.-.-.-.-.-.-.-X---------------------
------------------------------------------,-X-X-X-X-X-X-X-X-X-X-X-X-X-X-X-X-X-X-X-X-X-X-.-.-X-X-X-.-:-.-.-.-.-.-.-.-.-.-X-X.X-.-.-.-.-.-.-,-X---------------------
--------------------------------------------,-X-.-.-.-.-.-.-.-.-.-.-.-.-.-.-.-.-.-.-X-X-.-.-X-X-X-,-.-.-.-.-.-.-.-.-.-,-X-X-X-.-.-A-.-A-X-X-X---------------------
----------------------------------------------,-X-.-.-.-.-.-.-.-.-.-.-.-.-.-.-.-.-.-X-X-.-.-.-.-.-,-,-.-.-.-.-.-.-,-,-,-.-.-.-A-A-,-X-X-X-X-X---------------------
------------------------------------------------,-X-.-.-.-.-.-.-.-.-.-.-.-.-.-.-.-.-X-X-.-.-.-.-.-.-,-,-,-,-,-,-,-,-.-.-.-.-.-,-X-X-X-X-.-X-----------------------
--------------------------------------------------,-X-X-.-.-.-.-.-.-.-.-.-.-.-.-.-.-X-X-.-.-.-.-.-.-.-,-,-,-,-,-,-.-.-.-.-.-,-X-,-X-.-.-,-X-----------------------
------------------------------------------------------,-X-.-.-.-.-.-.-.-.-.-.-.-.-.-X-X-.-.-.-.-.-.-.-.-.-.-.-.-,-,-.-.-.-,-X-X-X-.-.-.-X-------------------------
--------------------------------------------------------,-X-.-.-.-.-.-.-.-.-.-.-.-.-X-X-X-X-X-X-X-,-,-X-X-,-,-,-X-X-,-,-X-X-X-,-,-,-.-,-X-------------------------
----------------------------------------------------------,-X-.-.-.-.-.-.-.-.-.-.-.-X-X-X-X-X-X-X-.-.-X-X-,-,-,-X-X-.-.-X-X-.-.-.-,-.-X---------------------------
------------------------------------------------------------,-X-.-.-.-.-.-.-.-.-.-.-,-,-.-.-.-.-.-.-.-.-.-.-.-.-.-.-.-.-.-.-.-.-,-,-.-X---------------------------
--------------------------------------------------------------,-X-.-.-.-.-.-.-.-.-.-.-,-.-.-.-.-.-.-.-.-.-.-.-.-.-.-.-.-.-.-.-.-,-.-,-X---------------------------
----------------------------------------------------------------,-X-.-.-.-.-.-.-.-.-.-,-,-.-.-.-.-.-.-.-.-.-.-.-.-.-.-.-.-.-.-,-,-.-X-----------------------------
------------------------------------------------------------------,-X-X-.-.-.-.-.-.-.-.-,-.-.-.-.-.-.-.-.-.-.-.-.-.-.-.-.-.-.-,-.-,-X-----------------------------
----------------------------------------------------------------------,-X-.-.-.-.-.-.-.-,-.-.-.-.-.-.-.-.-.-.-.-.-.-.-.-.-.-.-,-.-X-------------------------------
------------------------------------------------------------------------,-X-.-.-.-.-.-.-,-,-.-.-.-.-.-.-.-.-.-.-.-.-.-.-.-.-,-,-,-X-------------------------------
--------------------------------------------------------------------------,-X-.-.-.-.-.-.-,-.-.-.-.-.-.-.-,-,-,-.-.-.-.-.-.-,-.-X---------------------------------
----------------------------------------------------------------------------,-X-.-.-.-.-.-,-.-.-.-.-.-,-,-,-.-,-.-.-.-.-.-.-,-.-X---------------------------------
------------------------------------------------------------------------------,-X-.-.-.-.-,-,-.-.-.-.-,-.-.-.-,-,-,-,-.-.-,-,-,-X---------------------------------
--------------------------------------------------------------------------------,-X-.-.-.-.-,-.-.-.-.-,-.-.-.-.-,-,-,-,-.-,-.-X-----------------------------------
----------------------------------------------------------------------------------,-X-X-.-.-,-,-.-.-.-,-,-.-H-.-,-,-.-,-,-,-,-X-----------------------------------
--------------------------------------------------------------------------------------,-X-.-.-,-.-.-.-.-,-,-,-,-,-,-,-,-,-.-X-------------------------------------
----------------------------------------------------------------------------------------,-X-.-,-,-,-,-,-,-,-,-.-.-.-.-,-,-,-X-------------------------------------
------------------------------------------------------------------------------------------,-X-.-.-.-.-.-.-,-,-.-.-.-.-.-.-X---------------------------------------
--------------------------------------------------------------------------------------------,-X-X-X-X-X-X-X-X-X-X-X-X-X-X-X---------------------------------------
