----------------------------------------------------------------------,-,-,-X-X-X-,-,-------------------------------------------------------------------------------------------------
--------------------------------------------------------------------,-,-X-X-.-.-.-X-X-,-----------------------------------------------------------------------------------------------
--------------------------------------------------------------------,-X-.-.-.-E-.-,-.-X-,-,-------------------------------------------------------------------------------------------
----------------------------------------------------------------,-,-,-X-,-,-.-.-.-,-,-.-X-X-,-,-,-,-----------------------------------------------------------------------------------
------------------------------------------------------------,-,-,-X-X-.-.-,-X-.-.-.-,-.-E-.-X-X-X-X-----------------------------------------------------------------------------------
--------------------------------------------------------,-,-,-X-X-.-.-.-.-X-X-.-.-X-X-X-.-.-.-.-.-X-,---------------------------------------------------------------------------------
------------------------------------------------------,-,-X-X-.-E-.-.-.-H-X-X-.-.-.-X-,-X-X-.-.-.-.-X---------------------------------------------------------------------------------
------------------------------------------------------,-X-.-.-.-.-.-.-.-X-,-X-.-.-.-X-X-X-,-X-.-E-.-X---------------------------------------------------------------------------------
----------------------------------------------------,-,-X-.-.-.-.-.-.-,-,-X-X-,-.-.-,-.-.-X-X-.-.-.-X---------------------------------------------------------------------------------
----------------------------------------------------,-X-,-,-.-X-X-X-X-X-X-,-X-,-.-,-,-.-.-.-.-.-.-.-X-,-------------------------------------------------------------------------------
----------------------------------------------------,-X-.-,-,-X---------,-X-.-,-,-,-.-.-.-E-.-.-.-.-.-X-------------------------------------------------------------------------------
------------------------------------------------------,-X-.-,-X-,-----,-,-X-E-.-,-X-X-X-,-,-,-.-.-.-.-X-------------------------------------------------------------------------------
------------------------------------------------------,-X-.-E-.-X-,-,-,-X-.-.-.-X-,-,-X-X-.-,-.-E-.-,-X-------------------------------------------------------------------------------
------------------------------------------------------,-,-X-.-.-.-X-X-,-X-.-.-,-X-,-X-.-W-.-,-.-,-X-X---------------------------------------------------------------------------------
----------------------------------------------------,-,-X-.-.-:-.-.-.-X-X-.-E-X-,-,-X-.-.-.-X-X-X-------------------------------------------------------------------------------------
--------------------------------------------------,-,-X-,-,-,-.-.-.-.-X-X-.-.-X-,-X-.-.-.-.-X-----------------------------------------------------------------------------------------
--------------------------------------------------,-X-.-.-.-,-X-X-,-,-X-X-.-.-X-,-X-A-.-.-.-X-,---------------------------------------------------------------------------------------
--------------------------------------------------,-X-.-E-.-X-,-X-.-.-.-.-.-.-X-X-.-.-.-A-.-.-X---------------------------------------------------------------------------------------
--------------------------------------------------,-X-.-.-,-X-,-X-.-.-.-.-E-,-X-X-<-.-W-.-.-.-X-,-------------------------------------------------------------------------------------
----------------------------------------------------X-.-.-X-,-,-X-.-.-.-.-.-X-,-X-.-.-.-.-.-.-.-X-------------------------------------------------------------------------------------
----------------------------------------------------,-X-.-.-X---,-X-X-X-.-,-X-,-,-X-.-.-.-.-.-.-X-------------------------------------------------------------------------------------
----------------------------------------------------,-X-.-.-,-X-,-X-X-,-X-X-X-X-,-X-<-.-.-.-<-H-X-------------------------------------------------------------------------------------
----------------------------------------------------,-X-.-E-.-X-,-X-.-X-X-X-.-,-X-,-X-.-<-.-.-,-X-------------------------------------------------------------------------------------
------------------------------------------------------,-X-.-,-,-X-.-.-.-.-.-.-.-X---,-X-X-X-X-X-,-------------------------------------------------------------------------------------
--------------------------------------------------------,-X-,-.-.-.-.-.-.-.-.-.-,-X-,-,-,-,-,-X-X-,-,---------------------------------------------------------------------------------
------------------------------------------------,-,-,-,-,-,-X-.-.-.-.-.-.-.-.-.-.-X-X-X-X-X-X-.-A-X-X-,-------------------------------------------------------------------------------
----------------------------------------------,-,-X-X-X-X-X-.-.-.-.-.-.-.-E-.-.-.-.-.-.-.-.-.-.-.-.-.-X-------------------------------------------------------------------------------
----------------------------------------------,-X-.-.-.-.-.-.-.-.-.-.-.-.-.-.-.-.-.-.-.-.-.-.-.-.-.-X-,-------------------------------------------------------------------------------
------------------------------------------------,-X-.-.-.-.-.-.-.-.-.-.-.-.-<-.-.-.-.-.-.-E-.-.-.-.-X-,-------------------------------------------------------------------------------
--------------------------------------------------X-.-.-.-.-.-.-.-.-.-.-.-.-.-.-.-.-.-.-.-.-.-.-.-.-.-X-,-----------------------------------------------------------------------------
----------------------------------------,-,-,-,---,-X-.-.-E-.-.-.-.-.-.-.-.-.-.-.-.-.-.-.-.-.-.-.-.-.-.-X-,---------------------------------------------------------------------------
--------------------------------------,-,-X-X-X-,-,-,-X-.-.-.-.-.-.-.-.-.-.-.-.-.-.-.-.-.-.-.-.-E-.-.-.-.-X---------------------------------------------------------------------------
--------------------------------------,-.-X-.-.-X-X-X-.-.-.-.-.-.-.-.-,-,-,-,-,-.-.-.-.-.-.-.-.-.-.-.-.-X-,---------------------------------------------------------------------------
------------------------------------,-,-X-.-.-.-.-.-.-.-.-.-.-.-.-,-,-,-.~H~.~,~,~,~,-.-.-.-.-.-.-.-.-.-X-,---------------------------------------------------------------------------
------------------------------------,-.-X-.-.-E-.-.-.-.-.-.-.-.-,-,-.~.~.~.~.~.~.~.~,~.-.-.-.-.-.-.-.-.-.-X---------------------------------------------------------------------------
------------------------------------,-X-.-.-.-.-.-.-.-.-.-.-.-.-,-.~.~.~.~.~.~.~.~.~,~,~.-.-.-.-.-.-.-.-.-X-,-------------------------------------------------------------------------
------------------------------------,-X-.-.-.-.-.-.-.-.-.-.-.-,-,~.~,~,~,~,~,~,~,~.~.~,~.-.-.-.-.-.-.-.-.-,-X-,-,-,-------------------------------------------------------------------
--------------------------------------,-X-,-X-X-X-.-.-.-.-.-.-,-.~,~,~.-.-.-K-.-,-,~,~,~.~.-.-.-E-.-.-,-X-X-,-X-X-X-,-,---------------------------------------------------------------
--------------------------------------,-X-X-,-,-,-X-.-.-.-.-.-,-.~,~.-,-,-,-,-,-,-.-,-,~.~.-.-.-.-.-.-X-,-X-X-.-A-.-X-X---------------------------------------------------------------
--------------------------------------------,-X-X-X-.-.-.-.-.-,-.~,~.-,-.-E-.-E-,-.-,-,~,~.-.-.-.-.-.-.-X-.-.-.-.-.-.-X-,-------------------------------------------------------------
--------------------------------------------,-X-.-.-.-.-.-.-.-,-.~,~.-,-.-.-.-.-,-,-,-.~,~.-.-.-.-.-.-.-.-.-,-X-X-X-H-.-X-------------------------------------------------------------
--------------------------------------------,-X-.-.-.-.-.-.-.-,-.~,~.-,-.-.-.-.-,-,-,-.~,~.-.-.-.-.-.-.-.-,-X---,-X-.-.-X-------------------------------------------------------------
--------------------------------------------,-X-.-.-.-.-E-.-.-,-.~,~.-,-H-.-.-.-,-.-,-.~,~.-.-.-.-.-.-,-,-X-----,-X-.-A-X-------------------------------------------------------------
--------------------------------------------,-X-.-.-.-.-.-.-.-,-.~,~,-,-A-.-E-,-H-,-,-.~,~.-.-.-E-.-.-X-X---,-,-,-X-,-,-X-------------------------------------------------------------
--------------------------------------------,-X-.-.-.-.-.-.-.-,-,~,~,~.-X-X-,-X-,-,-.~,~,~.-.-.-.-.-.-X-,-,-,-X-X-,-A-,-X-------------------------------------------------------------
--------------------------------------------,-X-.-.-.-.-.-.-.-.-,~,~,~,-X-X-,-X-,-.~.~,~.~.-.-.-.-.-.-.-X-,-X-,-A-,-.-,-X-------------------------------------------------------------
--------------------------------------------,-X-.-.-.-.-.-.-.-.-.-,~,~.~X~X-.-X-.~,~,~,~.-.-.-.-.-.-.-.-,-X-,-,-,-A-,-X---------------------------------------------------------------
----------------------------------------------,-X-.-.-.-.-.-.-.-.-.-,-,~X~X-,-X-,~,~.-.-.-.-.-.-.-.-.-.-.-,-.-W-,-,-X-----------------------------------------------------------------
------------------------------------------------,-X-,-,-,-,-,-,-,-,-,-,-X~X-,-X-,~,-,-,-,-,-,-,-.-.-.-.-A-,-X-X-X-X-------------------------------------------------------------------
--------------------------------------------------,-X-X-.-.-.-.-.-.-,-X-X~X-.-X-,~X-.-.-.-.-.-X-X-X-X-X-X-X-X-------------------------------------------------------------------------
------------------------------------------,-,-,-,-,-,-X-E-,-X-X-X-X-X-X~X~X-,-X-.~X~X-X-X-X-.-X---------------------------------------------------------------------------------------
----------------------------------------,-,-X-X-X-X4X4X4.-X-X~X~X~X~.~.~X~X-.-X-.~.~X~X~X~X~X-X---------------------------------------------------------------------------------------
----------,-,-,-,-----------------------,-X-X-.-,-.4.4,4.-X-X~.~.~.~.~,~X~X-E-X-.~.~.~.~.~X~X-X---------------------------------------------------------------------------------------
----------,-X-X-X-----------------------,-X-.-.-E-X4X4X4X-X-X~.~.~.~.~X~X-.-.-X-X~.~.~.~.~X~X-X---------------------------------------------------------------------------------------
----------,-X-.-X-----------------------,-X-.-.-.-X---,-,-,-X~.~.~.~,~X-X-.-.-.-X-.~.~.~,~X~,-,-,-------------------------------------------------------------------------------------
----------,-X-.-X-----------------------,-X-X-.-.-X-,-,-X-X-X-.~.~,~X~X-.-.-H-.-X-X~.~.~,~X-X-X-X-,-----------------------------------------------------------------------------------
----------,-X-.-X-,-,-,-,-,-,-,-,-------,-X-X-.-.-X-,-X-.-.-,-.~.~,~X-X-.-.-E-.-X-X-.~.~.~,~,-.-.-X-----------------------------------------------------------------------------------
----------,-X-.-.-X~X~X~X~X~X~X~,-,-----,-X-.-E-.-X-X-A-.-.-,-.~.~,~.-.-.-.-.-.-.-,-.~.~.~.~,~.-.-A-X-,-,-,-,-------------------------------------------------------------------------
----------,-X-.-.-.~.~.~.~.~.~.~X~X~,---,-X-.-.-.-+-+-.-.-.-,-.~E~,~.-.-E-.-.-.-.-,-.~.~.~.~,~.-E-,-X-X-X-X-X-,-----------------------------------------------------------------------
----------,-X-.-.-.~H~.~,~,~,~,~.~.~X~--,-X-X-.-.-+-+-.-E-.-,-.~.~,~.-,-,-,-A-,-,-,-.~E~.~.~,~.-.-,-+-+-,-,-.-X-----------,-,-,-,-,---------------------------------------------------
------------,-X-,-,~,~,~,~.~.~,-,~.~X~--,-,-X-X-X-X-X-.-.-,-,-.~.~,~X-X-.-.-.-.-X-X-.~.~.~.~,~.-.-,-X-X-X-X-,-X-,-,-,-,-,-,-X-X-X-X---------------------------------------------------
--------------,-X-X-.-.-,-,-,-,-,-,~X~,-,-X~X~X~X~X~X-,-,-,-.~.~.~,~X-X-,-,-,-,-X-X-.~.~.~.~,~.-A-,-X---,-X-,-X-X-X-X-X-X-X-.-.-.-,-X-------------------------------------------------
--------------,-,-X-,-,-,-.-.-,-.-,~.~X~X~.~.~.~H~.~X~X~X-.~.~.~.~,~.-.-.-.-.-.-.-,-.~.~.~.~,~X-X-X-----,-X-.-H-,-E-,-,-.-H-,-E-.-.-X-------------------------------------------------
------------,-,-X-.-.-.-.-.-E-,-.-,-,~,~.~,~X~X~X~X~.~.~X~.~.~.~.~,~.-.-.-.-.-.-.-,-.~.~.~.~.~X~----------,-X-X-X-.-,-X-X-X-,-X-X-H-,-X---,-,-----------,-,-,-------------------------
------------,-X-.-.-.-.-.-.-.-,-,-,-.-X-X~X~------X-.~.~X~.~.~.~.~,~,-,-,-,-E-,-,-,-.~.~.~.~.~X~--------------,-X-,-X---,-X-,-X-X-.-.-X-,-,-X~,-,---,-,-,-X-X~,-----------------------
--------------,-X-.-.-.-.-.-.-.-.-,-,-X-,-,-,-,---,-X~.~X~.~.~.~.~,~X-X-.-.-.-.-X-X-.~.~.~.~.~X~------------,-,-X-,-X-,-,-X-.-X-,-X-E-X-,-X-.~X~X~,-,-X-X~.~.~X-,---------------------
----------------,-X-.-.-.-.-.-.-.-.-.-.-X-X-X-X---,-X~.~.~.~.~.~E~.~X~X-,-,-,-,-X-X~.~.~.~.~.~X~------------,-X-.-E-X-,-X-X-+-X-X-X-.-X-,-X~.~.~.~X~X~.~.~.~.~.~X---------------------
--------------,-,-X-.-.-.-.-.-.-.-.-.-.-.-.-.-X-,-,-X~X~X~.~.~.~.~.~.~.~.~.~.~.~.~.~.~.~E~.~.~X~----------,-,-X-H-X-,-X-.-.-W-.-.-X-X-X-X~.~.~.~.~.~.~.~.~.~.~.~X~,-,-----------------
--------------,-X-.-.-.-E-.-.-.-.-.-.-.-.-.-.-X-X-X-X-X-X-.~.~.~.~.~.~.~.~.~.~.~.~.~.~.~.~.~.~X~--------,-,-X-,-A-X-,-X-.-.-E-.-E-X-X-X-.~.~.~.~.~.~.~.~.~.~.~.~.~X~X-,-,-,-----------
--------------,-X-.-.-.-.-.-.-E-.-.-.-.-.-E-.-.-.-.-.-.-X-.~.~.~.~.~.~.~,~,~,~,~.~.~.~.~.~.~.~X~--------,-X-.-A-,-X-,-X-,-,-,-,-,-X-X-X-.~.~.~.~.~.~.~.~.~.~.~.~.~.~.~X~X~X-,-,-------
--------------,-X-,-,-,-.-.-.-.-.-.-.-.-.-.-.-X-X-X-X-.-X-,~,~,~.~.~.~,~,~.-.-,-.~.~.~,~,~,~,~X~--------,-X-.-X-X-----,-X-+-+-+-X-,-X-X-.~.~.~.~.~.~.~.~.~.~.~.~.~.~.~.~.~.~X~X~------
--------------,-X-,-,-,-,-.-.-.-.-.-.-.-.-.-.-X-,-,-X-H-X-.-.-,-,~.~.~,~.-.-.-,-.~.~,~,~.-.-.-X-,-,-,-,-,-X-A-X-,-,---,-XR+R+R+RXRX-.-X-.~.~.~.~.~.~.~.~.~.~.~.~.~.~.~.~.~.~.~X-------
------------,-,-X-.-,-,-,-.-E-.-.-E-.-.-.-.-.-X-,-X~X-,-X-,-,-,-,-,~,~,~.-.-W-,-,~,~,~.-,-,-,-X-X~X~X~X~X~X-,-X-X~X~,-,-X-.-.-.-X-X-E-X-.~.~.~.~.~.~.~.~.~.~.~.~.~.~E~.~.~.~,~X-------
------------,-X-.-H-.-,-.-,-.-.-.-.-.-.-.-.-.-X-,-X~.~.~.~.~.~,~,-.-.-,-.-.-.-,-.-.-.-,-,-.~.~.~.~.~.~.~.~.~.~.~.~X~X~X-X-.-.-.-X-X-.-X-.~.~.~.~.~.~.~.~.~.~.~.~.~.~.~.~.~.~X~--------
------------,-X-.-.-.-.-,-,-X-X-.-,-,-X-X-X-X-X-,-X~E~.~.~.~.~.~,~,-,-,-.-.-<-,-,-,-,-,-.~.~.~.~.~.~.~.~.~.~.~.~.~.~,~,-.-.-.-.-X-X-.-+-.~.~.~.~.~.~.~.~.~.~.~.~.~.~.~.~.~.~X~--------
--,-,-,---,-,-,-X-X-,-,-X-X-,-,-X-X-X-,---------,-X~.~.~.~.~.~.~.~.~.~,~.-.-.-,-.~.~.~.~.~.~.~.~.~.~.~.~.~.~.~.~.~.~,~,-.-.-E-.-X-X-X-X-.~,~,~,~,~,~.~.~.~.~.~.~.~.~.~.~.~.~X~,-------
--,-X-X-,-,-X-X-X-X-X-X-,-X-X-X-X-X-X-X-----,-,-,-X~.~.~.~.~.~.~.~.~.~,~.-.-t.,-.~.~.~.~.~.~.~.~.~.~.~.~.~.~.~.~.~.~,~,-.-.-.-,-X-X-,-X~X~X~X-.-.-X-.~.~.~.~.~.~.~.~.~.~.~.~.~X-------
--,-X-:-X-X-.-.-.-X---,-.-X-A-.-A-.-.-X---,-,-X-X-X-.~.~.~.~.~.~.~.~.~,~,-,-,-,-.~.~.~.~.~.~.~.~.~.~.~.~.~.~.~.~.~.~,~X-X-X-.-,-,-,-X-X-X-X-X-,-,-X-,-,~.~.~.~.~.~.~.~.~.~.~.~X~,-----
--,-X-.-.-.-.-.-.-X-,-,-X-.-E-A-.-.-A-,-X-,-X-X-A-,-.~.~.~.~.~.~.~.~.~.~.~.~.~.~.~.~.~.~.~.~.~.~.~.~.~.~.~.~.~.~.~.~.~,~X-X-.-E-,-,-,-,-.-+Q+Q.-A-.-,-X-X~.~.~.~.~.~.~.~.~.~.~.~X~,---
,-,-X-.-.-.-.-:-.-X-,-.-X-:-.-.-.-.-.-.-X-X-X-,-:-,-.~.~.~.~.~.~.~.~.~.~.~.~.~.~.~.~.~.~.~.~.~.~.~.~.~.~.~.~.~.~.~.~.~,~.-,-.-.-,-,-,-,-,-+Q+Q.-.-A-,-X-X-.~.~.~.~.~.~.~.~.~.~.~.~X---
,-X-.-.-.-.-.-.-.-X-X-X-.-:-.-:-:-.-.-:-X-X_,-A-A-,-.~.~.~.~.~.~.~.~.~.~.~.~.~.~.~.~.~.~,~X~,~X~.~.~.~.~.~.~.~.~.~.~,~,~,-,-E-.-,-,-,-.-,2.-+Q+QH-,-,-.-,-,-.~.~.~.~.~.~.~.~E~.~.~X~,-
X-.-.-.-.-.-.-.-.-,-.-.-.-.-.-.-.-.-.-.-+-+_,-,-.-,-.~.~.~.~.~.~.~.~.~.~.~.~E~.~.~.~.~.~X~X@t.X0X~.~.~.~.~.~.~.~.~.~,~.-,-.-.-.-,-,-,-.-,2.-.-+Q.-,-.-.-.-X-X~.~.~.~.~.~.~.~.~.~.~,~X~
X-.-.-:-.-.-.-.-.-,-.-.-.-.-.-:-.-.-E-:-+-+_,-A-A-,-.~.~.~.~.~.~.~.~.~.~.~.~.~.~.~.~.~.~,~t@.-t0.~.~.~.~.~.~.~.~.~.~,~.-,-.-t0E-,-,-,-.-,2E-.-.-.-H-.-.-K-X-X~.~.~.~.~.~.~.~.~.~,~X---
,-X-.-.-.-.-.-.-.-,-.-.-.-.-.-.-.-.-.-.-+-+_,-,-.-,-E~.~.~.~.~.~.~.~.~.~.~.~.~.~.~.~.~.~X~X5t5X0X~.~.~.~.~.~.~.~.~.~,~,-,-,-.-.-,-,-,-.-,2.-+Q+Q.-,-.-.-,-,-.~.~.~.~.~.~.~.~,~X~X-----
,-X-.-.-.-.-.-.-.-,-.-.-.-.-:-.-.-.-.-:-+-+_,-A-:-,-.~.~.~.~.~.~,~,~,~,~,~.~.~.~.~.~.~.~,~X/,/X/.~.~.~.~.~.~.~.~.~.~.~,~.-,-.-,-E-,-,-.-,2.-+Q+QH-,-A-,-,-.~.~.~.~.~.~.~.~.~X~,-------
,-X-.-.-.-.-.-.-.-X-X-X-.-.-E-.-:-.-.-.-X-X_,-,-A-,-.~.~.~.~.~,~,~.-.-.-,-,~.~.~.~.~.~.~.~.~.~.~.~.~.~.~.~.~.~.~.~.~.~,~.-,-.-,-,-,-.-,-,-+Q+Q,-,-,-,-X-X-.~.~.~.~.~.~.~.~.~.~X-------
X-.-.-.-:-.-:-.-.-X---X-.-:-.-A-.-.-A-.-X-X-X-,-.-,-.~.~.~.~,~,~,-,-,-,-.-,~.~.~.~.~.~.~.~.~.~.~.~.~.~.~.~.~.~.~.~.~,~,~X-X-.-,-,-,-,-X-X-XQ+Q,-A-.-.-X-X-.~.~.~.~.~.~.~.~.~.~X~,-----
>-.-.-.-.-.-.-.-.-X---,-X-.-.-.-.-.-.-X-,-,-X-X-:-,-.~.~.~.~,~.-,-.-t=,-,-,-,~.~.~.~.~.~.~.~.~.~.~.~.~.~.~.~.~.~.~.~,~X-X-X-.-,-,-X-X-,-,-,-X-,-,-X-,-,~.~.~.~.~.~.~.~.~.~.~.~.~X-----
>-.-.-.-.-.-.-.-.-X-----X-.-A-:-A-.-.-X-----,-X-.-,-.~.~.~.~,~.-,-.-.-,-,-,-,-.~.~.~.~.~.~.~.~,~,~,~,~,~,~,~,~,~.~.~,~,-.-.-.-.-X---,-X~X~X~X~.~,~X-.~.~.~.~.~.~.~.~.~.~.~E~.~,~X~----
>-,-X-X-X-X-.-.-.-X-----,-X-X-X-.-X-X-X-----,-X-.-,-.~.~.~.~,~.-,-.-E-,-,-,-,-.~.~.~.~.~.~.~,~,~:-.-.-.-:-.-.-:-,~.~,~,-.-.-E-.-X---,-X~.~.~.~.~.~.~.~.~.~.~.~.~.~.~.~.~.~.~.~X~------
X-X-------,-X-X-.-X---------,-X-+-X-X-X-----,-X-.-,-.~.~.~.~,~.-,-.-.-,-,-,-,-.~.~.~.~.~.~.~,~,-,-,-,-,-,-,-,-,-,-,~,~,-.-.-.-.-X---,-X~.~.~.~.~.~.~.~.~.~.~.~.~.~.~.~.~.~.~,~X-------
--------------,-X-X---------,-X-.-.-.-X-----,-X-.-,-.~.~.~.~,~.-,-.-.-,-.-,-.~.~.~.~.~.~.~,~,~,-.-.-E-.-.-.-E-,-.-.-,~X-X-H-<-H-X---,-X~.~.~.~.~.~.~.~.~.~.~.~.~.~.~.~.~,~X~X~--------
----------------------------,-X-.-<-.-X-----,-X-t@,-X~X~.~.~,~,-,-.-.-,-,-,-H~.~.~,~X~X~.~,~:~.-.-.-.-.-.-.-.-,-,-:-X-,-X-X-.-X-X---,-X~.~.~.~.~.~.~.~.~.~.~.~.~.~,~X~X-X-------------
----------------------------,-X-X-X-X-X-----,-X-X-X-,-X~X~X~X~X-X-.-.-.-X-X-X~X~X~X~,-X~X~X~X-.-.-.-X-X-X-X-.-.-.-X-,---,-X1X1X1----,-X~.~.~.~.~.~.~.~.~.~.~.~.~.~X~------------------
------------------------------------------------------,-,-,-,-,-X-.-.-.-X-----,-,-X-X-X-X-X-X-.-.-.-X-X-,-X-.-.-.-X-X---------------,-X~.~.~.~.~.~.~.~.~.~.~.~.~,~X~------------------
----------------------------------------------------,-,-X-X-X-X-X-.-.-.-X-,-,-X-X-,-.-E-.-.-.-.-.-.-.-X-X-X-.-.-.-.-X---------------,-X~,~X~X~.~.~.~.~.~.~.~.~.~X~--------------------
----------------,-,-,-,-,-,-,-,-,-,-,-,-,-,-,-,-,-,-,-X-.-.-E-.-.-.-.-.-X-,-X-.-A-,-,-.-.-.-.-.-.-.-.-X-X-.-.-E-.-.-X---------------,-X~X---,-X~X~.~.~.~,~X~X~X~X~--------------------
--------------,-,-X-X-X-X-X-X-X-X-X-X-X-X-X-X-X-X-X-X-X-.-.-.-.-.-.-.-,-X-X-,-.-.-.-,-,-,-.-.-.-.-.-.-X-X-.-.-.-.-.-X---------------------------,-X~X~,~X~----------------------------
--------------,-X-.-.-.-.-.-.-E-.-.-.-.-.-.-.-E-.-.-.-.-.-.-.-.-.-.-.-,-X-X-,-,-,-.-.-.-,-,-,-.-.-.-.-X-X-.-.-.-.-.-X-------------------------------,-X~------------------------------
--------------,-X-A-.-E-.-.-.-.-.-.-.-E-.-.-.-.-.-.-.-.-.-.-E-.-.-.-.-,-.-,-.-.-,-,-.-.-.-.-,-.-.-.-.-X-X-.-.-.-.-.-X-----------------------------------------------------------------
--------------,-X-.-.-.-X-X-.-.-X-X-.-.-X-X-.-.-X-X-.-.-.-.-.-.-.-.-.-,-.-,-.-.-.-,-,-,-.-.-,-,-.-.-.-X-X-X-.-t5.-.-X-----------------------------------------------------------------
--------------,-,-X-.-.-X-X-X-X-X-X-X-X-X-X-X-X-X-X-X-X-.-.-.-.-.-.-.-A-X-X-,-.-.-E-.-,-,-.-.-,-,-,-.-.-X-X-X-X-X-X-X-----------------------------------------------------------------
--------------,-X-.-.-.-X-X-.-.-X-X-.-.-X-X-.-.-X-X-X-,-X-.-.-X-X-X-X-X-X-X-,-,-,-.-.-.-,-.-.-.-.-,-,-,-,-X-X-X-X-X-,-----------------------------------------------------------------
--------------,-X-.-E-.-.-.-.-E-.-.-E-.-.-.-.-.-.-.-.-X-.-.-.-.-X-X-X-X9X-XX.-.-,-.-.-.-,-,-.-.-.-.-.-E-.-.-,-,-.-,-X-----------------------------------------------------------------
--------------,-X-.-.-.-.-.-.-.-.-.-.-.-.-.-E-.-.-.-.-E-.-.-.-.-A-X-.-t9,-.-.-.-,-,-.-.-.-,-,-,-.-.-.-,-,-,-,-.-.-,-X-----------------------------------------------------------------
--------------,-X-X-X-X-X-X-X-X-X-X-X-X-X-X-X-X-X-X-.-.-.-.-.-.-.-X-X-X9X-XX,8.-.-,-,-.-.-.-.-,-,-,-,-,-.-.-.-.-,-,-X-----------------------------------------------------------------
----------------------------------------,-,-X~,---,-X-.-.-.-.-.-.-X-X?X-X-X-,-,8,8.-,-,-.-.-.-.-E-.-.-.-.-.-.-,-,-.-X-----------------------------------------------------------------
--------------------------------------,-,-X~.~X~,---,-X-.-.-.-.-.-,-E?.-.-X-.-.-,-.8.-E-,-,-.-.-.-.-.-.-.-,-,-,-E-<-X8----------------------------------------------------------------
------------------------------------,-,-X~.~.~.~X~,-,-,-X-.-.-.-.-,-,?,-K-X-.-.-,-,8.-.-.-,-,-,-,-,-,-,-,-,-.-.-.-,-X8----------------------------------------------------------------
------------------------------------,-X~.~.~.~.~.~X~,-X-A-.-A-A-.-,-.?.-,-X-A-,-.-,-,8.-.-.-.-.-.-.-.-.-t<.-.-,-,8,8X-----------------------------------------------------------------
------------------------------------,-X-.~.~.~.~,~H~X~X-X-.-.-.-.-,-X?X-X-X-X-,-,-.-,-,8,8.-.-.-.-.-E-.-.-,-,8,8,-.-X-,-,-,-,-,-,-,-,-,-----------------------------------------------
--------------------------------------,-X~.~.~.~,~.-.-X@X-,-,-,-,-,-X-X-X~X~X-.-,-,-E-.-,-,8,8,8,8,8,8,8,8,8.-,-,-,-X-X~X~X~X~X~X~X~X~X~,---------------------------------------------
--------------------------------------,-X-.~.~.~,~.-.-t@W-.-A-.-A-.-E-,-.~.~,~,-.-,-.-.-.-.-A-,-X-X-.-.-.-.-.-,-.-,-,-.~.~.~.~.~.~.~.~.~X-,-------------------------------------------
----------------------------------------,-X~.~.~,~,-,-t@,-,-,-,-,-,-,-,-.~.~,~,-,-,-,-,-,-,-,-X-,-X-,-,-,-,-,-,-,-,-,-.~.~.~.~.~.~.~.~.~.~X-------------------------------------------
--------------------------------------,-,-X~.~.~.~.~.~.~.~.~.~.~.~.~.~.~.~.~.~,~,-,-,-,-,-,-,-X-X~X-,-,-,-,-,-,-,-.~.~.~.~.~.~.~.~.~.~.~.~X~,-----------------------------------------
--------------------------------------,-X-.~.~.~.~.~.~.~.~.~.~.~.~.~.~.~.~.~.~.~.~.~.~.~.~.~.~.~.~.~.~,~,~,~.~.~.~.~.~.~.~.~.~.~.~.~.~.~.~,~X~----------------------------------------
------------------------------------,-,-X~.~.~.~.~.~.~.~.~.~.~.~.~.~.~E~.~.~.~.~.~.~.~.~.~.~.~.~.~.~,~,~,-,-,~.~.~.~.~.~.~.~.~.~.~.~.~.~.~X~------------------------------------------
------------------------------------,-X-.~.~.~.~.~.~.~E~.~.~.~.~.~.~.~.~.~.~.~.~.~.~.~.~.~.~.~.~.~.~,~t=t=t=,-.~.~.~.~.~.~.~.~.~.~.~.~.~,~X-------------------------------------------
----------------------------------,-,-X~.~.~.~.~.~.~.~.~.~.~.~.~.~.~.~.~.~.~.~.~.~.~.~.~.~.~.~.~.~.~,~t=.-t=,-.~.~.~.~.~E~.~.~.~.~.~.~.~X~--------------------------------------------
----------------------------------,-X-.~.~.~.~.~.~.~.~.~.~.~.~.~.~.~.~.~.~.~.~.~.~.~.~.~.~.~.~.~.~.~,~t=t=t=,-.~.~.~.~.~.~.~.~.~.~.~.~.~X~,-------------------------------------------
----------------------------------,-X~.~.~.~.~.~.~.~.~.~.~.~.~.~.~.~.~.~.~.~.~.~.~.~.~E~.~.~.~.~.~.~.~,~,-.~.~.~.~.~.~.~.~.~.~.~.~.~.~.~.~X-------------------------------------------
------------------------------------,-X-X~.~.~.~.~.~.~.~.~X~X~X~X~X~X~X~X~.~.~.~.~.~.~.~.~.~.~.~.~.~.~.~.~.~.~.~.~.~.~.~.~.~.~.~.~.~.~.~.~X~,-----------------------------------------
----------------------------------------,-X~.~.~.~.~.~.~.~X~X-X-X-X-X-X-X~.~.~.~.~.~.~.~.~.~.~.~.~.~.~.~.~.~.~.~.~.~.~.~,~,~,~,~.~.~.~.~.~.~X-----------------------------------------
------------------------------------------,-X-.~.~.~.~.~.~X~X-E-.-.-E-X-.~.~.~.~.~.~.~.~.~.~.~.~.~X~X~X~X~X~X~X~X~.~.~.~,~.-.-,-.~.~.~.~.~,~X~----------------------------------------
--------------------------------------------,-X-X~.~.~.~.~X~X-.-.-.-H-X-.~.~.~.~.~.~.~.~.~.~.~.~.~X~X-X-X-X-X-X-X~.~.~.~,~,-t9,-.~.~.~.~,~X~------------------------------------------
------------------------------------------------,-X~.~.~.~X~XW+W+W+WXWX-.~.~.~.~.~E~.~.~.~.~.~.~.~X~X-.-E-.-.-X-.~.~.~E~.~,~,-,-.~.~.~,~X~--------------------------------------------
----------------------------------------------,-,-X~.~.~.~X~XW+W+W+WXWX~X~.~.~.~.~.~.~.~.~.~.~.~.~X~X-.-.-.-H-X-.~.~.~.~.~.~.~.~X~X~,~X~----------------------------------------------
----------------------------------------------,-X-.~.~.~.~X~X-,-,-,-X-X~X~.~.~.~.~,~,~,~.~.~.~.~.~X~XV+V+V+VXVX-.~.~.~.~.~.~.~,~X-,-X~------------------------------------------------
----------------------------------------------,-X~.~.~.~.~.~.~.~.~.~.~.~.~.~.~.~,~,~,-,-,~.~.~.~.~X~XV+V+V+VXVX~X~.~.~.~.~.~.~X~------------------------------------------------------
------------------------------------------------,-X~.~.~.~.~.~.~E~.~.~.~.~.~.~.~,~t<t<t<,-.~.~.~.~X~X-,-,-,-X-X~X~.~.~.~.~.~.~X~------------------------------------------------------
--------------------------------------------------,-X~.~.~.~.~.~.~.~.~.~.~.~.~.~,~t<.-t<,-.~.~.~.~.~.~.~.~.~.~.~.~.~.~.~.~.~,~X-------------------------------------------------------
----------------------------------------------------,-X~.~.~.~.~.~.~.~.~.~.~.~.~,~t<t<t<,-.~.~.~.~.~.~.~.~.~.~.~.~.~,~X~X~.~X~--------------------------------------------------------
----------------------------------------------------,-X-.~.~.~.~.~.~.~.~.~.~.~.~.~.~.~.~.~.~.~.~.~.~.~.~.~.~.~.~.~,~X~--,-X-X~--------------------------------------------------------
------------------------------------------------------,-X-.~.~.~.~,~X~X~X~.~.~.~.~.~.~.~.~.~.~.~.~,~X~X~.~.~.~.~.~X~------------------------------------------------------------------
--------------------------------------------------------,-X-.~,~X~X-----,-X~X~.~.~.~.~.~.~.~.~,~X~X---,-X-X~X~.~,~X-------------------------------------------------------------------
----------------------------------------------------------,-X~X-------------,-X~X~.~.~.~.~,~X~X-------------,-X-X~--------------------------------------------------------------------
--------------------------------------------------------------------------------,-X~X~,~X~X-------------------------------------------------------------------------------------------
------------------------------------------------------------------------------------,-X~----------------------------------------------------------------------------------------------
