------------------------------------------------------------------------------------------------------------------------------------------------,-,-,-,-,-X-X-X-X-X-X-X-,-,-,-,-,-,-,-,-,-----------------------------------------------------------------------------------X-X-
--------------------------------------------------------------------------------------------------------------------------------------------,-,-,-X-X-X-X-.-.-.-.-.-.-,-XYX-X-X-X-X-X-X-X---------------------------------------------------------------------------------------
------------------------------------------------------------------------------------------------------------------------------------------,-,-X-X-,-.-,-.-.-.-E-.-.-.-,-.9.-.-E-.-.-E-.-X---------------------------------------------------------------------------------------
------------------------------------------------------------------------------------------------------------------------------------------,-X-,-,-,-.-,-.-.-.-.-.-E-.-,-.9.-.-.-.-.-.-.-X---------------------------------------------------------------------------------------
------------------------------------------------------------------------------------------------------------------------------------------,-X-.-.-,-,-,-.-.-E-.-.-.-.-,-.9.-E-.-.-E-.-.-X---------------------------------------------------------------------------------------
------------------------------------------------------------------------------------------------------------------------------------------,-X-.-.-.-X-X-X-.-.-.-.-.-.-X-XYX-,-E-,-,-,-E-X---------------------------------------------------------------------------------------
------------------------------------------------------------------------------------------------------------------------,-,-,-,-,-,-,-,-,-,-X-.-.-.-X-,-X-.-.-.-.-.-.-X-XYXY+Y+Y+Y+Y+Y+YXY,-,-----------------------------------------------------------------------------------
------------------------------------------------------------------------------------------------------------------------,-X-X-X-X-X-X-X-X-X-X-,-,-,-X-X-X-.-.-.-.-.-.-X-XY+Y+Y+Y+Y+Y+Y+YXY,-X-,-,-------------------------------------------------------------------------------
------------------------------------------,-,-,-,-,-,-,-,-,-,-,-,-,-,-,-,-,-------------------------------------,-,-,-,-,-X-:-.-E-.-E-.-.-,-.-.-.-.-.-X-,-X-.-.-.-.-E-X-XY+Y+Y+Y+Y+Y+Y+YXYX-.-X-X-,-----------------------------------------------------------------------------
------------------------------------------,-X-X-X-X-X-X-X-X-X-X-X-X-X-X-X-X-------------------------------------,-X-X-X-XTX-.-.-:-.-.-:-,-,-.-.-.-.-.-.-X-X-.-.-.-.-.-X-X-.-.-E-.-.-E-.-X-X9.-.-.-X-----------------------------------------------------------------------------
,---,-,-,-,-,-,---------------------------,-X-A-.-.-,-A-,-.-,-,-,-,-.-.-,-X-,-----------------------------------,-X-A-.-+T.-.-.-.-:-.-.-,-,-.-.-.-.-.-.-X-X-.-.-.-.-.-X-X-.-.-.-.-.-.-.-.-.9.-.-.-X-,---------------------------------------------------------------------------
X-,-,-X-X-X-X-X-,-------------------------,-X-E-.-E-,-,-,-,-.-.-.-.-.-.-,-.-X-----------------------------------,-X-.-H-+T.-.-:-.-.-.-.-,-.-.-.-.-.-.-.-X-X-.-.-.-.-.-X-X-.-.-.-.-.-.-.-.-.9.-.-.-.-X---------------------------------------------------------------------------
,-,-X-.-.-.-.-.-X-,-----------------------,-X-.-.-,-,-,-,-,-.-.-.-.-.-.-,-.-X-,---------------------------------,-X-A-.-+T.-.-.-.-E-.-.-+Z.-.-.-.-.-.-.-X-,-X-H-.-.-.-X-X-.-.-.-.-.-.-.-.-.9.-.-.-.-X---------------------------------------------------------------------------
,-X-.-.-.-.-.-.-.-X-,-,-,-,-,-,-,-,-,-,-,-,-X-E-.-E-.-.-,-.-.-.-,-,-,-,-,-.-.-X---------------------------------,-X-X-X-XTX-.-.-.-.-:-,-+Z.-.-.-.-.-.-.-.-X-X-X-.-.-.-X-X-X-.-.-.-X-X-X-X-X9.-.-.-.-X-,-------------------------------------------------------------------------
X-.-.-,-,-,-,-.-.-.-X-X-X-X-X-X-X-X-X-X-X-X-X-.-.-,-.-.-,-.-.-.-,-tL,-,-,-.-.-X-----------------------------------------,-X-A-A-:-,-,-,-+Z.-.-.-.-.-.-.-.-X-X-X-.-.-,-X-X-X-.-.-,-X-X-,-,-X-.-.-.-.-H-X-------------------------------------------------------------------------
X-.-.-,-H-.-,-.-.-.-.-.-.-.-.-.-.-.-.-.-.-.-,-E-.-E-,-,-,-,-.-.-.-.-.-.-,-.-.-X-,---------------------------------------,-X-.-.-.-.-.-,-.-.M.-.-.-.-+-.-.-.-.-,-,-,-,-,-,.,-,-,-,-,-..X.,-,-X-.-.-.-A-X-,-,-,-,-,-,-,-,-,-,-,-,-------------------------------------------------
X-.-.-,-.-.-,-.-.-.-.-.-.-.-.-.-.-.-.-.-.-.-,-.-.-.-,-,-,-,-.-.-.-.-.-.-,-.-.-.-X---------------------------------------,-X-.-.-.-.-.-,-.-.M.-.-.-.-+-.-.-.-.-,-,.,-,-....,.,-,-,-......X-X-.-.-.-,-,-.-X-X-X-X-X-X-X-X-X-X-X-X-------------------------------------------------
X-.-tLtLH-,-,-.-.-.-.-.-.-.-.-.-.-.-.-.-.-.-,-E-.-E-.-.-.-.-.-.-,-,-.-.-,-.-.-.-X-,-------------------------------------,-X-.-.-.-.-E-,-.-.M.-.-.-.-+-.-.-.-.-,-........................,-.-E-.-.-A-.-.-.-.-.-.-.-.-X-X-.-.-.->-------------------------------------------------
XLtLtLtLtLtLtLtLtLtLXLX-X-X-X-X-X-X-X-X-X-X-X-.-.-.-.-.-.-.-.-A-,-,-.-.-,-.-.-.-.-X-------------------------------------,-X-.-.-.-.-.-,-.-.M.-.-W-.-+-.-.-.-.-,-........................,-.-.-.-.-A-.-.-.-.-.-H-.-.-+-.-.-.-E->-------------------------------------------------
,-X-.-.-.-.-.-.-,-X-----------------------,-X-E-.-E-X-X-X-X-X-X-X-X-X-X-X-X-.-.-.-X-------------------------------------,-X-.-.-.-.-.-,-.-.M.-.-.-.-+-.-.-.-.-,-,.,.,.....,.,.,.,.......,-.-E-.-.-A-,-.-.-.-.-.-.-.-X-X-.-.-.->-------------------------------------------------
--,-X-.-.-.-.-,-X-------------------------,-X-.-.-.-X-,-X-X-X-X-X-X-X-X-X-X-.-.-.-X-,-----------------------------------,-X-.-.-.-.-.-X-X-.M.-.-.-.-+-.-.-.-.-,-,..4,4,.,.,.,-,-,-,...,.X-X-.-.-.-.-A-X-X-X-X-X-X-X-X-X-X-X-X-X-------------------------------------------------
----,-X-X-X-X-X---------------------------,-X-.-.-.-X-,-X-A-A-A-H-H-A-A-A-X-X-.-.-.-X-----------------------------------,-X-.-.-.-.-.-X-X-+-+-+-+-+-+-.-.-.-,-,:.-K-.-,-,.,-.-.-,-,-,.X.--,-X-.-.-.-,-X-------------------------------------------------------------------------
------------------------------------------,-X-.-.-.-X-,-X-.-E-.-E-.-E-.-E-X-X-.-.-.-X-,---------------------------------,-X-.-.-.-.-.-X-X-.-.-.-.-.-.-.-,-X-X:X-X-X-X-X-X-X-.-.-.-X-X-,-,-,-X-.-.-.-X---------------------------------------------------------------------------
--------------------------------,-,-,-,-,-,-X-.-.-.-X-,-X^+^+^+^+^+^+^+^+^X^,-X-.-.-.-X-,-,-,-,-,-,---------------------,-X-.-.-.-.-.-X-X-.-.-.-.-.-.-.-,-X-X-X-X-X-X-X-X-X-.-.-.-X-X-X-X0X0.-.-.-.-X-----------,-,-,-,---------------------------------------------------------
--------------------------------,-X-X-X-X-X-X-,-,-,-X-X-X^+^+^+^+^+^+^+^+^X^,-X-.-.-.-X-X-X-X-X-X-X-,-------------------,-X-.-.-E-.-E-X-X-.-.-.-.-.-.-.-X-X-.-.-.-.-.-.-.-.-.-.-.-.-.-.-,0.0.-.-.-.-X---------,-,-X-X-X-,-------------------------------------------------------
--------,-,-,-,-----,-,-,-,-,-,-,-X-A-.-.-.-.-.-.-.-,-A-.-A-.-.-.-.-.-.-A-X-,-X-.-.-.-,-.-,-E-,-.-,-X=------------------,-X-.-.-.-.-.-X-,-X-.-.-.-.-.-.-X-X-.-.-.-.-.-.-.-.-.-.-.-.-.-.-,0.0.-.-.-,-X---------,-X-.-.-.-X-------------------------------------------------------
--------,-X-X-X-,---,-X-X-X-X-X-X-X-.-,-,-,-,-.-.-,-,-.-.-.-.-.-.-.-.-.-A-X-,-X-.-.-.-,-.-,-.-,-,-,-X=------------------,-X-.-.-E-.-.-X-,-X-.-.-.-.-.-,-X-X-.-.-.-.-.-.-.-.-.-.-.-.-.-.-,0.0.-.-.-X---------,-,-X-.-.-.-X-,-----------------------------------------------------
--------,-X-<-X-X---,-X-.-E-.-E-H-,-.-,-.-.-,-.-.-,-.-.-.-.-.-.-.-.-.-.-A-X-,-X-.-.-.-,-.-,-.-,-E-.-X=------------------,-X-.-.-.-.-.-X-X-X\E-.-.-.-E-,-X-.-.-.-.-X-X-X-X-X-L-L-L-X-X-X-X0X0.-.-,-X---------,-X-.-.-.-.-.-X-,---------------------------------------------------
--------,-X-.-.-X---,-X-.-.-.-.-.-,-.-,-.-W-,-.-.-,-.-.-.-.-.-.-.-.-.-.-.-X---X-X-X-X-X-X-X-X-X-X-X-X=------------------,-X-E-.-.-.-.-X-E-+\,-,-,-E-,-X-X-.-.-.-.-X-X-X-X-,-,-,-,-X-X-X-X-X-,-X-X---------,-,-X-.-.-.-.-.-.-X---------------------------------------------------
--------,-X-.-.-X---,-X-.-.-.-.-.-,-.-,-,-,-,-.-.-,-.-.-.-.-.-.-.-.-.-.-.-.-X-,-,-,-,-,-,-,-,-,-,-X-X=,-,-,-,-,-,-,-,-,-,-X-.-.-.-.-.-X-X-X-X:.:K:.:X:X-X-.-.-E-X-,-X-.-H-.-.-.-.-.-H-.-X-,-X-----------,-,-X-.-.-.-.-.-.-.-X-,-------------------------------------------------
--------,-X-.-.-X-,-,-X-.-.-.-X-X-X-.-.-.-.-.-.-.-,-.-.-.-.-.-.-.-.-.-.-.-.-.-X-X-X-X-X-X-X-X-X-X-X-X=X-X-X-X-X-X-X-X-X-X-X-.-.-.-.-.-X---,-X-E-.-E-X-X-X-.-.-.-X-,-X-.-.-.-.-.-.-.-.-A-X---------------,-X-.-E-.-E-.-E-.-E-.-X-------------------------------------------------
--------,-X-.-.-X-X-X-X-.-.-.-X-XAXA.-.-.-.-.-,-,-,-,-.-.-.-.-.-.-.-.-.-.-.-.-.-.-.-.-.-.-.-.-.-.-H-X=X-.-.-.-,-,-.-.-,-.-,-.-.-.-.-.-X---,-X-.-.-.-.-.-.-.-E-.-X-,-X-.-.-.-.-.-.-.-.-.-X-,-----------,-,-X-.-.-.-.-.-.-.-.-.-X-,-----------------------------------------------
--------,-X-.-.-X-X-.-.-.-.-.-.-EA,A.-.-.-.-.-,-.-,-,-.-.-.-.-.-.-.-.-.-.-.-.-.-.-.-.-.-.-.-.-.-.-.-.-E-.-.-.-,-,-.-.-,-.-,-.-.-.-.-.-X---,-X-.-.-.-.-.-.-.-.-.-X-,-X-.-.-.-.-.-.-.-.-A-.-X---------,-,-X-.-.-.-.-.-.-.-.-.-.-.-X-----------------------------------------------
--------,-X-W-.-.-.-.-.-.-.-E-.-.A,A.-.-.-.-,-,-.-.-.-.-.-.-.-.-.-.-.-.-.-.-.-.-.-.-.-.-.-.-.-.-.-.-.-.-.-.-.-,-,-.-.-,-.-,-.-.-.-.-.-X---,-X-.-.-.-.-.-.-.-.-X-,-X-.-.-.-.-.-.-.-.-.-.-.-X-----,-,-,-.-X0.0.0.0.0.0.0.0.0.0.0.0,0X-,-,-----------------------------------------
--------,-X-.-A-.-.-.-.-.-.-.-.-.A,A.-.-.-.-,-.-.-.-.-.-.-.-.-.-.-.-.-.-.-.-.-.-.-.-.-.-.-.-.-.-.-.-.-E-.-.-.-,-,-.-.-,-.-,-.-.-.-.-.-X---,-X-.-.-.-.-.-.-.-.-X-,-X-.-.-.-.-.-E-.-.-.-.-.-X-----,-X-X-X-+-+-+-+-+-+-+-+-+-+-+-+-+-X-X-X-----------------------------------------
--------,-X-X-X-X-X-.-.-.-.-.-.-EA,A.-.-.-.-,-.-.-.-.-.-.-.-.-.-.-.-.-.-.-.-.-.-.-.-.-.-.-.-.-.-.-.-X>X-.-.-.-,-,-.-.-,-.-,-.-.-.-.-.-X---,-X-.-.-.-.-.-.-.-.-X-,-X-.-.-.-.-.-.-.-.-.-.-.-X-----,-X-E-.-E-.-E-.-E-.-E-.-E-.-E-.-E-.-E-X-----------------------------------------
--------------,-,-X-X-X-X-X-X-X-XAXA.-.-.-.-,-,-,-,-.-.-.-.-.-.-.-.-.-.-.-.-.-.-.-.-.-.-.-.-.-.-.-H-X>X-X-X-X-X-X-X-X-X-X-X-X-X-X-X-X-X-----,-X-.-.-.-.-.-.-.-X-,-X-,-,-E-,-,-,-,-,-E-,-,-X-,-,-,-X-.P.P.P.P.P.P.P.P.P.P.P.P.P.P.P.P.PX-,-,-,-,-,-,-,-,-,-,---------------------
--------------,-X-X-XkX-X-X-X-X-X-X-.-.-.-.-.-.-.-,-.-.-.-.-.-.-.-.-.-,-,-,-,-X-X-X-X-X-X-X-X-X-X-X-X>--------------------------------------,-X-.-.-.-.-.-.-X-X-X-X-.-.-.-.-.-.-.-.-.-.-.-X-X-X-X-XP,P,P,P,P,P,P,P,P,P,P,P,P,P,P,P,P,PX-X-X-,-X-X-X-X-X-X-X-,-,-,-,-------------
--------------,-X-E-+k.-.-.-.-.-E-,-.-.-.-.-.-.-.-,-.-.-.-,-,-,-,-,-,-,-----X---,-,-,-,-,-,-,-,-,-X-X>----------------------------------------,-X-A-.-.-.-A-X-X-E-.-.-.-.-.-.-.-.-.-.-.-.-E-.-.-.-.-.-.-.-.-.-.-.-.-.-.-.-.-.-.-.-E-.-.-.-X-,-X-.-.-E-.-.-.-X-X-X-X7,-----------
--------------,-X-.-+k.-.-.-.-.-.-,-.-.-.-.-.-.-.-,-.-.-,-,---------------X---,-,-X-X-X-X-X-X-X-X-X-X>----------------------------------------,-X-X-+-+-+-X-X-X-.-.-.-.-.-.-.-.-.-.-.-.-.-.-.-.-.-E-.-.-.-.-.-.-.-.-.-.-.-.-.-.-.-.-.-.-.-X-,-X-.-.-.-.-.-.-.-.-.-.7X-----,-,---
--------------,-X-E-+k.-.-.-.-.-E-,-.-.-.-.-.-.-,-,-,-,-,---------------A-X-,-,-X-A-A-.-.-,-.-,-.-,-X>------------------------------------------,-X-.-.-.-X-,-X-.-.-.-.-.-.-.-.-.-.-.-.-.-.-.-.-.-.-.-E-.-.-.-.-.-.-.-.-.-.-.-E-.-.-.-.-.-X-,-X-E-.-.-.-.-.-.-.-.-.7X-,---,-X-,-
--------------,-X-.-+k.-.-.-.-X-X-X-.-.-.-.-.-.-,-.-,-,-----------------A-X-,-X-.-.-,-.-.-,-.-,-.-,-X>------------------------------------------,-X-,-,-,-X-,-X-.-.-.-.-.-.-.-.-.-.-.-.-.-.-.-.-.-.-.-,-,-,-,-,-,-,-,-,-,-,-,-,-,-.-.-.-.-X-,-X-.-.-,-,-,-,-,-.-.-.7.-X-,-,-X-X-
--------------,-X-E-+k.-.-.-.-X-,-X-A-.-E-.-.-A-,-,-,-E---E-------------A-X-,-X-.-.-,-.-.-,-.-,-E-X-,-------------------------------------------,-X-.-.-.-X-,-X-.-.-.-.-.-.-.-.-.-.-E-.-.-.-.-.-.-.-H-,-A-,-,-,-E-,-A-,-,-,-E-,-A-.-.-.-.-X-,-X-.-,-,-.-.-.-,-,-,-.7.-X-X-X-X-X-
--------------,-X-X-XkXK.K.K.KXK,-X-X-X-X-X-X-X-X-X-X-X-X-X-X-X-X-X-X-X-X-X-,-X-.-.-,-X-X-X-X-X-X-X---------------------------------------------,-X-,-,-,-X-,-X-.-.-E-.-.-.-.-.-.-.-.-.-.-.-.-.-.-.-.-,-,-.-.-.-.-.-.-.-.-.-.-,-,-.-.-.-.-X-,-X-.-,-.-.-.-.-.-.-,-.7.-.-.-H-.-X-
--------------------,-X-.-.-.-X-,-X~X~X~X~X~X~X~X~X~X~X~X~X~X~X~X~X~X~X~X~X~X~X~.-.-.-X---------------------------------------------------------,-X-.-.-.-X-,-X-.-.-.-.-.-.-.-E-.-.-.-.-.-.-.-.-.-.-.-,-,-.-.-.-.-.-.-.-.-.-.-,-,-.-.-.-.-X-,-X-,-,-.-.-.-.-.-A-,-.7.-.-.-.-A-X-
--------------------,-X-.-.-.-X-,-X~.~.~,~.-.-.-.-,-,-,-,-,-,~.~.~.~.~.~.~.~.~,~.-.-.-X---------------------------------------------------------,-X-,-,-,-X-,-X-.-.-.-.-.-.-.-.-.-.-.-.-.-.-.-.-.-.-.-,-E-.-.-.-.-.-.-.-.-.-.-,-,-.-.-.-.-X-X-X-.-.-.-.-.-.-.-.-,-,7.-.-.-.-E-X-
--------------------,-X-.-.-.-X-,-X~.~,~,-,-,-,-,-,-,-,-,-,-.-,-.~.~.~.~.~.~,~,~.-.-.-X---------------------------------------------------------,-X-.-.-.-X-,-X-.-.-.-.-.-.-.-.-.-.-.-.-.-.-.-.-.-.-.-,-,-.-.-E-.-.-.-.-.-.-.-,-,-.-.-.-.-.-.-.-.-.-.-.-.-.-.-E-.-,2.2.-.-.-A-X-
--------------------,-X-.-.-.-X-X-X~,~,-,-,-.~.~.~.~.~.~.~.~,~,-,-,~.~.~.~,~,~.-.-.-.-X---------------------------------------------------------,-X-,-,-,-X-,-X-.-.-.-.-.-.-.-.-.-.-.-.-.-.-.-.-.-.-.-,-,-.-.-.-.-,-,-.-.-.-.-,-,-.-.-.-.-.-,-,-,-,-.-.-.-.-.-.-.-,2.2.-.-.-E-X-
--------------------,-X-.-.-.-.-E-.~.~,-,-.~.~.~.~.~.~.~.~.~.~,~.~,-.~.~,~,~,-,-.-.-.-X---------------------------------------------------------,-X-.-.-.-X-,-X-.-.-.-.-.-.-.-.-.-.-E-.-.-.-.-.-.-.-.-,-A-.-.-.-.-,-W-.-.-.-.-,-A-.-.-.-.-X-X-X-.-,-.-.-.-.-.-.-,-,2.2.-.-.-A-X-
--------------------,-X-.-.-.-.-,-,~,~,-.~.~.~,~,~.~.~.~.~.~.~,~,-.~.~,~,~,-,-,~.-.-.-X---------------------------------------------------------,-X-,-,-,-X-,-X-.-.-.-.-.-.-.-.-.-.-.-.-.-.-.-.-.-.-.-,-,-.-.-.-.-,-,-.-.-.-.-,-,-.-.-.-.-X-,-X-.-,-,-.-.-.-.-,-,-.7.-.-.-.-E-X-
----------------------,-X-.-.-.-E-.~.~.~.~.~,~.~,-.~.~.~.~.~.~.~.~.~,~,~,-,-.~,~.-.-.-X---------------------------------------------------------,-X-.-.-.-X-,-X-E-.-.-.-.-.-.-E-.-.-.-.-.-.-.-.-.-.-.-,-E-.-.-.-.-,-,-.-.-.-.-,-,-.-.-.-.-X-,-X-.-.-,-,-.-.-.-A-.7.7.-.-.-.-A-X-
------------------------,-X-X-X-X-X~.~.~.~.~,~,-.~.~.~.~.~.~.~.~.~,~,~,-,-.~.~,~.-.-.-X---------------------------------------------------------,-X-,-,-,-X-,-X-.-.-.-.-.-.-.-.-.-.-.-.-.-.-.-.-.-.-.-,-,-.-.-.-.-,-,-.-.-.-E-,-,-.-E-.-.-X-,-X-.-.-.-,-,-,-,-,7.7.7.-.-.-.-.-X-
--------------------------------,-X~.~.~.~.~,~,-,~,~,~,~,~,~,~,~,~,~,-,-.~.~.~,~.-.-,-X---------------------------------------------------------,-X-.-.-.-X-,-X-.-.-.-.-.-.-.-.-.-.-.-.-.-.-.-.-.-.-.-,-,-.-.-.-.-,-,-E-,-E-,-,-,-.-.-.-.-X-,-X-.-.-.-.-.7.7.7.-.-.7,-X-X-X-X-X-
--------------------------------,-X~.~.~.~.~X~,-,-,-,-,-,-,-,-,-,-,-,-.~.~.~.~,~.-,-X-----------------------------------------------------------,-X-,-,-,-X-,-X-.-.-.-.-.-.-.-.-.-.-.-.-.-.-.-.-.-.-.-,-,-.-.-.-.-,-,-.3.3.3.3.3,-.-.-.-E-X-,-X-.-.-.-.-.-.-.-.-.-.7X-----------
--------------------------------,-X~+~+~+~+~X~X~X~X~X~X~X~X~X~X~X~X~X~X~X~X~X~X~X-X-------------------------------------------------------------,-X-,-,-,-X-,-X-.-.-.-.-.-.-.-.-.-.-E-.-.-.-.-.-.-.-.-,-A-.-.-.-.-,-A-.3.3.3.3,3A-.-.-.-.-X-,-X-.-.-.-.-.-.-.-.-.-,7X-----------
--------------------------------,-X~,~,~.~.~X~--------------------------------------------------------------------------------------------------,-X-.-.-.-X-X-X-.-.-.-.-.-.-.-.-.-.-.-.-.-.-.-.-E-.-.-,-,-.-.-.-.-.-,-,3,3,3,3,3.-.-.-.-.-X-,-X-.-.-.-.-.-.-.-,-X-X7------------
--------------------------------,-X~,~,-.~.~X~--------------------------------------------------------------------------------------------------,-X-.-.-E-.-.-.-.-.-.-.-.-.-.-.-.-.-.-.-.-.-.-.-.-.-.-,-,-.-.-.-E-.-.-.-.-.-.-.-.-.-.-.-.-X-,-X-.-.-.-.-,-X-X-X-----------------
--------------------------------,-X~.~.~.~.~X~--------------------------------------------------------------------------------------------------,-X-E-.-.-.-.-.-.-.-.-.-.-.-.-.-.-.-.-.-.-.-.-.-.-.-E-,-,-.-.-.-.-.-.-.-.-.-.-.-.-.-.-.-.-X-,-X-.-.-.-X-X-----------------------
--------------------------------,-X~,~,~,~,~X~--------------------------------------------------------------------------------------------------,-X-.-.-.-.-,-,-,-,-,-,-,-,-,-,-,-.-.-,-,-,-,-,-,-,-H-,-E-,-,-E-,-,-,-,-,-,-,-,-,-,-,-,-,-X-,-X-E-.-E-X-------------------------
------------------------------,-,-X~.-.-.-,-X~,-------------------------------------------------------------------------------------------------,-X-X-X-X-X-X-X-.-.-.-.-.N.N.N.N,NXNXNXN.-.-.-.-.-.-,-,-,-,-.-.-.-.Q.-.-.-.-.-.-.-.-.-.-.-X-X1X6.-.-.-X-------------------------
----------------------------,-,-X~.-.-.-.-.-,-X~,-----------------------------------------------------------------------------------------------------------,-X-.-.-.-.-.N.N.N.N.NX-X-X-.-.-.-.-.-.-.-.-.-.-.-.-.-.Q.-.-.-.-.-.-.-.-.-.-.-.-.1.6.-.-.-X-------------------------
----------------------------,-X~.-.-.-.-.-.-.-,-X~----------------------------------------------------------------------------------------------------------,-X-.-.-.-.-.-.-.-.-.-.-X-X-.-.-.-.-.-.-.-.-.-.-.-.-.-.Q.-.-.-.-.-.-.-.-.-.-.-.-.1.6.-.-.-X-------------------------
----------------------------,-X~.-.-.-.-.-.-.-,-X~----------------------------------------------------------------------------------------------------------,-X-.-.-.-.-.-.-.-.-.-.-X-X-.-.-.-.-.-.-.-.-.-.-.-.-.-.Q.-.-.-.-.-.-.-.-.-.-.-.-.1.6.-.-.-X-------------------------
----------------------------,-X~.-H-.-.-.-.-.-,-X~----------------------------------------------------------------------------------------------------------,-X-.-.-.-.-.-.-.-.-.-.-X-XO.O.O.OXOX-X-X-X-X-X-X-X-X-XQ.-.-.-X-X-X-X-X-X-X-X-X-X1XW+W+W+WXW------------------------
----------------------------,-X~,-.-.-.-.-.-,-,-X~----------------------------------------------------------------------------------------------------------,-X-.-.-.-.-.-E-.-E-.-E-X-XV+V+V+VXV,-,-,-------,-X-X-X-.-.-.-X-X-X---------,-,-X-X8.8.8.8X8------------------------
------------------------------,-X~,-.-H-.-,-,-X~------------------------------------------------------------------------------------------------------------,-X-.-.-.-.-.-.-.-.-.-A-X-X-.-.-.-X-X-X-X-------,-X-A-.-.-.-.-.-H-X---------,-X-.-.8.8.8.8,8X-----------------------
--------------------------------,-X~,-,-,-,-X~--------------------------------------------------------------------------------------------------------------,-X-.-.-.-.-.-.-.-.-.-A-X-X-.-.-.-.-.-.-X-------,-X-A-.-.-.-.-.-H-X---------,-X-.-.8.8.8.8,8X-----------------------
----------------------------------,-X~X~X~X~----------------------------------------------------------------------------------------------------------------,-X-.-.-.-.-.-.-.-.-.-A-X-X-.-.-.-.-.-.-X-------,-X-A-.-.-.-.-.-H-X---------,-X-X-,7,7H7.8,8X-----------------------
------------------------------------------------------------------------------------------------------------------------------------------------------------,-X-.-.-.-.-.-.-.-.-.-H-X-X-.-.-.-.-.-E-X-------,-X-X-X-.-W-,-X-X-X-----------,-,-X8.8,8,7X7------------------------
------------------------------------------------------------------------------------------------------------------------------------------------------------,-X-.-.-X-X-X-X-X-X-X-X-X-X-.-.-.-.-.-.-X-------------,-X-X-X---------------,-,-X8.-.-.-.-,-X8----------------------
------------------------------------------------------------------------------------------------------------------------------------------------------------,-X-.-.-X-X-X-X-X-X-X-X-X-X6.6.6.6.6.6.6X6----------------------------------,-.-X8,-,-,-.-.-X8----------------------
------------------------------------------------------------------------------------------------------------------------------------------------------------,-X-.-.-.-.-H-.-.-.-.-.-H-.-.-.-.-.-.-.-X---------------------------------,-,-X8,-,-.-,-,-.-,-X8--------------------
------------------------------------------------------------------------------------------------------------------------------------------------------------,-X-.-.-.-.-.-.-.-E-.-.-.-.-.-.-.-.-.-.-X---------------------------------,-X8.-,-,-.-,-,-.-.-X8--------------------
------------------------------------------------------------------------------------------------------------------------------------------------------------,-X-.-.-.-.-.-.-.-.-.-.-.-.-.-.-.-.-.-.-X-----------------------------------,-X8.-,-,-,-.-.-X8,---------------------
------------------------------------------------------------------------------------------------------------------------------------------------------------,-X-.-.-.-.-.-.-.-.-.-.-.-.-.-.-.-.-.-.-X-------------------------------------X8.-.-.-.-.-.-X8----------------------
------------------------------------------------------------------------------------------------------------------------------------------------------------,-X-.-.-.-.-.-.-.-.-.-.-.-.-.-.-.-.-.-.-X-------------------------------------,-X8.-.-.-.-X8,-----------------------
------------------------------------------------------------------------------------------------------------------------------------------------------------,-X-.-.-.-.-.-.-.-.-.-.-.-.-.-.-.-.-.-A-X---------------------------------------,-X8X8X8X8X8------------------------
------------------------------------------------------------------------------------------------------------------------------------------------------------,-X-.-.-.-.-.-.-.-.-.-.-.-.-.-.-.-.-.-A-X---------------------------------------------------------------------------
------------------------------------------------------------------------------------------------------------------------------------------------------------,-X-.-.-.-X-X-X-X-.-.-.-X-X-X-.-.-.-.-A-X---------------------------------------------------------------------------
------------------------------------------------------------------------------------------------------------------------------------------------------------,-X-.-.-A-X-X-X-X-,-,-,-X-X-,-X-.-.-.-A-X---------------------------------------------------------------------------
------------------------------------------------------------------------------------------------------------------------------------------------------------,-X-.-.-.-X-X-.-.-E-.-E-.-.-X-X-.-.-.-A-X---------------------------------------------------------------------------
------------------------------------------------------------------------------------------------------------------------------------------------------------,-X-A-.-.-X-X-.-.-.-.-.-.-.-.-X-X-.-.-.-X---------------------------------------------------------------------------
------------------------------------------------------------------------------------------------------------------------------------------------------------,-X-.-.-.-X-X-.-.-.-H-.-.-.-.-X-X-.-.-.-X---------------------------------------------------------------------------
------------------------------------------------------------------------------------------------------------------------------------------------------------,-X-.-.-A-X-X-.-.-.-.-.-.-.-,-X-X-.-.-.-X---------------------------------------------------------------------------
------------------------------------------------------------------------------------------------------------------------------------------------------------,-X-.-.-.-X-X-E-,-E-,-,-,-,-X-.-X-.-.-.-X---------------------------------------------------------------------------
------------------------------------------------------------------------------------------------------------------------------------------------------------,-X-A-.-.-X-X-X-X-.-.-.-X-X-X-X-.-.-.-.-X-----,-,-,-,-,-,-----------------------------------------------------------
------------------------------------------------------------------------------------------------------------------------------------------------------------,-X-.-.-.-X-X-X-X-.-.-.-X-X-.-.-.-.-.-.-X-,-,-X-X-X-X-X-,-,---------------------------------------------------------
------------------------------------------------------------------------------------------------------------------------------------------------------------,-X-.-.-.-.-.-.-.-.-.-.-.-.-.-.-.-.-.-.-X-,-X-.-E-.-E-.-X-X---------------------------------------------------------
------------------------------------------------------------------------------------------------------------------------------------------------------------,-X-.-.-.-.-.-.-.-.-.-.-.-.-.-.-.-.-.-H-X-.-X-.-.-.-.-.-.-,-X-------------------------------------------------------
------------------------------------------------------------------------------------------------------------------------------------------------------------,-X-.-.-.-E-.-.-.-.-.-.-.-.-.-.-.-.-.-.-X-X-.-.-.-.-.-.-.-E-X-------------------------------------------------------
------------------------------------------------------------------------------------------------------------------------------------------------------------,-X-.-E-.-.-.-.-.-.-.-.-.-.-.-.-.-.-.-.-.-.-.-.-.-.-.-.-.-.-X-------------------------------------------------------
------------------------------------------------------------------------------------------------------------------------------------------------------------,-X-.-.-.-.-.-.-.-.-.-.-.-.-.-.-.-.-.-.-.-.-.-.-.-.-.-.-.-.-X-------------------------------------------------------
------------------------------------------------------------------------------------------------------------------------------------------------------------,-X-.-.-.-.-.-.-.-.-.-.-.-.-.-H-.-.-.-.-.-.-.-.-.-.-.-.-.-.-X-------------------------------------------------------
------------------------------------------------------------------------------------------------------------------------------------------------------------,-X-X-X-X-X-X-X-X-X-X-X-X-X-X-X-X<.-.-.-.-.-.-.-.-.-.-.-.-X-,-------------------------------------------------------
--------------------------------------------------------------------------------------------------------------------------------------------------------------------------------------,-,-X-X-.<.-.-.-.-.-.-.-.-.-,-,-X---------------------------------------------------------
------------------------------------------------------------------------------------------------------------------------------------------------------------------------------------,-,-X-.-.-.<.-.-.-.-.-,-X-X-X-X-X-----------------------------------------------------------
------------------------------------------------------------------------------------------------------------------------------------------------------------------------------------,-.-X-.-.-.-.<.-.-.-,-X---------------------------------------------------------------------
------------------------------------------------------------------------------------------------------------------------------------------------------------------------------------,-X-.-E-.-.-.-.<.-.-X-----------------------------------------------------------------------
------------------------------------------------------------------------------------------------------------------------------------------------------------------------------------,-X-.-.-.-.-.-.<.-.-X-----------------------------------------------------------------------
------------------------------------------------------------------------------------------------------------------------------------------------------------------------------------,-X-.-.-.-.-.-.-.<.-X-----------------------------------------------------------------------
------------------------------------------------------------------------------------------------------------------------------------------------------------------------------------,-X-.-E-.-.-.-.-.<,-X-----------------------------------------------------------------------
--------------------------------------------------------------------------------------------------------------------------------------------------------------------------------------X-.-.-.-.-.-.-.-X<------------------------------------------------------------------------
--------------------------------------------------------------------------------------------------------------------------------------------------------------------------------------,-X;X;.-.-.-,-,-X---------------------------------------------------------------------X-X-
----------------------------------------------------------------------------------------------------------------------------------------------------------------------------------------,-.-X;X-X-X-X-----------------------------------------------------------------------X---
