------------------------------,-X-X-X-X-X-X-X-------------------------------------------------------------------------------------------------------------------------------------------------
------------------------------,-X-.-.-.-.-.-X-------------------------------------------------------------------------------------------------------------------------------------------------
------------------------------,-X-.-.-.-.-.-X-------------------------------------------------------------------------------------------------------------------------------------------------
------------------------------,-X-.-.-.-.-.-X-------------------------------------------------------------------------------------------------------------------------------------------------
------------------------------,-X-.-.-.-.-.-X-------------------------------------------------------------------------------------------------------------------------------------------------
------------------------------,-X-.-.-.-.-.-X---------,-,-,-,-,-,-,-,-,-,-,-,-,-,-------------------------------------------------------------------------------------------------------------
------------------------------,-X-.-.-.-.-.-X-------,-,-X-X-X-X-X-X-X-X-X-X-X-X-X-,-----------------------------------------------------------------------------------------------------------
------------------------------,-X-.-.-.-.-.-X-----,-,-X-.-.-.-.-.-.-.-.-.-.-.-.-.-X-,---------------------------------------------------------------------------------------------------------
------------------------------,-X-.-.-.-.-.-X-----,-X-.-.-.-.-.-.-.-.-.-.-.-.-.-.-.-X---------------------------------------------------------------------------------------------------------
--------------------------,-,-,-X-.-.-.-.-,-X-,-,-,-X-.-.-.-.-.-.-.-.-.-.-.-.-.-.-.-X---------------------------------------------------------------------------------------------------------
--------------------------,-X-X-X-.-.-.-.-,-X-X-X-,-X-.-.-.-,-X-X-X-X-,-X-X-X-.-.-.-X---------------------------------------------------------------------------------------------------------
--------------------------,-X-H-,-.~.~.~.~E~.-.-X-,-X-.-.-.-X-X-X-X-X-,-X-X-X-.-.-.-X-,-,-,-,-,-,-,-,-,-,-,-,---------------------------------------------------------------------------------
--------------------------,-X-.-,-.~.~.~.~,~.-E-X-,-X-.-.-.-X-X-.-.-,-E-A-X-X-.-.-.-X-X-X-X-X-X-X-X-X-X-X-X-X-,-,-----------------------------------------------------------------------------
--------------------------,-X-.-,-.~.~.~.~,~.-,-X-X-X-.-.-.-X-X-X-X-X-,-X-X-X-.-.-.-.-,-,-,-,-,-,-,-,-,-,-.-.-X-X-,-----------,-,-,-,---------------------------------------------------------
--------------------------,-X-.-,-.~.~,~,~,~.-,-.-.-.-.-.-.-X-X-X-.-X-.-X-.-X-.-.-.-.-E-,-.-,-.-,-.-,-.-,-.-.-.-.-X-,-,---,-,-X-X-X-X-,-,-----------------------------------------------------
--------------------------,-X-.-,-.~,~,~.~.-.-,-.-.-.-.-.-.-<-:-X-.-X-.-X-.-X-.-.-.-.-.-,-.-A-.-,-.-A-.-,-.-.-.-.-.-X-X-,-X-X-.-.-,-.-X-X-----------------------------------------------------
--------------,-,-,-,-,-,-,-X-.-,-,~,~.-.-.-.-,-.-.-.-.-.-.-X-X-X-,-X-,-X-,-X-.-.-.-.-,-,-,-,-,-,-,-,-,-,-.-.-E-.-.-.-.-X-.-.-.-.-,-.-.-X-,---------------------------------------------------
--------------,-X-X-X-X-X-X-X-.-.-.~.-.-.-.-.-,-X-X-X-.-.-.-X-X-X-X-X-E-X-X-X-.-.-.-.-,-.-,-,-,-.-,-.-,-.-.-.-.-.-.-.-.-.-.-.-.-.-,-.-E-.-X---------------------------------------------------
--------------,-X-.-.-.-.-,-.-.-.-.-.-.-.-.-.-.-X-,-X-.-.-.-X-X-.-.-,-,-A-X-X-E-.-.-X-X-X-X-X-X-X-X-X-X-X-X-X-.-.-.-.-.-.-.-.-.-H-,-,-,-,-X---------------------------------------------------
--------------,-X-.-:-.-.-,-.-.-.-.-.-,-,-,~.-.-X-,-X-.-.-.-X-X-X-X-X-,-X-X-X-.-.-.-X-,-X-,-,-X-X-X-X-,-,---,-X-X-.-.-.-.-.-.-.-.-.-E-.-.-X---------------------------------------------------
--------------,-X-.-.-.-.-,-.-.-.-.-,-,-.~,~.-.-X-,-X-.-.-.-.-X-X-X-X-.-X-X-X-.-.-,-X-X~,~E-,-.-,-,-,-X-X-,---,-,-X-.-.-.-.-.-.-.-.-.-.-.-X---------------------------------------------------
--------------,-X-.-.-.-.-,-.-.-,-,-,~.~.~,~.-E-X-,-X-.-.-.-.-.-.-.-.-.-.-.-.-.-.-,-X~.~.~,~X-X-X-.-,-,-,-X-,-----,-X-.-.-.-.-.-.-.-.-.-.-X---------------------------------------------------
--------------,-X-.-.-.-.-,-.-.-,-.~.~.~.~,~.-.-X-,-X-.-.-.-.-.-.-.-.-.-.-.-.-.-.-,-X~.~,~,~X-X-X-X-,-,-,-,-X-------X-.-.-.-H-.-.-.-.-.-.-X---------------------------------------------------
--------------,-X-.-.-.-X-X-X-A-,-.~.~.~.~,~.-E-X---,-X-.-.-.-.-.-.-.-.-.-.-.-.-,-X-,-X~,~E~.-.-X-,-X-,-.-,-,-X-----,-X-.-.-.-.-.-.-.-.-.-X---------------------------------------------------
--------------,-X-.-.-.-X-,-X-.-,-.~.~.~.~,~.-,-X-----,-X-X-X-X-X-X-X-X-X-X-X-X-X---,-X~,~,-.-,-X---,-X-,-,-,-X-,-,-,-X-.-.-.-.-.-.-.-.-.-X---------------------------------------------------
--------------,-X-E-.-.-X---,-X-,-.~.~.~.~,~,-X-----------,-,-,-,-----,-,-,-,-,-,-,-,-,-X-X-X-X-------,-X-,-.-X-X-X-X-X-.-.-.-.-.-.-.-.-.-X---------------------------------------------------
--------------,-X-.-.-.-X-----,-X-.-.-.-.-.-X-,-,-,-,-----,-X-X-X-----,-X-X-X-X-X-X-X-X-X-X-X---------,-X-.-.-.-.-.-.-.-.-.-.-.-.-.-.-.-.-X---------------------------------------------------
--------------,-X-.-.-.-X-,-,-,-X-X-X-X-X-X-X-,-X3X3X3,-,-,-X-A-X-,-,-,-X-,-,-,-,-,-,-,-,-.-X---------,-X-,-X-X-X-X-X-X-,-,-.-.-.-,-,-,-,-X---------------,-,-,-,-,---------------------------
--------------,-X-.-.-.-X-,-X-X-X-X-X-X-X-X-X-X-X-,-X-X3X3X-X-.-X-X-X-X-X-.-X-X-X-E-X-X-X-.-X---------,-X-,-X-,-,-,-,-X-,-,-.-.-.-,-:-,-,-X---------------,-X0X-X-X---------------------------
--------------,-X-.-.-.-X-,-X-.-.-.-.-.-.-.-.-.-.-,-.3.3.3,-.-.-.-.-.-.-.-H-X-,-X-.-X-,-X-.-X---------,-X-.-X-X-X-X-X-X-,-,-.-.-.-,-,-H-.-X-,-,-,-,-,-,-,-,-X0.-.-X---------------------------
--------------,-X-.-.-.-X-,-X-.-.-.-.-.-.-.-:-.-.-,-.3,3X3X-X-.-X-X-X-X-X-.-X-,-X-,-X-,-X-.-X---------,-X-.-,-.-.-.-.-.-,-,-.-.-.-,-,-.-.-X-X-X-X-X-X-X-X-X0X0.-.-X---------------------------
--------------,-X-.-.-.-X-,-X-.-.-.-.-.-.-.-.-.-.-,-,3X3,-,-X-A-X-,-,-,-X-E-X-,-X-,-X-,-X-<-X-,-,-,-,-,-X-X-X-.-.-.-.-.-,-,-.-.-.-,-,-H-.-.-.-.-,-.-.-.-.-.0.-.-.-X---------------------------
--------------,-X-.-.-.-X-,-X-H-.-.-X-X-X-X-X-X-X-X-X3X-X-X-X-,-X-X-X-X-X-X-X-,-X-.-X-,-X-,-X-X-X-X-X-X~X~X~X~.-.-.-.-.-,-,-.-.-.-,-,-.-.-.-.-.-,-.-.-.-.-.0<-.-.-X---------------------------
,-,-,-,-,-,-,-,-X-.-.-.-X-,-X-.-.-.-X-----------,-,-X-.-.-.-.-.-.-.-.-.-X-,---,-X-.-X-,-X-,-A-,-.-A-,-.~.~.~,~.-.-.-.-.-,-,-.-.-.-,-,-A-.-.-.-.-,-.-.-.-.-.0.-.-.-X---------------------------
X-X-X-X-X-X-X-X-X-.-.-.-X-X-X-.-A-.-X-------,-,-,-X-.-.-.-.-.-.-.-.-.-.-.-X-,-,-X-,-X-,-X-X-X-X-X-,-,-.~.~.~,~.-H-.-H-.-,-,-.-.-.-,-:-.-.-X-X-X-X-X-X-X-X-X0.-.-:-X---------------------------
X-<-.-.-.-.-.-.-.-.-.-.-.-,-,-.-.-.-X-------,-X-X-.-.-.-.-.-.-.-.-.-.-.-.-.-X-,-X-.-X-,-,-----,-X~.~.~.~X~X~X~X-X-X-X-X-,-,-.-.-.-,-,-.-.-X-----------,-,-X-.-.-.-X-,-------------------------
X-X-X-X-X-X-X-.-.-.-.-.-.-,-X-A-.-A-X-------,-X-,-.-.-.-.-.-.-.-.-.-.-.-.-.-X-X-X-,-X-X-X-----,-X~.~.~.~X~X~X~,-X~X-,-X-X-X-.-.-.-,-X-X-X-X-----------,-X-X-.-.-.-X-X-------------------------
,-,-,-,-,-,-X-.-.-.-.-.-.-,-X-X-X-X-X-------,-X-,-.-.-.-.-H-.-.-.-.-.-.-.-.-E-.-.-.-.-,-X-------,-X~.~.~.~.~X~,-X~.~X~X~X~X-.-.-E-.-X-A-------,-,-,-,-,-X-.-.-.-.-.-X-,-,-,-,-----------------
X-X-X-X-X-X-X-.-.-.-.-.-.-,-X-X-X-,-,-,-,-,-,-X-X-.-.-.-.-.-.-.-.-.-.-.-.-.-.-.-.-.-,-,-X-,-------,-X~.~.~.~X~,-X~X~X~.~X~X-.-.-.-.-X---------,-X-X-X-X-X-.-.-.-.-.-X-X-X-X-X-----------------
X-<-.-.-.-.-.-.-.-.-.-.-.-,-.-,-.-X-X-X-X-X-X-X-X-.-.-.-.-,-,-,-,-.-.-.-.-.-.-.-.-,-,-.-.-X-,-,-,-,-X~.~.~.~X~X~X~X~X~.~X~X-.-.-.-.-X-,-,-,-,-,-X-E-.-.-.-.-.-.-.-.-.-.-.-.-X-----------------
X-X-X-X-X-X-X-.-.-.-.-.-:-,-.-,-.-,-.-,-.-,-.-.-.-.-.-.-.-,-.-.-,-.-.-.-.-.-.-.-.-,-.-.-.-.-X-,-X~X~X~.~.~.~.~.~.~.~.~.~X~X-.-.-.-.-X-,-X-X-X-X-X-.-.-.-.-.-.-.-.-.-.-.-.-.-X-----------------
,-,-,-,-,-,-X-.-.-.-.-.-.-,-.-A-.-,-.-,-.-A-.-.-.-.-.-.-.-,-.-W-,-.-.-.-.-.-E-.-.-,-.-.-.-.-X-,-X~.~.~.~.~.~.~.~.~.~.~.~X~X-,-,-,-,-X-,-X-,-.-,-.-.-.-.-.-.-.-.-.-.-.-.-.-.-X-----------------
X-X-X-X-X-X-X-.-.-.-.-.-.-,-.-,-.-,-.-,-.-,-.-.-.-.-.-.-.-E-,-,-,-.-.-.-.-.-.-.-.-,-,-.-.-,-X-,-X~.~.~.~.~.~.~.~.~.~.~.~X~X-X-,-,-X-X-,-X-,-.-,-.-.-.-.-.-.-.-.-.-.-.-.-.-,-X-----------------
X-<-H-.-.-.-.-.-.-.-.-.-.-,-,-,-,-,-X-X-X-X-X-X-X-.-.-.-.-.-.-.-.-.-.-.-.-.-.-.-.-.-,-,-,-X-,-,-X~.~.~X~X~X~X~.~.~X~X~X~X~,-X-.-.-.-X-,-X-,-.-,-.-.-.-.-.-.-,-,-,-,-,-.-,-X-------------------
X-X-X-X-X-X-X-.-.-.-.-.-.-,-X-X-X-X-X-------,-X-X-.-.-.-.-.-.-.-.-.-.-.-.-E-.-.-.-.-.-,-X-X-X-X-X~.~.~X~X~X~X~.~.~X~------,-X-.-.-.-X-,-X-X-X-X-X-.-.-.-E-,-,-.-.-.-,-.-X---------------------
,-,-,-,-,-,-X-.-.-.-.-.-.-,-X-A-.-A-X-------,-X-,-.-.-.-.-H-.-.-.-.-.-.-.-.-.-,-,-,-,-.-X-X-.-,-.~.~.~X~X~E~,~,~,~X~,-----,-X-.-.-.-X-X-X-X-X-X-X-.-.-.-.-,-,-.-,-,-,-.-X---------------------
X-X-X-X-X-X-X-.-.-.-.-.-.-,-,-.-A-A-X-------,-X-X-.-.-.-.-.-.-.-E-.-.-.-.-.-X-X-X-.-X-X-X-X-X-X-X~X~X~X~X~X~X-.-.-X-X-----,-X-.-.-E-.-,-.-,-.-.-,-.-.-.-.-,-,-.-,-.-,-.-X---------------------
X-<-.-.-.-.-.-.-.-.-.-.-.-E-X-.-.-.-X---------,-X-.-.-.-.-.-.-.-.-.-.-.-.-,-X-,-X-,-X-,-,-,-,-,-,-,-,-,-,-,-X-.-H-.-X-----,-X-.-.-.-.-,-.-,-.-.-,-.-.-.-.-,-,-.-,-.-,-.-X---------------------
X-X-X-X-X-X-X-X-X-.-.-.-X-X-X-X-.-X-X-----------,-X-.-.-.-.-.-.-.-.-.-.-,-X---,-X-.-X-,-X-X-X-X-X-X-X-X-X-,-X-H-E-H-X-----,-X-.-.-.-.-,-.-,-.-.-,-.-.-.-.-,-,-.-,-,-,-.-X---------------------
----------,-X-.-.-.-.-.-.-X-X-K-.-.-X-------------,-X-.-.-,-,-,-,-.-.-,-X-----,-X-,-X-,-X-E-.-.-.-.-.-.-X-,-X-.-H-.-X-----,-X-X-+-X-X-X-X-X-X-X-X-.-.-.-.-.-,-.-.-.-,-.-X---------------------
----------,-X-.-.-.-.-.-.-X-X-.-.-.-X---------------,-X-X-X-X~.~X~X-X-X-------,-X-.-X-,-X-X-X-.-.-.-.-.-X-,-X-X-X-X-X-----,-X-X-.-X-X-,-X-X-X-X-X-.-.-.-.-.-,-,-,-,-,-.-X-,-------------------
----------,-X-.-.-.-.-:-.-X-X-.-.-.-X-,-,-,-,-------------,-X~A~X~------------,-X-,-X-----,-X-.-.-.-.-.-X-----------------,-X-.-.-.-X-,-X-E-.-,-.-.-.-.-.-.-.-.-.-.-.-.-.-X-,-----------------
----------,-X-.-.-.-.-.-.-X-X-.-.-.-X-X-X-X-X-,-,-,-,-,-,-,-X~.~X~------------,-X-.-X-----,-X-.-X-X-X-.-X-----------------,-X-.-E-.-X-,-X-,-.-,-.-.-.-.-.-.-E-.-.-.-.-.-.-.-X-----------------
----------,-X-.-.-.-.-.-.-X-X-:-.-.-,-,-,-,-,-X-X-,-X5X5X5,-X~H~X~,-,-,-,-,-,-,-X-.-X-,-,-,-X-.-X-,-X-.-X-----------,-,-,-,-X-,-,-,-X-,-X-E-.-,-.-E-.-.-.-.-.-.-.-.-.-.-.-.-X-----------------
----------,-X-.-.-.-.-.-.-X-X-.-.-.-X-X-X-X-X-.-.-X-X-.-X-X~X~.~X~,-X-X-X-X-X-X-X-E-X-X-X-X-X-.-X-,-X-H-X-,-,-,-,-,-,-X-X-X-X-.-.-.-X-,-X-X-X-X-X-.-.-.-.-.-.-.-.-.-.-.-.-.-X-----------------
----------,-X-.-.-.-.-.-.-X-X-X-X-X-X-----,-X-.-.-.-.-.-,-.~.~.~X~,-X-.-.-,-.-.-.-.-.-.-.-,-.-.-X-,-X-.-X-,-X~X~X~X~X~X-,-.-.-.-.-.-X---------,-X-.-.-.-.-.-.-.-.-.-.-.-.-.-X-----------------
----------,-X-.-.-.-.-.-.-X-------------,-,-X-.-.-.-,-,-X-X~X~X~X~,-X-.-.-,-X-X-X-X-X-X-X-X-X-.-X-,-X-X-X-X~.~.~.~.~,~X-,-.-.-.-.-.-X---------,-X-X-X-X-X-.-.-.-.-.-X-X-X-X-X-----------------
----------,-X-.-.-.-.-.-.-X-------------,-X-.-.-.-.-X-X-----------,-X-.-.-.-X-,-X-X-X-X-X-X-X-.-X-,-,-,-,-X~.~.~.~.~,~,~,-,-.-.-.-.-X-,-,-,-,---------,-X-.-.-.-.-.-X-,-,-,-,-----------------
----------,-X-.-.-.-.-.-.-X-------------,-X-.-.-.-.-X-,-,-,-------,-X-.-.-.-X-,-X-.-.-.-.-.-.-.-X-,-X-,-X-.~.~.~.~.~.~,~X-X-X-X-X-,-X-X-X-X-X---------,-X-X-.-.-X-X-X-,-X-X-X-,---------------
----------,-X-X-X-.-.-.-X-X-,-----------,-X-.-.-.-.-.-X-X-X-,-----,-X-.-.-.-X-,-X-<-.-.-.-.-.-,-X-X-.-X-,-.~.~.~.~.~.~.~X~----,-X-.-E-.-.-.-X-----------,-X-L-L-X-,-,-X-.-.-.-X-----,-,-------
--------------,-X-.-.-.-X-X-X-----------,-X-.-.-.-.-.-.-.-.-X-,---,-X-.-.-.-X-,-X-.-.-.-.-.-X-X-X-.-.-.-,-.~.~.~.~.~.~.~X~----,-X-.-.-.-.-.-X-----------,-X-.-.-X-X-X-.-.-.-.-X---,-,-X-,-,---
----------,-,-,-X-.-.-.-.-,-X-,-,---------,-X-.-.-.-.-.-.-.-.-X---,-X-E-.-.-X-,-X-.-.-.-.-.-X-,-X-.-.-.-,-.~.~.~.~.~.~.~X~----,-X-.-.-.-.-.-X-,-,-,-,---,-X-.-.-E-.-.-.-E-.-.-X-,-,-X-.-X-X-,-
----------,-X-X-X-.-.-.-.-,-X-X-X-----------,-X-X-X-.-.-.-.-.-X-,-,-X-.-.-.-X-,-X-.-.-.-.-.-X-X-.-.-.-.-X-.~.~.~.~.~.~,~X~----,-X-.-.-E-.-.-X-X-X-X-X-----,-X-.-.-.-.-.-.-.-.-X-X-X-.-.->->->-
------,-,-,-X-,-.-.-.-.-.-.-,-,-X-,-,-,-,---------,-X-.-.-.-.-.-X-,-X-.-.-.-X-,-X-A-.-.-.-.-X-X-.-.-.-,-X-X~.~.~.~.~.~X~------,-X-.-.-.-.-.-,-E-.-,-X-,-,-,-X-X-X-.-.-E-.-E-.-.-+-.-.-.->-.-X-
------,-X-X-X-.-A-.-.-.-.-H-.-,-X-X-X-X-X-----------,-X-.-.-.-.-X-,-X-X-X-.-X-,-X-X-X-X-X-X-X-X-.-.-.-X-,-,-X~.~.~.~,~X~,-,-,-,-X-X-X-X-X-,-,-.-.-,-X-X-X-X-X-,-X-.-.-.-.-.-.-X-X-X-.-.->->->-
------,-X-.-,-.-.-.-.-.-.-.-.-.-.-E-.-.-X-----------,-X-.-.-.-,-X-----,-X-.-X---------------,-X-.-.-.-X-,-X-,~,~,~X~X-X-X-X-X-X-X-X-X-X-X-E-.-.-.-,-.-.-.-.-X-,-X-E-.-.-.-.-.-X---,-X-,-X-X---
------,-X-E-,-.-.-.-.-.-.-.-.-.-.-.-.-.-X-------------,-X-.-.-,-X5,---,-X-.-X---------------,-X-.-.-.-X-,-X-W-X-X-X-X-.-A-.-H-.-.-.-.-X-X-.-.-.-.-,-.-E-.-.-X-,-X-.-.-.-E-.-.-X-----,-X-------
------,-X-.-,-.-.-.-.-.-.-.-.-.-.-.-.-.-X-------------,-X-X-.-,-.5X5,-,-X-.-X-,-,---------,-,-X-.-.-.-X---X-X-,-X-.-.-X-X-X-X-.-.-.-.-X-X-.-.-,-,-,-.-.-.-.-X-,-X-.-E-.-.-.-.-X---------------
------,-X-.-,-.-.-.-.-.-.-.-E-.-.-E-.-.-X-------------,-,-,-X-,-.5.5X5X-X-.-X-X-X-------,-,-X-X-.-.-.-X-X-,---,-X-.-.-X-X-.-X-.-.-.-.-X-X-X-X-X-X-.-.-.-.-.-X-,-X-.-.-.-.-.-,-X---------------
------,-X-.-,-.-.-.-.-.-.-.-.-.-.-.-.-.-X-------------,-X-X-X-X-.5.5.5.-.-.-.-A-X-----,-,-X-.-.-.-.-.-.-.-X-,-,-X-.-.-X-X-X-X-.-.-.-.-X-,-,-,-,-X-.-.-.-.-.-X-,-,-X-.-.-.-.-X-----------------
------,-X-.-,-.-.-.-.-.-.-.-.-.-.-.-X-X-X-------------,-X-E-X-,-X5X5X5X-X-X-X-X-X-,-,-,-X-.-.-.-.-.-.-.-.-,-X-X-X-.-.-.-.-.-.-.-.-.-.-X-,-X-X-X-X-X-X-,-,-,-X-X-X-,-X-X-X-X-X-----------------
------,-X-E-,-.-.-.-.-.-.-.-.-.-.-.-X-,-,-,-,-,-,-,-,-,-X-.-X-,-X-X-X-,-X-X-X-,-X-X-X-,-X-.-.-.-.-.-.-.-.-,-.-X-X-.-.-.-.-X-X-X-X-.-.-X-X-.-.-.-.-X-X-.-.-.-.-.-X-----------------------------
------,-X-.-,-.-.-.-.-.-.-.-.-.-.-.-X-X-X-X-X-X-X-X-X-X-X-.-X-X-X-.-X-X-X-.-X-X-X-.-X-X-X-.-.-.-.-.-.-.-.-,-.-.-,-.-.-.-.-X-.-X-X-.-.-.-E-E-.-.-.-.-.-X-X-X-X-.-X-----------------------------
------,-X-.-,-.-.-.-.-.-.-.-.-.-.-.-.-.-.-E-.-.-.-.-.-.-.-.-.-.-.-.-.-.-.-.-.-.-.-.-.-.-.-.-.-.-.-.-.-.-.-,-.-.-,-.-.-.-.-X-X-X-X-.-.-.-.-.-.-.-.-.-.-X-X-.-X-.-X-----------------------------
------,-X-.-,-.-.-.-.-.-.-.-.-.-.-.-.-.-.-.-.-.-.-.-.-.-.-.-.-.-.-.-.-.-.-.-.-.-.-.-.-.-.-.-E-.-.-.-.-.-.-,-.-X-X-.-.-.-.-.-.-.-.-.-.-.-.-.-.-.-.-.-.-X-X-X-X-.-X-----------------------------
------,-X-.-,-.-.-.-.-.-.-.-.-,-,-.-.-.-.-.-.-.-.-.-.-.-.-.-.-.-.-.-.-.-.-.-.-.-.-.-.-.-.-.-.-.-.-.-.-.-.-,-.-X-X-.-.-.-.-.-.-X-X-X-X-X-X-X-X-X-X-X-X-.-.-.-.-.-X-----------------------------
------,-X-X-X-,-A-.-.-.-.-A-,-,-X-X-X-X-X-X-X-X-X-X-X-X-X-.-X-X-X-.-X-X-X-.-X-X-X-.-X-X-X-.-.-.-.-.-.-.-.-,-X-X-X-.-.-.-.-.-.-X-X-.-X-X-----------,-X-X-X-X-X-X-X-----------------------------
----------,-X-,-,-.-.-.-.-,-,-.-X---------------------,-X-X-X-,-X-X-X-,-X-X-X-X-.-.-X-,-X-.-.-.-.-.-.-.-,-X---,-X-.-.-.-.-.-.-X-X-X-X-X-------------------------------------------------------
----------,-X-X-X-.-.-.-.-,-X-X-X-------------------------------------,-,-X-X-.-.-.-X---,-X-X-.-.-.-.-,-X-------,-X-.-H-.-.-.-.-.-.-A-X-------------------------------------------------------
--------------,-X-.-.-.-.-.-X---------------------------------------,-,-X-.-<-.-.-,-X-------,-X-X-X-X-X-,-,-,-,-,-,-X-X-X-X-X-X-X-X-X-X-,-,-,-,-,-,-,-,-,-,-,-,-,-----------------------------
--------------,-X-X-X-X-X-X-X---------------------------------------,-X-.-.-.-,-X-X---------------------,-X-X-X-X-X-X-X-X-X-X-X-X-X-X-X-X-X-X-X-X-,-X-X-X-X-X-X-X-,---------------------------
--------------------------------------------------------------------,-X-.-.-.-X-----------------------,-,-X-.-.-.-.-.-.-.-E-.-.-,-E-.-.-,-.-.-.-X-,-X-H-.-.-.-.-.-X-,-------------------------
--------------------------------------------------------------------,-X-.-.-.-X-----------------------,-X-.-.-.-.-.-.-.-.-.-.-.-,-.-.-.-,-.-.-.-X-,-X-.-.-.-H-.-.-.-X-,-----------------------
------------------------------------------------------,-,-,-,-,-,-,-,-X-.-.-.-X-,-,-,-,-,-,-,---------,-X-.-.-.-.-.-.-.-.-.-.-.-,-.-.-.-,-.-.-.-X-,-X-.-.-.-.-.-.-.-.-X-,---------------------
------------------------------------------------------,-X~X~X-X-X-X-X-X-.-.-.-X-X-X-X-X-X-X~X~--------,-X-.-.-.-X-X-X-.-.-.-.-.-,-.-.-.-,-.-.-.-X-,-X-.-.-.-.-.-.-.-H-.-X---------------------
------------------------------------------------------,-X~.~,~.-.-.-.-.-.-.-.-.-.-.-.-,-.~.~X~--------,-X-.-.-.-X-,-X-.-.-.-.-.-,-.-.-E-,-.-.-.-X-,-X-.-.-.-H-.-.-.-.-.-X---------------------
------------------------------------------------------,-X~.~,~,~.-.-:-.-.-.-.-.-.-.-,-,~.~.~X~,-,-,-,-,-X-.-.-X-X-,-X-X-X-X-X-X-X-X-X-X-X-.-.-.-X-X-X-.-.-.-.-.-.-.-.-,-X---------------------
------------------------------------------------------,-X~.~.~,~,-.-.-.-.-.-.-.-.-,-,-.~.~.~X~,-X~X~,-,-X-.-.-X-,-X~X-,-,-------------,-X-.-.-.-.-.-.-.-.-.-W-.-.-A-.-X-----------------------
------------------------------------------------------,-X~.~.~.~,~.-.-.-.-.-:-.-.-,-.~.~.~.~X~.-X~.~X~X~X~E-,-X-X~.~.~X~X~,-,---------,-X-.-.-.-.-.-.-.-.-.-.-.-.-.-.-X-----------------------
------------------------------------------------------,-X~.~.~.~,~,~,-,-,-,-,-,-,-,~.~.~.~.~X~X~.~E~.~.~,~.-.-,-.~.~E~.~.~X~X~,-------,-X-.-.-.-.-.-.-.-H-.-.-H-.-.-.-X-----------------------
------------------------------------------------------,-X~.~.~.~.~,~.-,-,-,-,-.-,-.~.~.~.~,~X~X~.~.~.~.~,~.-.-,-.~.~.~.~.~.~.~X~------,-X-X-X-.-.-.-.-.-.-.-.-.-A-.-.-X-----------------------
------------------------------------------------------,-X~.~.~.~.~,~.-,-,-,-,-.-,-.~.~.~.~,~X~.~.~.~.~E~,~.-.-,-E~.~.~.~.~.~.~X~--------,-X-.-.-.-.-.-.-H-.-.-.-.-.-,-X-----------------------
------------------------------------------------------,-X~.~.~.~.~,~.-,-.-.-,-.-,-.~.~.~.~.~X~.~.~.~.~.~,~.-.-,-.~.~.~.~.~E~.~X~------,-,-X-.-.-.-.-.-.-.-.-.-.-.-.-X-------------------------
------------------------------------------------------,-X~.~.~.~.~,~.-,-.-.-,-.-,-.~.~.~.~.~X~X~.~.~.~.~,~.-.-,-.~.~.~.~.~.~.~X~----,-,-X-.-.-.-.-.-.-.-.-.-.-.-.-.-X-------------------------
------------------------------------------------------,-X~.~.~.~.~,~.-,-E-.-E-.-,-.~.~.~.~.~X~X~.~.~.~.~,~.-.-,-.~.~.~.~.~.~.~X~,-,-,-X-.-.-.-.-X-X-.-.-.-.-.-.-,-X-X-------------------------
------------------------------------------------------,-X~.~E~.~.~,~.-,-.-E-,-.-,-.~.~E~.~.~X~X~.~.~.~.~,~.-.-,-.~.~.~.~.~.~,~X~,-X-X-.-.-.-.-X-,-,-X-X-.-,-X-X-X-----------------------------
------------------------------------------------------,-X~.~.~.~.~,~.-,-,-,-,-.-,-.~.~.~.~,~X~X~E~.~.~.~,~.-.-,-.~.~.~.~.~,~,~X-X-.-.-.-.-.-,-X-------,-X-X-----------------------------------
------------------------------------------------------,-X~,~,~,~,~,~.-,-,-,-,-.-,-,~,~,~,~,~X~X~.~.~.~.~,~.-.-,-.~.~.~.~.~,~.-,-.-.-.-.-.-,-X-------------------------------------------------
------------------------------------------------------,-X-.-.-.-.-,-,-,-,-,-,-,-,-.-.-.-.-,-X~.~.~.~.~.~,~.-.-,-.~.~.~.~.~,~,-,-.-.-.-,-X-X---------------------------------------------------
------------------------------------------------------,-X-.-.-.-.-.-.-.-.-.-.-.-.-.-.-.-.-,-X~.~.~.~.~.~,~.-.-,-.~.~.~.~.~,~,-.-,-X-X-X-------------------------------------------------------
------------------------------------------------------,-X-.-.-.-.-.-.-.-.-.-.-.-.-.-.-.-.-,-X~.~.~.~.~.~,~.-.-,-.~.~.~.~.~.~,~X-X-------------------------------------------------------------
------------------------------------------------------,-X-.-,-,-,-,-,-.-.-.-.-,-,-,-,-,-.-.-X-X~.~.~.~.~,~.-.-,-.~.~.~.~.~.~X~,---------------------------------------------------------------
------------------------------------------------------,-X-X-X-X-.-.-X-X-X-X-X-X-X-.-.-X-X-X-X-,-X~.~.~.~,~.-.-,-.~.~.~.~.~.~.~X---------------------------------------------------------------
------------------------------------------------------------,-X-.-.-X-,-,-,-,-,-X-.-.-X-,-,-,---,-X~X~.~,~,-,-,-.~.~.~.~.~.~,~X~--------------------------------------------------------------
------------------------------------------------------------,-X-.-.-X-X-X-X-X-X-X-.-.-X-X-X-X-,-,-,-,-X~X~.-.-X-X~X~X~.~.~,~X~----------------------------------------------------------------
------------------------------------------------------------,-X-.-.-.-.-.-.-.-.-.-.-.-.-.-.-X-X-X-X-X-X-X-.-.-X-----,-X~X~X~------------------------------------------------------------------
------------------------------------------------------------,-X-.-.-.-.-.-.-.-.-.-.-.-.-.-.-.-.-.-.-.-.-.-E-.-X-------------------------------------------------------------------------------
--------------------------------------------------------------,-X-.-.-.-.-.-.-.-.-.-.-.-.-.-.-.-.-.-E-.-.-.-.-X-------------------------------------------------------------------------------
----------------------------------------------------------------,-X-X-.-.-.-.-.-.-.-.-.-.-.-.-.-.-.-.-.-.-.-.-X-------------------------------------------------------------------------------
--------------------------------------------------------------------,-X-.-.-.-.-.-.-.-.-.-.-X-X-X-X-X-X-X-X-X-X-------------------------------------------------------------------------------
----------------------------------------------------------------------,-X-X-X-X-X-X-X-X-X-X-X-------------------------------------------------------------------------------------------------
