----------------------------------------------------------------------,-,-,-X-X-X-,-------------------------------------------------------,-,-,-X~X~X~X~X~X~X~X~X~,-,---------------------------
--------------------------------------------------------------------,-,-X-X-,-,-,-X/,-,-------------------------------------------------,-,-X-X~.~.~.~.~.~.~.~.~.~X~X~,-,-----------------------
------------------------------------------------------------------,-,-X-,-,-,-,-,-./X-X-,-----,-,-------------------------------------,-,-X~.~.~.~.~.~.~.~.~.~.~.~.~.~X~X~,---------------------
------------------------------------------------------------------,-X-,-,-,-,-,-,-./.-,-X-,-,-,-X-,-----------------------------------,-X~.~.~.~.~,~,~,~,~,~,~,~,~.~.~.~.~X---------------------
----------------------------------------------------------------,-,-X-,-.-,-,-,-,-./,-+-+RXR,-X-.-X-,-,-----------------------------,-,-X~.~.~,~,~,~.~.-.-.-.-.~,~,~,~.~.~X~,-------------------
--------------------------------------------------------------,-,-X-,-,-,-,-X-X-X-X/+-+R+R,/X/.-.-,-X-X-,---------------------------,-X~.~,~,~,~.-.-.-.-.-.-.-.-.-.-,-,~.~.~X~------------------
--------------------------------------------------------------,-X-,-,-,-,-X-----,-X-+R+R,/,/.-.-.-.-,-,-X-,-------------------------,-X~.~,~.-.-.-A-.-.-.-.-.-.-.-.-.-,~.~.~X~------------------
------------------------------------------------------------,-,-X-,-,-,-X-------,-,-XR,/,/:-.-.-E-.-.-,-,-X-,-------------------,-,-,-X~,~,~.-.-.-.-.-X-X-.-.-.-E-.-.-,-,~.~X~,-----------------
------------------------------------------------------------,-X-,-,-,-,-X-----,-,-X-,-X/.-.-.-.-.-.-.-.-,-X-X-----------------,-,-X~X~X~X~.~.-H-.-.-X-.-X-.-.-.-.-.-.-.-,-.~.~X-----------------
------------------------------------------------------------,-X-,-,-,-X-----,-,-X-,-X-.-.-.-.-X-.-.-.-.-.-.-X-,-,-,-----------,-X~X~.~,~X~X-.-.-.-E-X-X-X-.-W-.-.-.-.-.-,-.~.~X-----------------
------------------------------------------------------------,-X-,-,-,-X---,-,-X-,-,-.-.-.-.-X-.-X-.-.-.-.-.-.-X-,-X-,-------------,-X~X~,-X-.-.-.-.-.-.-.-.-.-.-.-.-.-.-,-.~.~X~----------------
------------------------------------------------------------,-X-,-,-,-X---,-X-,-,-.-A-.-.-X-.-.-.-X-.-.-E-.-.-,-X-.-X-,---------------,-,-X-<-.-:-.-.-.-.-.-A-.-X-X-.-.-,-.~.~X~----------------
------------------------------------------------------------,-X-,-,-,-X-,-,-,-X-.-.-.-.-.-X-.-.-X-.-.-.-.-.-.-.-,-,-.-X-,-----------,-,-X/.-.-.-.-.-.-.-.-.-.-X-.-X-.-.-,-.~.~X~----------------
------------------------------------------------------------,-X-,-.-.-X-,-X-X-.-.-.-.-.-X-.-.-.-X-.-.-X-.-.-.-.-.-,-,-,-X---------,-,-XP+P./.-.-.-.-.-.-.-.-E-X-X-X-H-.-,-.~.~X~----------------
------------------------------------------------------------,-X-.-.-.-X-X-.-A-.-.-.-.-X-.-.-.-X-.-.-X-.-X-.-.-.-.-.-,-X-,-------,-,-XP+P+P+P./,-X-X-.-.-.-.-.-.-.-.-.-.-,-.~.~X~----------------
------------------------------------------------------------,-X-.-A-.-X-,-X-.-.-E-.-.-.-X-.-X-.-A-.-X-.-.-X-.-.-E-.-.-.-X-,---,-,-XP+P+P+P+P+PX/,-,-X-.-E-.-.-.-.-.-,-,-,-.~,~X-----------------
------------------------------------------------------------,-X-.-.-.-.-X-,-X-.-.-.-.-.-.-X-.-X-.-.-.-X-.-.-X-B-.-.-.-.-.-X-,-,-XP+P+P+P+P+PXP----,-,-X-.-.-.-,-,-,-,~.~.~.~X~------------------
--------------------------------------------------------------,-X-.-.-.-X---,-X-.-.-.-.-.-.-X-.-X-.-H-.-X-.-.-X-.-.-.-.-.-.-X-XP+P+P+P+P+PXP--,-,-,-X~X-,-,-,-,~.~.~.~.~.~,~X~------------------
--------------------------------------------------------------,-X-.-.-.-X-----,-X-.-.-.-.-.-.-X-.-X-.-.-.-X-.-.-X-.-.-.-.-.-,-X/+P+P+P+PXP----,-X~X~.~X~.~.~.~.~.~.~.~.~,~X~--------------------
--------------------------------------------------------------,-X-.-A-.-X-------,-X-B-.-.-.-.-.-X-.-X-.-K-.-X-.-.-X-.-.-.-.-.-,-./+P+PXP------,-X~.~X~X~.~.~.~.~.~.~,~X~X~----------------------
--------------------------------------------------------------,-X-.-.-.-X---------,-X-.-.-.-.-.-.-X-.-X-.-.-.-X-.-X-.-.-.-.-.-:-,-X/XP--------,-X~.~X~,-X~X~X~X~X~X-X---------------------------
----------------------------------------------------------------,-X-.-.-X-------,-,-X-X-.-.-.-.-X-.-.-.-X-.-H-.-X-.-.-.-.-.-.-.-.-.-X-,---,-,-,-X~.~X~------------------------------------------
------------------------------------------------,-,-,-,-,-,-,-,-,-X-.-.-X-------,-X-.-.-.-.-.-X-.-.-.-X-.-X-.-.-.-.-.-.-X-.-.-.-.-.-.-X-,-,-X~X~.~,~X~,-,-,-,-----------------------------------
------------------------------------------------,-X-X-X-X-X-X-X-X-X-.-A-X---------,-X-.-.-.-.-.-X-.-X-A-X-.-X-.-.-.-.-X-.-X-.-.-E-.-.-A-X-,-X~.~.~,~X-X-X-X-X-----------------------------------
------------------------------------------------,-X-.-.-.-.-.-.-.-.-<-.-X---------,-,-X-.-E-.-.-.-X-.-.-.-X-.-X-.-X-X-.-X-.-.-.-.-.-,-X---,-X~,~,~,~.-.-.-.-X-----------------------------------
------------------------------------------------,-X-.-E-H-.-.-.-.-.-.-.-X-------,-,-X-.-.-.-E-.-B-.-.-.-.-.-X-.-X-.-.-X-.-.-.-.-,-,-X-,-,-,-X~,~.-.-.-.-H-.-X-----------------------------------
------------------------------------------------,-X-.-.-.-.-.-.-.-.-.-.-X-----,-,-X-X-,-.-.-.-E-.-.-.-.-.-.-.-X-.-.-.-X-.-.-.-,-,-X-,-,-X~X~X~,~.-.-.-.-.-.-X-----------------------------------
------------------------------------------------,-X-.-.-.-.-.-.-.-X-X-X-X---,-,-X-,-,-,-,-,-.-.-.-.-.-.-.-.-.-.-X-.-X-.-.-.-E-,-.-,-X-X~,~X~X~X~X-.-H-.-.-,-X-----------------------------------
------------------------------------------------,-X-.-,-,-,-,-.-.-X---------,-.-X-,-,-,-,-,-X-X-.-.-X-.-.-.-.-.-.-X-.-.-.-,-,-.-,-X-,-X~X~----,-X-,-,-.-.-X-------------------------------------
------------------------------------------------,-X-.-,-.3.3,3.-.-X-------,-,-X-.-E-,-,-,-X---,-X-X-,-X-.-.-.-.-.-.-.-.-,-B-.-,-X---,-X~X~--,-,-X-+-X-X-X-X-------------------------------------
------------------------------------------------,-X-.-,-.3.3,3.-.-X-----,-,-X-.-.-.-,-,-X-------,-X---,-X-.-.-.-.-.-.-,-,-.-,-X-----,-X~X~,-,-X-.-.-X-------------------------------------------
------------------------------------------------,-X-.-,-,3,3,3.-.-X-----,-X/.-.-,-X-X-X-X---------------,-X-.-.-E-.-,-,-.-,-X-------,-X~X~,-X-.-.-.-X-------------------------------------------
------------------------------------------------,-X-.-.-.-.-.-.-.-X---,-,-X-,/,-X-,-,-,-,-,-,-,-,-,-,-,-,-,-X-.-.-.-,-X-,-X---------,-X~X~,-X-.-.-.-X-------------------------------------------
------------------------------------------------,-X-,-E-,-,-,-,-E-X-,-,-X-,-,-X/X-X-X-X-X-X-X-X1X-X-X1X1X1X-X-X-,-X-X-,-X-----------,-X~X~,-X-.-<-.-X-------------------------------------------
--------------------------------------------,-,-,-X-X-X-.-.-.-.-X-X-,-X-,-,-,-X-.-.-.-.-.-.-.-.1.-E-.1.1.1.-.-X-X-------,-,-,-----,-,-,-,-X-.-.-.-.-X-------------------------------------------
--------------------------------------------,-X-X-X-X-X-,-,-,-,-X-,-X-,-,-,-X-X-.-E-.-.-.-E-.-.1E-,-.1.1.1.-H-.-X-,-,-,-,-X-X4X-X5X-X4X-X-.-.-.-.-.-X-------------------------------------------
--------------------------------------------,-X-.-.-.-.-.-.-.-X-,-X-.-E-,-X-X-.-.-.-.-.-.-.-.-.1.-E-.1H1.1.-.-.-.-X-X-X-XU.4,4A--5,-.4.-.-.-.-.-.-.-X-------------------------------------------
--------------------------------------------,-X-<-.-E-.-.-.-E-X-XW.-:-,-X-X-.-<-.-.-.-.-.-.-.-.1E-E-.1.1.1.-.-.-.-.-A-.-.4H4,4---5,-.4.-.-.-.-.-.-,-X-------------------------------------------
--------------------------------------------,-X-.-.-.-.-.-.-.-.-.-.-.-X-,-X-.-.-.-B-,-,-,-X-X-X1X-,-.1.1.1.-.-.-.-.-.-E-.4.4,4W--5:-.4.-.-.-.-.-,-X---------------------------------------------
----------------------------------------------,-X-.-:-.-.-.-.-.-A-.-XWX-X-X-.-.-.-X-X-,-,-X-----,-X-X1X1X1X-.-.-.-.-W-.-.4H4,4A--5,-.4.-.-.-.-,-X-----------------------------------------------
----------------,-,-,-,-,-,-,-,-,-,-,-,-,-,-,-,---X-.-.-.-.-.-.-.-.-X-,-.-,-.-.-E-X-X-,-,-X-----,-,-,-,-,-X-.-.-.-A-.-.-.4.4,4---5,-.4.-.-.-,-X-------------------------------------------------
--------------,-,-X-X-X-X-X-X-X-X-X-X-X-X-X-X-X-X-,-X-.-.-.-B-.-.-.-.-,-.-,-.-.-.-X7X-,-,-X-,-,-,-X-X-X-X-X-X-X-X-X-X-X-XUX4X4X-X5X-X4X-X-X-X---------------------------------------------------
------------,-,-X-.-.-.-.-.-.-.-.-.-B-.-.-.-.-.-.-X-X-.-.-.-.-.-.-.-.-E-.-,-.-E-.-X7X-.-.-X-,-X-X-.-.-.-.-X-X-X-X-X-X-X-X-X-X-X-X-,-------,-,-,-,-,-,-,-,---------------------------------------
------------,-X-.-.-E-.-.-.-.-.-.-.-.-.-.-.-.-E-.-.-.-+-+-.-.-.-.-.-.-,-X-X-X-X-X-X7X-,-,-X-X-.-.-.-.-.-.-.-E-.-+-.-A-.-.-.-.-.-.-X-,---,-,-X-X-X-X-X-X-X-,-------------------------------------
------------,-X-.-.-.-.-.-.-.-.-.-.-.-.-.-.-.-.-.-.-.-+-,-X-X-.-.-.-E-.-X-X-X-X-X-X-X-.-.-.-.-.-.-.-E-.-.-.-.-.-+-.-.-.-.-.-E-.-.-.-X-,-,-X-.-.-.-.-.-E-.-X-,-,-,-,-,-,-,-----------------------
------------,-X-.-.-.-.-.-.-.-.-E-.-.-.-.-.-.-.-.-.-E-.-X-,-,-X-.-.-.-E-,-,-,-,-.-.-.-.-.-.-.-E-.-.-X-X-X-.-.-.-+-.-.-.-.-.-.-.-.-.-.-X-X-.-.-.-.-.-.-.-.-.-X-X-X-X-X-X-X-----------------------
------------,-X-.-.-.-.-.-.-.-.-.-.-.-.-.-.-.-.-.-.-.-.-.-X---X-.-.-.-.-,-,-,-,-.-.-E-.-.-.-,-,-,-X-,-X-X-X-X-X-X-X-X-.-.-.-.-.-.-.-.-.-E-.-.-.-.-.-.-.-.-.-.-.-.-.-E-.-X-----------------------
------------,-X-.-.-.-.-X-X-X-,-,-,-,-,-,-,-X-X-X-.-.-.-.-.-X-,-X-.-.-.-,-,-,-,-.-.-.-.-.-,-X-X-,-X-.-X-A-.-.-X-X-X-X-X-X-.-.-.-.-.-.-.-.-.-.-.-.-.-.-.-.-.-.-.-.-.-.-.-X-----------------------
------------,-X-.-.-.-.-X-,-X~.~.~.~.~.~.~.~X~,-X-.-.-.-.-.-X-,-X-X-X-X-X-X-X-X-X-X-X-X-X-X-,-X-+-X-X@.-.-.-E-.-.-.-X-,-,-X-.-.-.-.-.-.-.-.-.-E-.-.-.-H-.-.-.-.-.-.-.-E-X-----------------------
------------,-X-.-.-.-.-X-X~X~.~.~.~.~.~.~.~.~X~X-.-.-.-.-B-X---------------------------,-,-X`X---X-X@.@.@.-.-.-.-.-.-X---,-X-.-.-.-.-.-.-.-.-.-.-.-.-.-.-.-.-.-.-.-.-.-X-----------------------
,-,-,-,-,-,-,-X-B-.-.-.-,-.~.~.~.~.~.~.~.~.~.~,~.-.-.-.-.-.-X---------------------------,-X-,`------,-,-,@.@.@.@.-.-.-X-----,-X-.-.-.-.-E-.-.-.-.-.-.-.-.-.-.-E-.-.-.-.-X-----------------------
X-X-X-X-X-X-X-X-.-.-.-A-,-.~.~.~.~.~.~.~.~.~.~,~.-.-E-.-H-X-X-------------------,-,-,-,-,-X-,`----------E-,-.@.@.-.-E-X-,-----,-X-X-X-X-X-.-.-.-.-.-.-.-.-,-X-X-X-.-.-.-X-----------------------
X-.-.-.-.-.-X-X-.-.-.-.-X-X~X~.~.~.~.~.~.~.~.~,~.-.-,-X-X-----------------------,-X-X-X-X=X=,`--B---------,-,-.@.-.-.-.-X---------------,-X-.-.-:-.-.-.-,-X---,-X-.-.-.-X-----------------------
X-.-<-.-.-.-X-X-.-.-.-.-X-X-X-.~.~.~.~.~.~.~.~,~X-X-X-,-,-,-,-,-,-,-,-,-,-,-,-,-,-X-,-,-.=.=,`--------------E-.@.-.-.-.-X-----------------,-X-X-X-X-X-X-X-----,-X-H-.-A-X-----------------------
X-H-.-.-.-A-X-X-.-.-.-.-.-E-,-.~.~.~.~.~.~.~.~.~X~XYXYXYXYXYXYXYXYXYXYXYXYXYXYXYX].-,-,-.=.=,`----------E---,-X@X@.-.-.-X-,-,-,---------------------------,-,-,-X-,-,-,-X-,-,-------------------
X-.-<-.-.-.-+-+-.-.-.-.-.-.-,-.~.~.~.~.~.~.~.~.~,~+Y+Y+Y+Y+Y+Y+Y+Y+Y+Y+Y+Y+Y+Y+Y.].-,-,-.=.=,`----------------X-X-.-.-.-X-X-X-X-----------------------,-,-,-X-X~X-.-.-.-X-X~X-,-,---------------
X-.-.-.-.-W-+-+-.-.-.-.-.-H-,-.~.~.~.~.~.~.~.~.~,~+Y+Y+Y+Y+Y+Y+Y+Y+Y+Y+Y+Y+Y+Y+Y.]E-.-H-.=.=,`--------------E-X-X-H-.-E-.-.-.-X---------------------,-,-X~X~.~,~.-.-.-.-,-.~.~X~X~,-------------
X-.-<-.-.-.-+-+-.-.-.-.-.-E-,-.~.~.~.~.~.~.~.~.~X~XYXYXYXYXYXYXYXYXYXYXYXYXYXYXYX].-.-.-.=.=,`----------E---,-X-X-.-.-.-X-X-.-X-------------------,-,-X~.~.~.~,~.-.-.-.-,-.~.~.~.~X~,-----------
X-.-.-.-.-A-X-X-.-.-.-.-.-,-,-.~.~.~.~.~.~.~.~.~X~,-,-------------------------,-X-.-.-.-.-.=,`--------------B-X@X@.-.-.-X-X-.-X-----------------,-,-X~.~.~.~.~,~.-.-.-.-,-.~.~.~.~.~X~,---------
X-.-<-.-.-.-X-X-.-.-.-:-X-X-X~.~.~.~.~.~.~.~.~.~X~X-X-,-,---------,-,-,-,-,-,-,-,-X-.-.-X-X=,`------------,-E-.@.-.-.-.-X-X-.-X-----------------,-X~.~.~.~.~,~,~.-.-.-.-,-,~.~.~.~.~.~X~--------
X-.-.-.-.-:-X-X-.-.-.-,-X~X~X~.~.~.~.~.~.~.~.~.~,~.-.-X-X-,-,-----,-X-X-X-X-X-X-X-X-.-.-X-X-,`----------,-,-.-.@.-.-.-,-X-X-.-X---------------,-,-X~.~.~.~,~,~.-.-.-.-.-.-,-,~.~.~.~.~X~,-------
X-X-X-X-X-X-X-X-.-.-.-,-.~.~.~.~.~.~.~.~.~.~.~.~,~.-.-H-.-X-X-,-,-,-X-,-,-,-,-,-X-X-E-.-X-X-,`------,-,-E-.-.@.@.-.-E-X-,-X-.-X---------------,-X-.~.~.~,~,~.-.-,-,-,-,-.-.-,-.~.~.~.~.~X-------
------------,-X-.-.-.-,-.~.~.~.~.~.~.~.~.~.~.~.~,~.-.-.-.-.-X-X-,-X-.-.-.-.-.-H-E-X-.-.-X-X-,`----,-,-.-.@.@.-.-.-.-.-X-,-X-.-X-------------,-,-X~.~.~.~,~.~.-E-,-.-.-,-,-E-,-,~.~.~.~.~X~,-----
------------,-X-.-.-.-,-X~X~X~.~.~.~.~.~.~.~X~X~X~.-.-.-.-.-.-X-X-.-.-.-<-.-.-.-.-X-.-E-X-,-X`X-X-X-X@.@.-.-.-.-.-.-,-X-.-X-X-,-------------,-X-.~.~.~,~,~.-.-,-.-.-.-.-,~,-.-,-.~.~.~.~.~X-----
------------,-X-.-.-.-.-X-,-X~.~.~.~.~.~.~.~X~,-X-.-.-.-.-.-.-L-L-.-.-.-.-.-.-.-.-X-X-X-X---------,-X@.-A-.-E-.-.-.-X-,-X-.-X---------------,-X~.~.~.~,~.~.-E-,-.~.~.~.~.~,~.-,-,~.~.~.~.~X~----
------------,-X-.-.-.-.-X-X-X~,~,~,~,~,~,~,~X~X-X-.-E-.-.-.-.-L-L-:-.-.-.-.-.-.-.-.-X-,-------------X-.-.-.-,-X-X-X-X-,-X-+-X---------------,-X~.~.~.~,~.-.-,-.~.~.~.~.~.~,~.-E-,-.~.~.~.~X~----
------------,-X-.-.-.-.-.-.-.-.-.-.-.-.-.-.-.-.-.-.-.-.-.-.-.-X-X-.-.-.-.-,-,-,-.-.-.-X-,-----------,-X-X-X-X-----,-,-,-X-+-X-,-,-,---------,-X~.~.~.~,~.-B-,-.~.~.~.~.~.~,~.-.-,-.~.~.~.~X~----
------------,-X-.-.-.-.-.-.-.-.-E-.-.-.-.-.-.-.-.-.-.-.-.-B-X-X-,-X-.-.-.-,-.~,~,-.-.-.-X-,-----------------------,->-X-X-.-X-X-X>,-,-,-,-,-,-X~.~.~.~,~.-.-,-.~.~.~.~.~.~,~.-.-,-.~.~.~.~X~----
------------,-X-.-.-.-.-.-.-.-.-.-.-.-.-.-.-.-.-.-.-.-.-.-.-X---,-,-X-.-.-,-.~.~,-,-.-.-.-X-,---------------------,->-.-.-.-.-,-.>X>X>X-X-X-X-X-.~.~.~,~.-.-,-.~.~.~H~.~.~,~.-.-,-.~.~.~.~X~----
------------,-X-.-.-E-.-.-.-.-.-.-.-.-.-.-.-.-.-E-.-.-.-.-,-X---,-X-X-.-.-,-.~.~.~,-,-.-E-.-X-,-,-,-,-------------,->-.-.-.-.-,-.>.>.><-A-.-E-,-.~.~.~,~.-.-A-.~.~.~.~.~.~,~.-A-,-.~.~.~.~X~----
--------------,-X-.-.-.-.-.-.-.-.-.-.-.-B-.-.-.-.-.-.-.-,-X-----,-X-,-.-.-,-.~.~.~.~,-.-.-.-X-X-X-X-X-------------,->-.-.-.-.-,-,>,>X>X-X-X-X-X-.~.~.~,~.-.-,-.~.~.~.~.~.~,~.-.-,-.~.~.~.~X~----
----------------,-X-X-X-X-X-X-X-X-X-X-X-X-X-X-X-X-X-X-X-X-------,-X-,-.-.-,-.~.~.~.~,~,-.-.-E-.-.-.-X-------------,->-X-X-X-X-X-X>X---------,-X~.~.~.~,~.-.-,-.~.~.~.~.~.~,~.-.-,-.~.~.~.~X~----
----------------------------------------------------------------,-X-,-.-.-,-.~.~.~.~.~,~,-,-,-.-.-.-X---------------------------------------,-X~.~.~.~,~,-.-,-,~.~.~.~.~,~,~.-B-,-.~.~.~.~X~----
----------------------------------------------------------------,-X-,-.-E-,-.~.~.~.~.~.~.~.~X~X-.-.-X---------------------------------------,-X~.~.~.~.~,~.-:-,-.~.~.~.~,~.-.-,-,~.~.~.~.~X~----
----------------------------------------------------------------,-X-,-.-.-,-.~.~.~.~.~.~.~.~X~X-.-.-X---------------------------------------,-X-.~.~.~.~,~,-.-,-,-.~.~,~,-.-.-,-.~.~.~.~,~X-----
----------------------------------------------------------------,-X-,-.-.-,-.~.~.~.~.~.~.~.~X~X-.-E-X-----------------------------------------,-X~.~.~.~.~,~.-E-,-,~,~,~.-E-,-,~.~.~.~.~X~------
----------------------------------------------------------------,-X-,-.-.-,-,~.~.~.~.~.~.~.~X~X-.-.-X-----------------------------------------,-X-.~.~.~.~,~,-.-.-.-.-.-.-,-,-.~.~.~.~,~X-------
----------------------------------------------------------------,-X-X-.-.-.-,-.~.~.~.~.~.~.~X~X-.-.-X-,-----------------------------------------,-X~.~.~.~.~,~,-.-.-.-H-,-,-.~.~.~.~.~X~--------
------------------------------------------------------------------,-X-.-.-.-,-,-,~,~,~.~.~,~X~X-.-.-.-X-,---------------------------------------,-X~.~.~.~.~.~,~.-.-.-.-,-.~.~.~.~.~,~X~--------
------------------------------------------------------------------,-X-.-E-.-.-,-X~X-X-X~X~X~X-.-.-.-.-.-X-,---------------------------------------,-X~.~.~.~.~,~.-E-.-.-,-.~.~.~.~.~X~----------
--------------------------------------------------------------------,-X-.-.-.-.-.-.-.-.-.-.-.-.-.-.-.-.-.-X---------------------------------------,-X-,~,~,~,~,~,-,-,-,-,-,~,~,~,~,~X-----------
----------------------------------------------------------,-,-,-,-,-,-,-X-.-.-.-E-.-.-.-.-.-E-.-.-.-E-.-.-X-,---------------------------------------,-X~X-.-.-.-.-.-.-.-.-.-.-.-X-X~------------
--------------------------------------------------------,-,-X-X-X-X-X-,-,-X-.-.-X-X-X-X-X-X-X-X-X-.-.-.-.-.-X-,---------------------------------------,-X-E-.-.-.-.-.-E-.-.-.-E-X---------------
--------------------------------------------------------,-X-,-,-,-,-,-X-,-,-XV.6XV--------------,-X-.-.-E-.-,-X6,-------------------------------------,-X-.-.-.-.-.-.-.-.-.-.-.-X---------------
------------------------------------------------------,-,-X-,-,-,-,-,-,-X-X-X-.-X-----------------,-X-.-.-,-,6.-X-,-,---------------------------------,-X-.-.-.-.-.-.-.-.-.-.-A-X---------------
------------------------------------------------------,-X-,-,-,-,-,-,-,-,-.-.-.-X-------------------,-X-,-,6.-.-.-X-X-,-------------------------------,-X-X-X-.-X-X-X-X-X-.-X-X-X---------------
------------------------------------------------------,-X-.-,-X-X-X-X-,-.-.-.-.-X-,-------------------,-X6.-.-E-.-.-.-X-,---------------------------,-,-,-,-X-.-X-.-.-.-X-.-X-,-,-,-,-,-,-,-,-,-
------------------------------------------------------,-X-,-,-X-----,-X-.-.-.-.-B-X-------------------,-X-.-.-.-.-.-.-.-X---------------------------,-X-X-X-X-.-X-X-X-X-X-.-X-X-X-X-X-X-X-X-X-X-
------------------------------------------------------,-X-.-.-X-----,-X-.-.-.-.-.-X-----------------,-,-X-.-.-.-.-.-.-.-X---------------------------,-X-E-.-.-:-A-.-B-.-.-.-.-.-.-.-.-E-.-.-.-X-
------------------------------------------------------,-X-.-.-X-,-,-,-X-.-.-.-.-.-X-------------,-,-,-.-X-.-.-.-H-.-.-.-X-,-,-----------------------,-X-B-.-.-.-.-.-.-.-.-.-.-.-.-E-.-.-E-.-.-X-
------------------------------------------------------,-X-.-.-X-X-X-X-X-.-.-.-.-.-X---------,-,-,-.-X-X-.-.-.-.-.-.-.-.-.-X-X-,---------------------,-X-A-.-.-.-.-.-.-.-.-.-.-.-.-.-.-E-.-.-.-X-
------------------------------------------------------,-X-.-.-.-,-H-.-.-.-.-.-.-.-X-------,-,-.-.-X-.-.-.-.-.-.-.-.-.-.-.-.-.-X-,-,-----------------,-X-X-X-X-X-X-X-X-X-X-X-X-X-X-X-X-X-X-.-.-X-
------------------------------------------------------,-X-.-.-.-,-.-.-.-.-.-.-.-.-X-------,-X-X-X-.-.-.-.-.-.-.-.-.-.-.-.-.-.-.-X-X-,---------------------,-,-,-,-,-,-,-,-,-,-,-,-,-,-,-X-.-.-X-
------------------------------------------------------,-X-.-.-.-,-.-B-.-.-.-.-.-H-X-------,-X-.-.-.-.-.-.-.-.-.-:-.-.-.-.-.-.-.-.-.-X---------------------,-X-X-X-X-X-X-X-X-XXX-X-X-X-X-.-.-.-X-
------------------------------------------------------,-X-.-.-.-,-.-.-.-.-.-.-.-.-X-------,-X-.-.-.-.-.-.-.-.-.-.-.-.-.-.-.-.-.-.-.-X---------------------,-X-.-.-.-.-.-.-.-.-E-.-E-X-X-.-.-.-X-
------------------------------------------------------,-X-.-.-.-,-.-.-.-.-.-.-.-.-X-------,-X-.-E-.-E-.-.-X-X;.;.;.;X;X-.-.-E-.-E-.-X---------------------,-X-E-.-.-.-.-.-.-.-E-.-E-X-X-.-.-.-X-
------------------------------------------------------,-X-.-.-.-,-.-.-.-.-.-.-.-,-X-------,-X-.-.-.-.-.-.-X-X-.-.-.-X-X-.-.-.-.-.-.-X---------------------,-X-,-,-.-.-.-.-.-XXX-X-X-X-X-.-.-.-X-
------------------------------------------------------,-X-.-.-.-,-H-.-.-.-.-H-,-,-X-------,-X-.-B-.-.-.-.-X-X-.-.-.-X-X-.-.-.-.-.-.-X---------------------,-X8.8,8.-.-.-.-.-X-X-X-X-X-X-.-.-.-X-
------------------------------------------------------,-X-.-.-.-,-,-,-,-,-,-,-.-.-X-------,-X-.-.-.-.-.-.-X-X-H-E-.-X-X-.-.-.-.-.-.-X---------------------,-X-K-,8.-.-.-.-.-.-.-.-.-.-.-.-.-.-X-
------------------------------------------------------,-X-.-W-.-.-.-.-.-.-.-.-.-.-X-----,-,-X-.-.-E-.-.-.-X-X;.;.;.;X;X-.-.-.-E-.-.-X-,-------------------,-X8,8,8.-.-.-.-.-.-.-.-.-.-.-.-.-.-X-
------------------------------------------------------,-X-.-.-.-.-.-B-.-A-.-.-.-.-X---,-,-X-.-.-.-.-.-.-.-X-X-.-.-.-X-X-.-.-.-.-.-.-.-X-,-----------------,-X-E-.-.-.-.-.-.-.-.-.-.-.-.-.-.-,-X-
--------------------------------------------------------,-X-.-.-A-.-.-.-.-.-.-.-.-X---,-X-.-.-.-.-.-.-.-.-X-X-.-.-.-X-X-.-.-.-.-.-.-.-.-X-----------------,-X-.-.-.-.-.-.-.-.-.-.-.-.-,-X-X-X---
--------------------------------------------------------,-X-X-.-.-.-,-A-,-,-.-.-,-X---,-X-.-.-.-.-.-.-.-.-X-X-.-.-.-X-X-.-.-.-.-.-.-.-.-X-----------------,-X-.-.-.-.-.-.-.-B-.-.-.-,-X---------
--------,-,-,-,-,-,-,-,-,-,-,-,-,-,-------------------------,-X-X-X-X-X-,-X-X-X-X-----,-X-.-.-.-.-.-.-.-.-X-X-.-.-.-X-X-.-.-.-.-.-.-.-.-X-----------------,-X-X-X-X-X-X-X-X-X-X-X-X-X-----------
--------,-X-X-X-X-X-X-X-X-X-X-X-X-X---------------------------------,-X-,-X-----------,-X-.-.-.-.-.-.-.-.-X-X-.-.-B-X-X-.-.-.-.-.-.-.-.-X-------------------------------------------------------
--------,-X-.-.-.-.-.-.-.-.-.-.-.-X---------------------------------,-X-,-X-----------,-X-.-E-.-.-.-.-.-E-X-X-.-.-.-X-X-E-.-.-.-.-.-E-.-X-------------------------------------------------------
--------,-X-.-.-.-.-.-.-.-.-.-.-.-X---------------------------------,-X-.-X-,---------,-X-.-.-.-.-.-.-.-.-X-X-.-.-.-X-X-.-.-.-.-.-.-.-.-X-------------------------------------------------------
--------,-X-.-.-.-.-.-.-.-.-.-.-.-X-,-,-,-,-,-,-,-,-,---------------,-X-,-X-X-,-,-----,-X-.-.-.-.-.-.-.-.-X-X-.-.-.-X-X-.-.-.-.-.-.-.-.-X-------------------------------------------------------
--------,-X-.-.-.-.-.-.-.-.-.-.-.-X-X-X-X-X-X-X-X-X-X-,-------------,-X-E-.-.-X-X-,-,-,-X-.-.-.-.-.-.-.-.-X-X-,-,-,-X-X-.-.-.-.-.-.-.-.-X-------------------------------------------------------
--------,-X-.-.-.-.-.-.-.-.-.-.-.-,-<-.-.-.-.-.-.-.-.-X-------------,-X-X-.-.-.-.-X-X-,-X-.-E-.-.-.-.-.-.-X-X-.-.-.-X-X-.-.-.-.-.-.-E-.-X-------------------------------------------------------
--------,-X-.-.-.-.-.-.-.-.-.-.-.-,-.-.-.-.-.-.-.-.-.-X-,-,-,-,-,-,---,-,-X-.-.-.-.-X-,-X-.-.-.-.-.-.-.-.-X-X-.-.-.-X-X-.-B-.-.-.-.-.-,-X-------------------------------------------------------
--------,-X-.-.-.-.-.-.-.-.-.-.-.-,-.-.-.-.-.-.-H-.-.-.-X-X-X-X-X-X-,-,-,-X-.-.-.-.-X---,-X-,-,-,-,-,-,-A-X-X-B-E-.-X-X-A-,-,-,-,-,-,-X---------------------------------------------------------
--------,-X-.-.-.-.-.-.-.-.-.-.-.-,-.-.-.-.-.-.-.-.-.-.-,-.-,-,-.-.-X-X-,-X-.-.-.-.-X-----,-X-,-,-,-,-,-X-X-X-,-,-,-,-X-X-,-,-,-,-,-X-----------------------------------------------------------
--------,-X-.-.-.-.-.-.-.-.-.-.-.-,-.-.-.-.-.-.-.-.-.-,-X-X-X-X-.-.-.-.-X-X-.-.-.-.-X-----,-X-.-B-.-E-E-.-.-.-.-.-.-A-.-.-.-E-.-E-.-X-----------------------------------------------------------
--------,-X-.-.-.-.-.-.-.-.-.-.-.-,-.-.-.-.-.-.-.-.-.-X-----,-X-.-.-.-.-.-L-.-.-.-.-X-----,-X-.-.-.-.-.-.-.-.-.-.-.-.-.-.-.-.-.-.-.-X-----------------------------------------------------------
--------,-X-E-.-.-.-.-.-.-.-.-.-.-,-.-.-H-.-.-.-H-.-.-X-----,-X-.-.-.-.-.-L-.-.-.-.-X-----,-X-.-.-.-A-.-.-.-A-.-.-.-.-.-:-.-.-.-.-H-X-----------------------------------------------------------
--------,-X-.-.-.-.-.-.-.-.-.-.-.-,-.-.-.-.-.-.-.-.-.-X-----,-X-.-.-.-.-.-L-.-.-.-.-X-----,-X-.-.-.-.-.-.-.-.-.-.-.-.-.-.-.-.-.-.-,-X-----------------------------------------------------------
--------,-X-.-.-.-.-.-.-.-.-.-.-.-,-,-,-,-,-,-,-,-,-,-X-,-,-,-X-.-.-.-.-.-X-.-.-.-,-X-----,-X-X-.-.-H-.-.-.-.-.-.-.-.-.-A-.-.-,-X-X-------------------------------------------------------------
--------,-X-.-.-.-.-.-.-.-.-.-.-.-.-.-.-.-.-.-.-.-.-.-X-X-X-,-X-X-X-X-X-X-X-X-X-X-X---------,-,-X-X-.-.-.-.-.-.-.-.-.-.-.-.-,-X-----------------------------------------------------------------
--------,-X-E-.-.-.-.-.-.-.-.-.-.-.-.-.-.-.-.-.-.-.-.-.-.-X-------------------------------------,-,-X-X-.-:-.-.-<-.-.-.-,-X-X-------------------------------------------------------------------
--------,-X-.-.-.-.-.-.-.-.-.-.-.-.-.-.-.-.-.-.-.-.-.-.-.-X-----------------------------------------,-,-X-X-X-X-.-X-X-X-X-----------------------------------------------------------------------
--------,-X-.-.-.-.-.-.-.-.-.-.-.-.-.-.-.-.-.-.-.-.-.-.-.-X-------------------------------------------,-,-,-,-X-+-X-,-,-------------------------------------------------------------------------
--------,-X-.-.-.-.-.-.-.-.-.-.-.-.-.-.-.-.-.-.-.-.-.-.-.-X-------------------------------------------,-X-X-X-X-.-X-X-X-,-----------------------------------------------------------------------
--------,-X-.-.-.-.-.-.-.-.-.-.-.-.-.-.-.-.-.-.-.-.-.-.-.-X-----------------------------------------,-,-X-.-.-.-.-.-.-.-X-----------------------------------------------------------------------
----------,-X-.-.-.-.-.-.-.-.-.-.-.-.-.-.-.-.-.-.-.-.-.-.-X-----------------------------------------,->-.-.-.-.-.-.-.-.-X-----------------------------------------------------------------------
------------,-X-.-.-.-.-.-.-.-.-.-.-.-.-.-.-.-.-.-.-.-.-.-X-----------------------------------------,->-.-.-.-.-.-.-.-.-X-----------------------------------------------------------------------
--------------,-X-.-E-.-.-.-.-.-.-.-.-.-.-.-.-.-.-.-.-.-.-X-----------------------------------------,->-.-.-.-.-.-.-.-,-X-----------------------------------------------------------------------
----------------,-X-.-.-.-.-.-.-.-.-.-.-.-.-.-.-.-.-.-.-.-X-------------------------------------------,-X-X-X-X-X-X-X-X-------------------------------------------------------------------------
------------------,-X-.-E-.-.-.-.-.-.-.-.-.-.-.-.-.-.-.-.-X-------------------------------------------------------------------------------------------------------------------------------------
--------------------,-X-.-.-.-.-.-.-.-.-.-.-.-.-.-.-.-.-.-X-------------------------------------------------------------------------------------------------------------------------------------
----------------------,-X-.-.-.-.-.-.-.-.-.-.-.-.-.-.-.-.-X-------------------------------------------------------------------------------------------------------------------------------------
------------------------,-X-.-.-.-.-.-E-.-.-E-.-.-.-.-.-.-X-------------------------------------------------------------------------------------------------------------------------------------
--------------------------,-X-X-X-X-X-X-X-X-X-X-X-X-X-X-X-X-------------------------------------------------------------------------------------------------------------------------------------
