------------------------------------------------------------------,-,-X-,---------------------------------------------------------------------------------------------------------------------------------------------------------------------------
----------------------------------------------------------------,-,-X-,-X-,-------------------------------------------------------------------------------------------------------------------------------------------------------------------------
--------------------------------------------------------------,-,-X-.-.-.-X-,-------------------------------------------------------------------------------------------------------,-,-,-----------------------------------------------------------
------------------------------------------------------------,-,-X-.-.-.-.-,-X-,---------------------------------------------------------------------------------------------,-,-,-,-,-X~X~,-,-,-,-,-,-,-,-,-,-,-------------------------------------
------------------------------------------------------------,-X-,-.-.-tB.-,-,-X---------------------------------------------------------------------------------------------,-X~X~X~X~X~X~X~X~X~X~X~X~X-X-X-X-X-------------------------------------
--------------------------------------------------------------,-X-.-.-.-.-,-X-------------------------------,-,-,-,-,-,-----------------------------------------------------,-X~.~E~.~.~.~.~.~.~.~.~,~.-.-.-.-X-------------------------------------
----------------------------------------------------------------,-XCtCtCtCXC--------------------------------,-X-X-X-X-X-,-,-------------------------------------------------,-X~.~.~.~.~.~.~.~.~E~.~,~.-.-.-.-X-------------------------------------
------------------------------------------------------------,-,-,-X-.-.-.-X-,-----------------------------,-,-X-,-,-.-.-X-X-,-----------------------------------------------,-X~.~E~.~.~.~.~.~.~.~.~,~.-A-.-A-X-------------------------------------
--------------------------------------------------------,-,-,-X-X-X-.-.-.-X-X-,-,-------------------------,-X-tEtEtE.-.-.-.-X-,---------------------------------------------,-X~,~,~,~X~X~X~X~X~X~X~X~X-,-,-,-X-------------------------------------
----------------------------------------------------,-,-,-X-X-.-X-X-.-.-.-X-X-X-X-,-----------------------,-X-tEt@tE.-W-.-<-.-X---------------------------------------------,-X0.0.0.0X0------------,-X~.~.~.~X~------------------------------------
------------------------------------------------,-,-,-X-X-.-.-.-X-X-.-.-.-X-.-E-.-X-,-,-------------------,-X-tEtEtE.-.-.-.-.-X---------------------------------------------,-X0.0E0.0X0------------,-X~.~.~.~X~------------------------------------
--------------------------------------------,-,-,-X-X-.-.-.-E-,-X-X-L-L-L-X-.-.-.-.-X-X-,-------------------,-X-X-.-.-.-.-.-.-X---------------------------------------------,-X0.0.0.0X0------------,-X~.~.~.~X~------------------------------------
----------------------------------------,-,-,-X-X-.-.-.-.-,-,-X-X-.-.-tE.-,-X-X-.-.-.-.-X-,-,-------------------,-X-X-X-.-E-.-X-------------------------------------------,-,-X0.0.0.0X0,-----------,-X~E~.~.~X~------------------------------------
----------------------------------------,-X-X-.-.-.-.-.-,-X-.-X-,-.-.-.-.-,-X-,-,-.-.-.-.-X-X-,-------------------,-,-X-.-.-.-X-----,-,-,-,-,-,-,-,-,-,-,-,-,-,---------,-,-X-.-.-.-.-H-X-,---------,-X~.~.~.~X~------------------------------------
----------------------------------------,-X-.-.-.-.-.-.-X-X-,-,-.-.-.-E-.-.-,-,-X-X-.-.-.-.-.-X-,-,---------------,-X-X-.-.-.-X-----,-X-X-X-X-X-X-X-X-X-X-X-X-X-------,-,-X-.-.-.-.-.-.-.-X-,-------,-X~.~.~.~X~------------------------------------
----------------------------------------,-X-.-.-.-E-.-,-K-,-.-.-.-.-.-.-.-.-.-,-X-X-.-.-E-.-.-.-X-X-,-------------,-X-.-.-.-.-X-----,-X-A-.-.-.-.-.-.-.-.-.-H-X-----,-,-X-.-.-.-.-.-.-.-.-.-X-,-----,-X~.~.~.~X~------------------------------------
------------------------------------------,-X-.-.-.-.-X-X-,-,-.-.-.-.-t?.-.-.-,-,-,-X-.-.-.-.-.-.-.-X-------------,-X-.-.-.-.-X-----,-X-.-.-.-.-.-W-.-.-.-.-.-X---,-,-X-.-,-,-,-,-E-,-,-.-.-.-X-----,-X~.~.~.~X~------------------------------------
------------------------------------------,-X-.-.-.-,-X-X-.-,-,-.-.-.-.-.-.-,-,-,-X-X-.-.-.-.-.-.-,-X-------------,-X-.-.-.-.-X-----,-X-.-E-.-.-.-.-.-.-.-E-.-X---,-X-X-.-,-,-,-,-,-,-,-.-.-.-X-----,-X~.~.~.~X~------------------------------------
------------------------------------------,-X-.-.-.-,-,-,-.-.-,-,-.-.-:-.-,-,-.-.-,-,-.-.-.-.-.-.-X---------------,-X-X-.-.-.-X-----,-X-.-X-X-X-.-.-.-X-X-X-.-X---,-X-,-.-,-,-X-.-.-X-X-.-.-.-X-----,-X~.~.~.~X~------------------------------------
------------------------------------------,-X-.-.-.-X-,-.-.-.-.-,-.-.-.-.-,-.-.-.-,-,-,-.-.-.-.-,-X-----------------,-X-E-.-.-X-----,-X-.-X-.-X-.-.-.-X-.-X-.-X---,-X-,-.-,-,-.-.-.-,-,-.-.-.-X-----,-X~.~E~.~X~------------------------------------
--------------------------------------------,-X-.-,-X-X-,-.-.-E-,-,-.-.-,-,-.-E-,-,-,-X-X-.-.-.-X-----------------,-,-X-.-.-E-X-----,-X-.-X-X-X-.-.-.-X-X-X-.-X---,-X-,-A-,-,-.-.-E-,-,-.-.-.-X-----,-X~.~.~.~X~------------------------------------
--------------------------------------------,-X-E-,-.-,-,-,-,-.-.-,-,-,-,-.-.-,-,-.-,-X-.-.-.-.-X-----------------,-X-X-.-.-.-X-----,-X-.-.-.-.-.-.-.-.-.-.-.-X---,-X-X-.-,-,-X-,-,-X-X-.-.-.-X-----,-X~.~.~.~X~------------------------------------
--------------------------------------------,-X-.-,-.-,-.-.-,-,-.-.-.-.-.-.-,-,-.-.-,-,-.-.-.-,-X-----------------,-X-.-.-.-.-X-----,-X-X-.-.-.-.-.-.-.-.-.-X-X-----,-X-.-,-,-X-,-,-X-X-.-.-.-X-----,-X~.~.~.~X~------------------------------------
--------------------------------------------,-X-.-X-X-,-.-.-.-,-,-.-.-.-.-,-,-.-.-.-,-X-X-.-.-X-------------------,-X-X-.-.-.-X-------,-X-E-.-.-.-.-.-.-.-E-X-,-,-,-,-X-.-.-.-.-.-.-.-.-.-.-.-X-,-,-,-X~.~.~.~X~,-,-,-,-,-,-,-,-,-,-----------------
----------------------------------------------,-X-,-X-,-.-.-.-.-,-,-,-,-,-,-.-.-.-.-,-X-X-.-,-X---------------------,-X-.-.-.-X-------,-X-X-X-X-.-.-.-X-X-X-X-X-X-X-X-X-.-.-.-E-.-.-.-.-.-E-,-X-X-X-X-X~.~.~.~X~X-X-X-X-X-X-X-X-X-X-----------------
----------------------------------------------,-X-,-.-,-.-.-.-.-.-.-.-.-.-.-.-.-.-.-,-,-.-.-X-----------------------,-X-.-E-.-X-------,-X-X-.-X-.-.-.-X-.-X-X-X-.-.-.-,-,-.-.-.-.-.-.-.-.-,-,-.-.-.-,-.~.~.~.~,~.-.-.-.-.-.-.-.-,-X-,-,-,-,---------
----------------------------------------------,-X-X-X-X-,-,-,-,-,-,-.-.-,-,-,-,-,-,-,-X-X-X-X-----------------------,-XA,A,A,AXA------,-X-X-X-X-.-.-.-X-X-X-X-X-.-.-.-.-,-,-.-.-.-.-.-.-,-,-.-.-.-.-,-.~.~.~.~,~.-.-.-.-.-.-.-.-,-X-X-X-X-X---------
----------------------------------------------------,-X~,~,~,~,~E~,~.-.-,-.~.~.~.~.~W~X~----------------------------,-XA.A.A.AXA------,-X-.-.-.-.-.-.-.-.-.-X-X-.-.-.-.-.-,-,-.-.-W-.-,-,-.-.-.-.-.-,-.~.~.~.~,~.-.-.-.-.-.-.-.-,-.-.-E-.-X---------
----------------------------------------------------,-X~,~t?t?t?.~,~,-,-,-.~.~.~.~.~A~X~----------------------------,-XA.A.A.AXA------,-X-.-.-.-.-E-.-.-E-.-X-X-.-.-.-.-.-.-,-,-,-,-,-,-.-.-.-.-.-.-,-.~.~.~.~,~.-.-.-.-.-.-.-.-,-.-.-E-.-X---------
----------------------------------------------------,-X~,~t?.-t?.~,~,-,-,-.~.~.~.~.~.~X~----------------------------,-X-.-.-H-X-------,-X-X-,-,-,-,-,-,-,-X-X-X-.-.-.-.-.-.-.-.-.-.-.-.-.-.-.-.-.-.-,-.~.~.~.~,~.-.-.-.-.-.-.-.-,-.-.-.-.-X---------
----------------------------------------------------,-X~,~t?t?t?.~,~.-.-,-,~.~.~.~E~.~X~----------------------------,-X-.-.-.-X---------,-X-,-,-,-,-,-,-.-X-X-X-.-.-.-.-.-.-.-.-.-.-.-.-.-.-.-.-.-.-,-.~.~.~.~,~.-.-.-.-.-.-.-.-,-X-X-X-X-X---------
------------------------------------,-,-,-,-,-,-,-,-,-X~.~.~.~.~.~,~,-,-,-,-.~.~,~,~,~X~,-,-,-,-,-,-,-,-,-,-,-,-,-,-,-X-.-.-.-X-,-,-,-,-,-X-,-.-.-.-.-,-.-,-,-.-.-.-.-.-.-.-.-.-.-.-.-.-.-.-.-.-.-.-,-.~.~.~.~,~.-.-.-.-.-.-.-.-.-X-,-,-,-,-,-,-,-,-
------------------------------------,-X-X-X-X-X-X-X-X-X~,~,~,~,~,~,~.-.-.-,-,~,~,~.-,-X-X-X-X-X-X-X-X-X-X-X-X-X-X-X-X-X-.-.-,-X-X-X-X-X-X-X-,-,-,-,-,-,-.-,-,-.-.-.-.-.-.-.-.-.-.-.-.-.-.-.-.-.-.-.-,-.~.~E~.~,~.-.-.-.-.-E-.-.-.-X-X-X-X-X-X-X-X-X-
------------------------------------,-X-,-,-.-.-.-.-L-.-,-.-.-,-,-.-.-.-.-,-,-.<,-.-,-.-.-.-E-.-.-.-E-.-.-.-.-.-.-.-.-.-.-.-,-.-.-,-,-.-,-.-.-.-.-.-.-.-.-,-,-.-.-.-.-.-.-.-.-.-.-.-.-.-.-.-.-.-.-.-,-.~.~.~.~,~.-.-.-.-.-.-.-.-X-X-X-.-.-.-X-X-.-X-
------------------------------------,-X-.-,-,-.-.-.-L-.-,-.-.-,-,-.-.-H-.-,-,-.<,-.-,-.-E-.-,-.-.-.-.-.-.-.-.-.-.-.-.-.-W-.-<-.-.-,-,-.-,-.-.-.-.-<-.-.-.-,-,-.-.-.-.-.-.-.-.-.-.-.-.-.-.-.-.-.-.-.-,-.~.~.~.~,~.-.-.-.-.-.-.-.-X-X-.-.-.-.-.-X-.-X-
------------------------------------,-X-.-.-,-,-.-.-L-,-,-.-.-,-,-.-.-.-,-,-,-,<,-,-,-,-,-,-,-.-.-.-.-.-.-.-.-.-.-.-.-.-E-.-,-.-.-,-,-.-,-.-.-.-.-.-.-.-.-,-,-.-.-.-.-.-.-.-.-.-.-.-.-.-.-.-.-.-.-.-,-.~.~.~.~,~.-.-.-.-.-.-.-.-.-.-.-.-H-.-.-.-.-X-
------------------------------------,-X-,-,-,-X-X-X-X-X~,~,-,-,-,~,-,-,-,-,-.~.~.~.~,~X-X-X-X-X-X-X-X-X-X-X-X-X-X-X-X-X-.-.-,-X-X-X-X-X-X-X-.-.-.-.-.-.-.-X-X-X-.-.-.-.-.-.-.-.-.-.-.-.-.-.-.-.-.-.-,-.~.~.~.~,~.-.-.-E-.-.-.-.-.-.-.-A-:-A-.-.-.-X-
------------------------------------,-X-,-,-,-X-----,-X~,~,~,~,~.~,~.-.-,-.~A~.~.~E~.~X~----------------------------,-X-,-,-,-X---------,-X-.-.-.-.-.-.-.-X-,-X-.-E-.-.-.-.-.-.-.-.-.-.-.-.-.-.-.-.-,-.~.~.~.~,~.-.-.-.-.-.-.-.-.-.-.-.-H-.-.-.-.-X-
------------------------------------,-X-.-.-.-X-----,-X~,~t@t@t@.~,~,-,-,-.~.~.~.~.~.~X~----------------------------,-X-.-.-.-X---------,-X-X-X-X-X-X-X-X-X-,-X-.-.-.-.-.-.-.-.-.-.-.-.-.-.-.-.-.-.-,-.~.~.~.~,~.-.-.-.-.-.-.-.-X-X-.-.-.-.-.-X-.-X-
,-,-,-,-,-,-,-----------------------,-X-,-,-,-X-----,-X~,~t@.-t@.~,~,-,-,-.~.~.~.~.~.~X~----------------------------,-X-.-.-.-X-----------------------,-X-X-X-X-.-.-.-.-.-.-.-.-.-.-.-.-.-.-.-.-.-,-,-.~.~.~.~,~.-.-.-.-.-.-.-.-X-X-X-.-.-.-X-X-.-X-
X-X-X-X-X-X-XJ,-,-------------------,-X-.-.-.-X-----,-X~,~t@t@t@.~,~.-.-,-.~.~.~.~.~.~X~----------------------------,-X-,-,-,-X-----------------------,-X-E-.-.-.-.-.-.-.-.-.-.-.-.-.-A-.-.-.-,-,-,-.-.~.~.~.~,~,-,-.-.-.-.-.-.-.-.-.-.-.-.-.-.-.-X-
X-.-.-.-.-.-tJX-,-,-------,-,-,-,-,-,-X-.-.-.-X-,-,-,-X~,~,~,~.~,~,~.-.-,-,~.~.~.~.~.~X~----------------------------,-X-,-E-,-X-----------------------,-X-.-.-.-.-.-.-.-.-.-.-.-.-.-.-.-.-.-,-,-.-.~.~.~.~.~.~.~.~,~,-,-.-.-.-.-.-.-.-.-.-.-.-.-.-X-
X-.-.-.-.-.-tJ.-X-X-,-,-,-X-X-X-X-X-X-X-.-.-.-X-X-X-,-X-X-X-X-X~X~XS+S+S+SXSX~X~X~X~X~X~------------,-,-------------,-X-.-.-.-X-----------,-,-,-------,-X-E-.-.-.-.-.-.-.-.-.-.-.-.-.-.-.-.-,-.~.~.~.~.~.~.~.~.~.~.~.~,~,-.-.-.-.-.-.-.-.-.-.-.-.-X-
X-E-.-.-E-.-tJ.-.-.-X-X-X-.-.-.-.-.-.-.-.-.-.-.-.-.-X-X-,-.-X---,-X-.-.-.-X-----------------,-,-,-,-,-X-,-,-,-,-,-,-,-X-,-,-,-X-,-,-,-,-,-,-X-X-,-,-,-,-X-.-.-.-.-.-.-.-.-.-.-.-.-.-.-.-.-,-,-.~.~.~.~.~.~H~.~.~.~.~.~.~,-.-.-.-.-.-.-.-.-.-.-.-.-X-
X-.-.-.-.-.-tJ.-.-.-.-.-.-.-.-.-.-.-.-.-.-.-.-.-.-.-.-A-.-X-X---,-X-.-E-.-X-----------------,-X-X-X-X-X-X-X-X-X-X-X-X-X-.-.-.-X-X-X-X-X-X-X-X-X-X-X-X-X-X-E-.-.-.-.-.-.-.-.-.-.-.-.-.-.-.-,-.~.~.~.~,~X~,~,~X~X~.~.~.~.~,~,-.-.-.-.-.-.-.-.-.-.-.-X-
X-X-X-X-X-X-XJX-.-A-.-.-.-.-.-.-.-.-,-,-,-,-,-,-.-.-.-.-A-X-X---,-X-.-.-.-X---------,-,-,-,-,-X-.-.-.-.-.-.-.-.-.-.-.-.-.-.-.-.-.-.-.-.-.-.-.-.-.-.-,-X-X-X-X-X-.-.-.-.-.-.-.-.-.-.-.-.-,-,-.~.~.~,~,~.-.-.-.-,-,~.~.~.~.~,-.-.-.-.-.-.-.-.-.-.-.-X-
----,-X-X-X-XkX-A-.-.-.-.-.-.-.-.-.-,-.-.-.-.-,-.-.-.-.-.-,-X---,-X-,-,-,-X-------,-,-X-X-X-X-X-.-.-.-.-.-.-.-.-E-.-.-.-.-.-.-.-.-.-.-.-.-.-.-.-.-.-,-X-X-X-X-X-.-.-.-.-.-.-.-.-.-.-.-.-,-.~.~.~,~X~.-.->->->-.-X-,~.~.~.~,~.-.-.-.-.-.-.-.-.-.-.-X-
----,-X-.-.-.K.-.-.-.-.-.-.-.-.-.-.-,-.-.-.-tJ,-.-.-.-.-.-.-XH--,-X-.-.-.-X-------,-X-X-.-.-,-.-.-.-.-.-.-.-.-.-.-.-.-.-.-.-.-.-.-.-.-.-.-.-.-.-.-.-,-L-L-.-.-.-.-.-.-.-.-.-.-.-.-.-.-.-,-.~.~.~,~.-.-.-.-.-.-.-.-,-.~.~.~,~.-.-.-.-.-.-.-.-.-.-.-X-
----,-X-.-E-.K.-W-.-A-.-.-.-.-.-.-.-,-.-.-.-.-,-.-.-.-.-.-.-XH--,-X-.-.-.-X-------,-X-.-<-<-,-.-W-.-.-.-.-.-.-.-.-.-.-.-.-.-.-.-.-.-.-.-.-.-.-.-.-.-,-L-L-.-.-.-.-<-.-W-.-.-.-.-.-.-.-.-,-.~.~.~,~.-.-E-.-.-.-.-.-,-.~E~.~,~.-A-.-W-.-.-.-<-.-.-.-X-
----,-X-H-,-.K.-A-.-.-.-.-.-.-.-.-.-,-.-.-.-.-,-.-.-.-.-.-.-XH--,-X-,-,-,-X-------,-X-X-.-.-,-.-.-.-.-.-.-.-.-E-.-.-.-.-.-.-.-.-.-.-.-.-.-.-.-.-.-.-,-L-L-.-.-.-.-.-.-.-.-.-.-.-.-.-.-.-,-.~.~.~,~X-.-.-.-.-.-.-X-,-.~.~.~,~.-.-.-.-.-.-.-.-.-.-.-X-
----,-X-XL,LXkX-X-.-.-.-.-.-.-.-.-.-,-,-,-,-,-,-.-.-.-.-A-X-,---,-X-.-.-.-X---------,-X-X-X-X-X-.-.-.-.-.-.-.-.-.-.-E-.-.-.-.-.-.-.-.-.-.-.-.-.-.-.-,-X-X-X-X-X-.-.-.-.-.-.-.-.-.-.-.-.-,-,~.~.~.~X~,-.-.-E-.-,-X-.~.~.~.~,~.-.-.-.-.-.-.-.-.-.-.-X-
------,-X-.-X-,-,-X-X-.-.-.-.-.-.-.-.-.-.-.-.-.-.-.-.-A-.-X-X---,-X-.-.-.-X-----------------,-X-.-.-.-.-.-.-.-.-.-.-.-.-.-.-.-.-.-.-.-.-.-.-.-.-.-.-.-X-X-X-X-X-.-.-.-.-.-.-.-.-.-.-.-.-.-,-.~.~.~.~,~X-,-,-X-X-.~.~.~.~,~,-.-.-.-.-.-.-.-.-.-.-.-X-
------,-X-X-X-----,-,-X-.-.-.-.-.-.-.-.-.-.-.-.-.-.-.-.-.-.-X---,-X-.-E-.-X-----------------,-X-X-X-X-X-X-X-X-X-X-X-X-X-,-,-,-X-X-X-X-X-X-X-X-X-X-X-X-X-X-E-.-.-.-.-.-.-.-.-.-.-.-.-.-.-.-,-,~.~.~.~.~.~.~.~.~.~.~.~.~.~,~.-.-.-.-.-.-.-.-.-.-.-.-X-
----------------------,-X-X-X-X-X-.-.-.-.-.-.-.-.-,-,-X-.-.-X-,-,-XT.4.4.4XT,---------------------------------------,-X-,-,-,-X-,-,-,-,-,-,-,-,-,-,---,-X-.-.-.-.-.-.-.-.-.-.-.-.-.-.-.-.-.-,-.~.~.~.~.~.~H~.~.~.~.~.~,~,-.-.-.-.-.-.-.-.-.-.-.-.-X-
--------------------------,-X-X-,-X-X-X-.-.-.-X-X-X-X-X-X-X-X-,-X-X-.-.-.-X-,-,-,-----------------------------------,-X-.-.-.-X-,-X-X-X-X-X-X-X-X-X---,-X-E-.-.-.-.-.-.-.-.-.-.-.-.-.-.-.-.-,-,~.~.~.~.~.~.~.~.~.~,~,~,~.-.-.-.-.-.-.-.-.-.-.-.-.-X-
------------------------------------,-X-,-,-,-X---------,-,-X-X-,-,-,-E-,-,-X-X-,-,---------------------------------,-X-.-.-E-X-,-X-H-.-.-.-.-.-A-X---,-X-.-.-.-.-.-.-.-.-.-.-.-.-.-.-.-.-.-.-,-,-,~.~.~.~E~.~,~,~,~.-.-.-.-.-.-.-.-.-.-.-.-.-.-.-X-
------------------------------------,-X-.-.-.-X---------,-X-.-.-,-.-.-.-.-,-.-.-X-X---------------------------------,-X-,-,-,-X-,-X-.-.-E-.-E-.-.-X---,-X-E-.-.-.-.-.-.-.-.-.-.-.-.-.-.-.-.-.-.-.-,-,-.~.~.~.~,~.-.-.-.-.-.-.-.-X-X-X-,-,-,-X-X-.-X-
------------------------------------,-X-.-.-.-X-------,-,-X-.-.-,-.-.-.-.-,-.-.-.-,-X-------------------------------,-X-E-,-,-X-,-X-.-.-.-.-.-.-.-X---,-X-X-X-X-.-.-.-.-.-.-.-.-.-.-.-.-.-.-.-.-.-.-,-.~.~.~.~,~.-.-.-.-.-.-.-.-X-X-.-.-.-,-,-X-.-X-
----------------------------,-,-,-,-,-X-,-,-,-X-------,-X-.-.-E-,-,-,-,-,-,-.-.-.-.-X-,-,-,---------,-,---,-,-,-----,-X-.-.-.-X-,-X-E-.-E-.-E-.-E-X---,-,-,-,-X-.-.-.-.-.-.-.-.-.-.-.-.-.-.-.-.-.-.-,-.~.~.~.~,~.-.-.-.-.-.-.-.-,-,-.-.-.-.-,-.-.-X-
--------------------------,-,-XIXIXI,-X-,-,-,-X-,-,-,-,-X-,-,-,-,-.-.-.-.-,-,-,-,-,-,-X-X-X-,-,-,-,-,-X-,-,-X-X-,-,-,-X-.-.-.-X-,-XR+R+R+R+R+R+R+RXR,-,-X-X-X-X-.-.-.-.-.-.-.-.-.-.-.-.-.-.-.-.-.-.-,-.~.~.~.~,~.-.-.-.-.-.-.-.-,-.-.-A-A-,-,-.-.-X-
--------------------------,-X-X-A-X-X-X-.-.-,-X-X-X-X-X-.-,-,-.-.-,-,-,-,-.-.-,-.-,-.-X-X-X-X-X-X-X-X-X-X-X-X-X-X-X-X-X-.-.-.-X-X-XR+R+R+R+R+R+R+RXRX-X-X-E-.-.-.-.-.-.-.-.-.-.-.-.-.-.-.-.-.-.-.-.-,-.~.~.~.~,~.-.-.-.-.-.-.-.-,-,-.-A-A-,-.-.-.-X-
--------------------------,-X-A-.-.-.-.-.-,-,-.-.-.-L-.-.-,-,-.-.-,-.-.-,-.-.-,-.-,-.-,-.-.-E-.-.-.-.-.-.-.-.-.-.-.-.-.-.-.-.-.-.-.-:-.-.-.-.-.-.-.-.-X-X-.-.-.-.-.-.-.-.-.-.-.-.-.-.-.-.-.-.-.-.-.-,-.~.~.~.~,~.-.-.-.-.-.-.-.-X-X-,-,-,-,-.-X-.-X-
--------------------------,-X-A-H-.-.-.-,-,-.-.-.-.-L-.-.-,-,-.-.-,-.-W-,-.-.-,-.-,-.-,-E-.-,-.-.-.-.-E-.-.-.-.-.-.-.-.-.-.-.-.-.-.-.-W-.-<-.-.-.-.-.-X-X-.-.-.-.-.-.-.-.-.-.-.-.-.-.-.-.-.-.-.-.-.-,-.~.~.~.~,~.-.-.-.-.-.-.-.-X-X-X-,-,-.-X-X-.-X-
--------------------------,-X-A-A-H-.-,-,-.-.-.-.-.-L-.-.-,-,-.-.-,-,-,-,-.-.-,-.-,-.-,-.-.-,-.-.-.-.-.-.-.-.-.-.-.-.-.-.-.-.-.-.-.-.-.-.-.-.-.-.-.-.-X-X-.-.-.-.-.-.-.-.-.-.-.-.-.-.-.-.-.-.-.-.-.-,-.~.~.~.~,~.-.-.-.-.-.-.-.-.-.-.-.-.-.-.-.-.-X-
--------------------------,-X-XMXMXMX-X-X-X-X-X-X-X-X-X-.-.-,-,-,-.-.-.-.-,-,-,-,-,-,-X-X-X-X-X-X-X-X-X-X-X-X-X-X-X-X-X.......X.X-X-X-XR+R+R+RXRX-X-X-X-X-A-.-.-.-.-.-.-.-.-.-.-.-.-.-.-.-.-.-.-.-.-,-.~.~.~.~,~.-.-.-.-.-E-.-.-.-X-X-X-X-X-X-X-X-X-
----------------------------------------------------,-X-.-.-.-H-,-,-,-,-,-,-.-.-.-.-X---,-,-,-,-,-X-X-X-,-,-,-,-,-,-,-X.......X.,-,-,-XR+R+R+RXR------,-X-X-X-X-.-.-.-.-.-.-.-.-.-.-.-.-.-.-.-.-.-.-,-.~.~.~.~,~.-.-.-.-.-.-.-.-,-X-,-,-,-,---------
------------------------------------------------------,-X-.-.-.-,-.-.-.-.-,-.-.-.-,-X-,-,-X-X-X-X-X-,-X-X-X-X-X-X-X-X-X-.-.-.-X-X-X-X-X-.-.-.-X-------------,-X-.-.-.-.-.-.-.-.-.-.-.-.-.-.-.-.-.-.-,-.~.~.~.~,~.-.-.-.-.-.-.-.-,-X-X-X-X-X---------
------------------------------------------------------,-X-.-.-.-,-.-.-E-.-,-.-.-E-X---,-X-X-E-.-E-.-E-.-E-.-E-X-X-A-.-.-.-.-.-.-.-.-X-X-,-,-,-X-------------,-X-.-.-.-.-E-.-,-,-,-,-,-,-.-.-.-.-.-.-,-.~.~.~.~,~.-.-.-.-.-.-.-.-,-.-.-E-.-X---------
--------------------------------------------------------,-X-X-.-,-,-,-,-,-,-.-.-,-X---,-X-X-.-,-,-,-,-,-,-.-.-X-X-.-.-.-.-.-.-.-.-.-X-X-.-.-.-X-------------,-X-.-.-.-.-.-,-,-.-.-.-.-,-,-.-.-.-.-.-,-.~.~.~.~,~.-.-.-.-.-.-.-.-,-.-.-.-.-X---------
------------------------------------------------------------,-X-X-.-.-.-.-.-,-X-X-------,-X-E-,-,-,-,-,-,-.-E-X-X-.-.-.-.-.-.-.-.-.-X-X-.-.-.-X-------------,-X-.-.-.-.-,-,-.-.-.-W-.-.-,-,-.-.-.-.-,-.~.~.~.~,~.-.-.-.-.-.-.-.-,-.-.-E-.-X---------
----------------------------------------------------------------,-X-+-+-+-X-X-----------,-X-.-,-,-.-.-,-,-.-.-X-X-X-X-X-.-.-X-X-X-X-X-X-,-,-,-X-------------,-X-.-E-.-,-,-.-.-.-.-.-.-.-.-,-,-.-.-.-,-.~.~.~.~,~.-.-.-.-.-.-.-.-,-X-X-X-X-X---------
----------------------------------------------------------------,-X-+-+-+-X-------------,-X-E-,-,-.-.-,-,-.-E-X-X-.-:-X-.-.-X-E-.-H-X-X-.-.-.-X-------------,-X-.-.-,-,-.-.-.-.-.-.-.-.-.-.-,-,-.-.-,-.~.~.~.~,~.-.-.-.-.-.-.-.-.-X-----------------
----------------------------------------------------------------,-X-.-E-.-X-------------,-X-,-,-,-,-,-,-,-,-,-X-X-E-.-X-.-.-X-.-.-.-X-X-,-,-,-X-------------,-X-X-X-X-X-.-.-.-E-.-.-.-E-.-.-.-X-X-X-X-X~.~.~.~X~X-X-X-X-X-X-X-X-X-X-----------------
----------------------------------------------------------------,-X-.-.-.-X-----------,-,-X-.-.-.-.-.-.-.-.-.-X-X-.-.-X-.-.-X-.-.-.-X-X-.-.-.-X-------------------,-,-X-.-.-.-.-.-.-.-.-.-.-,-X-----,-X~.~.~.~X~------------------------------------
----------------------------------------------------------------,-X-.-.-.-X-----------,-X-X-.-.-.-.-.-.-.-.-.-X-X-.-.-.-.-:-.-.-.-.-X-X-.-.-.-X-------------------,-X-X-.-.-.-.-.-.-.-.-.-.-,-X-----,-X~.~.~.~X~------------------------------------
----------------------------------------------------------------,-X-.-E-.-X-----------,-X-.-.-.-.-.-.-.-.-E-.-X-X-.-.-.-.-.-.-.-.-.-X-X-.-.-.-X-------------------,-X-,-.-.-.-.-.-.-.-.-.-.-,-X-----,-X~.~.~.~X~------------------------------------
----------------------------------------------------------------,-X-,-,-,-X-----------,-X-X-.-.-.-.-.-.-.-.-.-X-X-.-.-.-.-H-.-.-.-.-X-X-.-.-.-X-------------------,-X-,-.-.-.-.-.-.-.-.-.-.-,-X-----,-X~.~E~.~X~------------------------------------
----------------------------------------------------------------,-X-,-,-,-X-,-----------,-X-.-.-.-.-.-.-.-X-X-X-X-X-X-X-,-,-,-X-X-X-X-X-.-.-.-X-------------------,-X-,-.-.-.-.-.-.-.-.-.-.-,-X-----,-X~.~.~.~X~------------------------------------
------------------------------------------------------------,-,-X-X-,-.-,-X-,-,---------,-X-.-.-.-.-W-.-.-X-X-X-X-X-X-X-.-.-.-X-X-X-X-X-.-.-.-X-------------------,-X-X-.-.-.-.-.-.-.-.-.-.-,-X-----,-X~.~.~.~X~------------------------------------
----------------------------------------------------------,-,-X-.-.-.-.-.-.-X-X---------,-X-.-.-.-.-.-.-.-.-.-.-.-.-.-.-.-.-.-.-.-.-.-.-.-.-.-X---------------------,-X-.-.-.-.-.-.-.-.-.-.-.-X-----,-X~.~.~.~X~------------------------------------
----------------------------------------------------------,-.-X-.-.-.-.-.-.-.-,-X-------,-X-.-.-.-.-<-.-.-.-.-.-.-.-.-.-.-.-.-.-.-.-.-.-.-.-.-X---------------------,-X-.-.-.-.-.-.-.-.-.-.-,-X-----,-X~.~.~.~X~------------------------------------
--------------------------------------------------------,-,-X-,-,-,-.-.-E-,-,-.-X-------,-X-.-.-.-.-.-A-.-.-.-.-.-.-.-.-.-.-.-.-.-.-.-.-.-.-.-X-----------------------,-X-.-.-.-.-.-.-.-.-,-X-------,-X~.~.~.~X~------------------------------------
--------------------------------------------------------,-.-X-tBtBtB.-.-,-.-,-,-,-X-----,-X-X-X-X-X-X-X-X-X-X-X-X-X-X-X-X-X-X-X-X-X-X-X-X-X-X-X-------------------------,-X-H-.-.-.-.-.-,-X---------,-X~.~.~.~X~------------------------------------
--------------------------------------------------------,-X-,-tBtCtB.-.-,-K-,-,-.-X---------------------------------------------------------------------------------------,-X-.-.-.-.-,-X-----------,-X~.~.~.~X~------------------------------------
----------------------------------------------------------X-,-tBtBtB.-.-.-,-,-.-X-,-----------------------------------------------------------------------------------------,-X9.9.9.9X9------------,-X~.~.~.~X~------------------------------------
----------------------------------------------------------,-X-.-.-.-.-.-E-.-.-.-X-------------------------------------------------------------------------------------------,-X9.9.9.9X9------------,-X~.~.~.~X~------------------------------------
------------------------------------------------------------X-.-.-.-.-.-.-.-.-X-,-------------------------------------------------------------------------------------------,-X9.9E9.9X9------------,-X~.~.~.~X~------------------------------------
------------------------------------------------------------,-X-X-.-.-.-.-,-,-X---------------------------------------------------------------------------------------------,-X9,9,9,9X9------------,-X~.~E~.~X~------------------------------------
--------------------------------------------------------------,-,-X-X-,-,-X-X-----------------------------------------------------------------------------------------------,-X~.~.~.~X~------------,-X~.~.~.~X~------------------------------------
------------------------------------------------------------------,-,-X-X---------------------------------------------------------------------------------------------------,-X~.~.~.~X~------------,-X~.~.~.~X~------------------------------------
----------------------------------------------------------------------------------------------------------------------------------------------------------------------------,-X~.~.~.~X~------------,-X~.~.~.~X~------------------------------------
----------------------------------------------------------------------------------------------------------------------------------------------------------------------------,-X~.~.~.~X~,-,-,-,-,-,-,-X~.~.~.~X~------------------------------------
----------------------------------------------------------------------------------------------------------------------------------------------------------------------------,-X~.~.~.~X~X~X~X-X-X-X-X~X~.~.~.~X~------------------------------------
----------------------------------------------------------------------------------------------------------------------------------------------------------------------------,-X~E~.~.~E~.~,~.-.-.-,-.~.~.~.~.~X~------------------------------------
----------------------------------------------------------------------------------------------------------------------------------------------------------------------------,-X~.~.~.~.~.~,~.-.-.-,-.~.~.~.~.~X~------------------------------------
----------------------------------------------------------------------------------------------------------------------------------------------------------------------------,-X~.~E~.~.~.~,~H-.-.-,-.~.~.~.~H~X~------------------------------------
----------------------------------------------------------------------------------------------------------------------------------------------------------------------------,-X~X~X~X~X~X~X~X-X-X-X-X~X~X~X~X~X~------------------------------------
