--------------,-X-X-XFX-X-X-XFX-X-X---------------------------------------------------------------------------------------------------------------------------------------------------------
--------------,-X-E-tF.-.-E-tF.-.-X---------------------------------------------------------------------------------------------------------------------------------------------------------
--------------,-X-.-tE,-.-.-tEtE.-X---------------------------------------------------------------------------------------------------------------------------------------------------------
--------------,-X-E-tE,-.-E-tEtE.-X---------------------------------------------------------------------------------------------------------------------------------------------------------
--------------,-X-.-tE,-.-.-tEtE.-X---------------------------------------------------------------------------------------------------------------------------------------------------------
--------------,-X-,-tE.-.-.-tEtE.-X---------------------------------------------------------------------------------------------------------------------------------------------------------
----------------X-,-tE.-.-.-tEtE,-X---------------------------------------------------------------------------------------------------------------------------------------------------------
----------------X-E-tE,-.-E-tEtE,-X-,-------------------------------------------------------------------------------------------------------------------------------------------------------
----------------X-X-XEX-X-X-XEXEX-X-X-,-----------------------------------------------------------------------------------------------------------------------------------------------------
----------------------------------,-X-X-,---------------------------------------------------------------------------------------------------------------------------------------------------
------------------------------------,-X-X-,-------------------------------------------------------------------------------------------------------------------------------------------------
--------------------------------------,-X-X-,-----------------------------------------------------------------------------------------------------------------------------------------------
----------------------------------------,-X-X-,---------------------------------------------------------------------------------------------------------------------------------------------
------------------------------------------,-X-X-,-----------------------------,-,-,-,-------------------------------------------------------------------------------------------------------
------------------------------------------,-X-.-X-,---------------------------,-X-X-X-------------------------------------------------------------------------------------------------------
--------------------------------------------,-X-.-X-,-------------------------,-X-.-X-------------------------------------------------------------------------------------------------------
----------------------------------------------,-X-.-X-,---------------------,-,-X-.-X-,-------,-,-,-,---------------------------------------------------------------------------------------
------------------------------------------------,-X-.-X---------------------,-X-.-.-.-X-,-,-,-,-X;X;X;--------------------------------------------------------------------------------------
--------------------------------------------------,-X-X-,-------------------,-X-.-.-.-X-X~X~X~X;.;.;X;,-------------------------------------------------------------------------------------
----------------------------------------------------,-X-X-,-----------------,-X-X-+-X-X-X~,~,;.;.;.;.;X-------------------------------------------------------------------------------------
------------------------------------------------------,-X-X-,---------------,-X-.-E-,-+~.~,~,;.;.;.;.;X;------------------------------------------------------------------------------------
--------------------------------------------------------,-X-X-,-------------,-X-.-.-,-+~.~.~,;,;.;.;,;X-------------------------------------------------------------------------------------
----------------------------,-,-,-,-----------------------,-X-X-,-----------,-X-E-.-+~.~.~.~,~,;.;.;X;--------------------------------------------------------------------------------------
------------------------,-,-,-X-X~X-,-,---------------------,-X-X-,---------,-X-.-,-+~.~.~.~.~,;,;,;X;--------------------------------------------------------------------------------------
----------------------,-,-X-X-,-.~.~X~X~,-,-,-,-,-,-,-------,-X-.-X-,-------,-X-E-,-+~.~.~.~,~,~.;.;X;,-------------------------------------------------------------------------------------
--------------------,-,-X~.-.-,-.~.~.~.~X~,-X-X-X-X-X-,-------,-X-.-X-,-----,-X-,-+~.~.~.~.~,~,;.;.;.;X-------------------------------------------------------------------------------------
--------------------,-X-.-.-.-,-,~,~,~,~,~XSX-.-.-.-H-X-,-------,-X-.-X-,---,-X-E-+~.~.~.~.~,~,;.;.;.;X;------------------------------------------------------------------------------------
--------------------,-X-,-,-W-,-,-,-,-,-,-.-.-.-.-.-,-X-X---------,-X-.-X-,-,-X-X-+~.~.~.~.~,~,;,;.;,;X-------------------------------------------------------------------------------------
--------------------,-X~.~,~.-,-.~.~.~.~,~XSX-.-.-,-,-X~X~,---------,-X-.-X-X-X-X-X-.~.~.~.~.~,;,;,;X;--------------------------------------------------------------------------------------
----------------------,-X~,~.-,-.~.~.~,~X~,-X-X-X-X-X~.~.~X~,---------,-X-X-X-X-X-X-.~.~.~.~.~,;.;.;X;--------------------------------------------------------------------------------------
------------------------,-X~X-,-.~,~X~X~--------,-X-X~.~.~.~X~,-------------,-,-X-+~.~.~.~.~.~,~.;.;X;,-------------------------------------------------------------------------------------
----------------------------,-X-X~X-----------------,-X~.~.~.~X~,---,-,-,-,-,-X-E-+~.~.~.~.~.~,~.;.;.;X-------------------------------------------------------------------------------------
------------------------------------------------------,-X~.~.~.~X~,-,-X-X-X-X-X-.-+~.~.~.~.~.~,~.;.;.;X;------------------------------------------------------------------------------------
----------------------------------------,-,-,-,-,-,-,-,-,-X~.~.~X~,-X-,-,-.-X;X-E-+~+~.~.~.~.~,~,;.;,;X-------------------------------------------------------------------------------------
--------------------------------------,-,-X~X~X~X~X~X~X~X~.~.~,~X~,-X-.-,-A-.;,-E-,-+~.~.~.~.~.~,;,;X;--------------------------------------------------------------------------------------
------------------------------------,-,-X~.~.~.~.~.~.~.~.~.~X~X-,-X-.-.-,-.-.;,-.-E-+~.~.~.~.~.~.~.~X~--------------------------------------------------------------------------------------
----------------------------------,-,-X~.~.~.~.~.~.~.~.~.~,~X~,-X-,-,-,-X-X-X;X-.-.-+~+~.~.~.~.~.~.~X---------------------------------------------------------------------------------------
--------------------------------,-,-X~.~.~,~X~X~X~X~X~X~X~X~--,-X-.-.-X---,-X-X-.-E-+~+~.~.~.~.~.~,~X---------------------------------------------------------------------------------------
------------------------------,-,-X~.~.~.~X~,-,-X~X~X~X~,-----,-X-A-,-X-,-,-X-X-X-X-X-X~.~.~.~.~.~X~----------------------------------------------------------------------------------------
----------------------------,-,-X~.~.~.~X~X~X~X~.~.~.~.~X~----,-X-,-.-X-X-X-,-.-X-,-,-,-X~.~.~.~.~X~----------------------------------------------------------------------------------------
--------------------------,-,-X~.~.~.~.~.~.~.~.~.~.~.~.~X~----,-X-.-.-,-.-,-,-.-.-X-X-,-X~,~,~,~,~X~----------------------------------------------------------------------------------------
------,-,-,-,-,-,-,-,-,-,-,-X~.~.~,~X~X~X~X~X~X~.~.~.~,~X~------,-X-,-,-.-A-.-.-.-,-,-X-X-.-.-.-.-X-----------------------------------------------------------------------------------------
----,-,-X~X~X~X~X~X~X~X~,-X~.~.~,~X~,-X-X~X~X~X~X~,~,~X~----------,-X-.-.-,-.-,-,-A-.-X-X-.-.-.-.-X-----------------------------------------------------------------------------------------
--,-,-X~.~.~.~.~.~.~.~,~X~,~,~,~,~.~X~.~.~.~.~.~.~.~.~X~------------,-X-X-X-X-X-X-X-.-XIX-,-,-,-,-X-----------------------------------------------------------------------------------------
--,-X~.~.~.~.~.~.~.~,~.~,~X-X~.~.~.~.~.~.~.~.~.~.~.~.~X~----------------------,-,-XI.IX-X;.;.;.;.;X;----------------------------------------------------------------------------------------
--,-X~.~.~X~X~X~X~X~X~,~.-.-X-X~.~.~.~.~,~X~X~X~X~,~,~X~,-,-,-,-,-,-,-,-,-,-,-,-X-.-.-.-X-.-tE.-.-X-----------------------------------------------------------------------------------------
--,-X~.~.~X~--,-,-X~,~X-.-.-,-X3X~.~.~,~X~X~X~X~X~.~.~X~X~X~X~X-X-X-X-X-X-X-X-X-.-.-.-.-X-.-.-.-.-X-,---------------------------------------------------------------------------------------
--,-X~.~.~X~,-,-X~.~.~X~X-,-X3X~.~.~.~X~,-X~.~,~,~,~,~,~.~.~H~.-,-,-.-.-.-.-.-.-tH,-,-X-X-,-,-,-,-X-X-,-,-----------------------------------------------------------------------------------
--,-X~.~.~X~,-X~.~.~.~.~X~X3X~,~.~.~,~,~X~X~,~X~X-.-.-,5.~.~,~X-X-.-.-.-.-.-.-,-,-,-,-,-.-.-.-.-.-.-.-X-X-,-,-------------------------------------------------------------------------------
--,-X~.~.~.~X~,-X~.~.~.~.~X~.~,~,~X~,~.~,~X~,~X-X-.-.-,5.~.~.~X~X-.-.-.-.-,-A-,-,-,-,-.-.-E-.-.-.-.-.-.-.-X-X-,-,-------------------------,-,-,-,-,-,-,-------------------------------------
----,-X~.~.~,~X~,-X~.~.~.~.~.~,~X~,-X~,~,~.~.~X~,-,-,-,5.~.~.~X~X-.-.-,-A-,-.-,-,-.-.-.-,-,-,-E-,-.-.-.-.-.-.-X-X-,-,-------------------,-,-X-X-X-X-X-X-,-----------------------------------
------,-X~,~,~.~X~,-X~.~.~.~,~X~----,-X~.~.~.~.~.~.~,~X~X~.~.~X~X-.-A-,-X-,-,-,-,-,-,-,-,-X-.-.-X-X-.-.-.-.-.-.-.-X-X-,-,-------------,-,-X-.-.-.-.-.-.-X-,---------------------------------
--------,-X~.~.~.~X~X~.~.~,~X~------,-X~.~.~.~.~.~.~.~X~X~.~.~X~X-.-.;X;,-X-.-.-.-,-X-X-X-X-.-.-X-,-X-X-X-,-.-.-.-.-.-X-X-,-,-------,-,-X-.-.-.-.-.-.-E-.-X-,-------------------------------
----------,-X~.~,~,~.~.~,~X~--------,-X~.~.~X~X~X~X~X~X~X~.~.~X~X;.;.-X-,-X-,-,-,-X-,-,-,-X-.-.-X-X-X-X-X-X-X-.-.-.-.-.-.-X-X-----,-,-X-.-.-,-,-,-,-,-.-E-.-X-,-,-,-,-----------------------
------------,-X~,~.~.~,~X~----------,-X~.~.~X~X~X~X~X~X~X~,~.~X~X-.-.-X-,-X-.-,-X-,-X-X-X-X-.-.-X-X-<-<-.-X-X-.-.-.-.-.-.-.-X---,-,-X-.-.-,-,-.-.-E-,-,-.-E-,-XZXZXZXZ----------------------
--------------,-X~X~X~X~------------,-X~.~.~.~.~.~.~H~,~.~,~,~X~X-.-.-X-,-X-,-.-X-,-X-.-,-,-.-.-X-X-<-.-.-A-,-.-.-.-.-H-.-.-X---,-X-.-.-,-,-.-.-.-.-.-,-.-.-,-+Z+Z+ZXZ----------------------
------------------------------------,-X~.~.~.~,~,~,~,~,~.~.~,~X~X-.-.-X-,-X-,-,-X-,-X-.-,-,-.-.-X-X-<-.-.-X-X-.-.-.-.-.-.-.-X---,-X-.-.-,-.-.-.-.-.-.-,-.-.-,-+Z+Z+ZXZ,-,-,-------,-,-,-----
------------------------------------,-X~X~X~X~X~X-.-X-X~X~X~X~X~X-.-.-X-,-X-.-.-.-X-X-X-X-X-.-.-X-X-X-X-X-X-X-.-.-.-.-.-.-.-X---,-X-,-,-,-,-,-,-,-,-,-,-.-.-,-+Z+Z+ZXZXZXZXZ----,-,-XZXZ,---
--------------------------------------------,-X-+-+-X-,-------,-X-.-.-X-,-X-.-.-.-.-X-X-,-X-.-.-X-,-,-X-X-.-.-.-.-.-.-.-,-X-X---,-X-.-.-,-.-.-.-.-,-E-,-.-.-,-+Z+Z+ZXZXZ+ZXZ--,-,-XZ+Z+ZXZ,-
------------------------------------------,-,-X-.-H-.-X-,-----,-X-A-A-X-,-X-.-.-.-.-.-.-X-X-.-,-X-X-X-.-.-.-.-,-,-,-,-X-X-------,-X-,-.-,-,-,-,-,-,-,-,-.-.-,-+Z+Z+ZXZXZ+ZXZ,-,-XZ+Z+Z+Z+ZXZ
----------------------------------------,-,-X-.-.-.-.-,-X-,-,-,-X-A-A-X-,-X-.-.-.-.-tA.-,-X-,-,-X-,-.-.-,-,-,-,-.-X-X-,-,-,-,-,-,-X-,-,-,-.-.-.-E-,-,-,-.-.-,-+Z+Z+ZXZXZ+ZXZ,-XZ+Z+Z+Z+Z+ZXZ
------------------------------------,-,-X-X-.-.-.-.-.-,-,-X-,-,-X-,-,-X-,-X-.-.-.-.-.-.-,-A.......,-,-,-,-.-.-A-A-X-X-X-X-X-X-X.X-,-,-,-,-,-,-,-,-.-.-,-.-.-,-+Z+Z+ZXZ+Z+Z+ZXZ+Z+Z+ZXZXZ+ZXZ
------------------------------------,-X-.-.-.-.-.-.-,-,-,-.-X-X-XWtHtHXH,-X-.-.-.-.-,.,-,-.........-,-,-.-.-.-.-.-+-.-.-.-,-,-t..-,-,-,-,-.-.-.-,-.-E-,-.-.-,-+Z+Z+Z+Z+Z+Z+Z+Z+Z+Z+ZXZXZ+ZXZ
------------------------------------,-X-.-.-.-.-.-,-,-,-.-.-.-.-+W.-.-.-X-X-.-.-.-.-,.............E.,..-.-.-.-.-.-+-.-.-.-,-,-t.E-.-.-.-.-.-.-E-,-.-.-,-.-.-,-+Z+Z+Z+Z+Z+Z+Z+Z+Z+Z+ZXZXZ+ZXZ
------------------------------------,-X-.-.-.-.-.-,-.-,-,-.-.-.-+WtF.-.-.-H-.-.-.-.-,.,.....t.E.....,.,-.-.-.-A-A-+-.-.-.-,-.-,-t..-.-,-,-,-,-,-H-,-E-,-.-.-,-+Z+Z+Z+Z+ZXZ+Z+Z+Z+Z+ZXZXZ+ZXZ
------------------------------------,-X-.-.-.-.-.-,-,-.-,-.-.-.-+W.-.-,-X-X-.-.-.-.-..,.,.......,.,.,.X-X-X-X-X-X-X-X-X-X-X-X-X-X.,-,-,-.-,-.-.-.-,-.-,-.-.-,-+Z+Z+Z+ZXZ,-XZ+Z+Z+Z+ZXZXZXZXZ
------------------------------------,-X-.-.-.-.-.-.-,-.-,-,-,-X-XWX-X-X-,-X-E-.-.-.-.-.-,-....,.,..-.-X-X-X-X-X-X-X-X-X-X-X-X-X-X-.-.-.-.-,-.-.-.-,-.-,-.-.-,-+Z+Z+Z+ZXZ,-XZ+Z+Z+Z+ZXZ------
------------------------------------,-X-.-.-,-,-E-,-E-,-,-E-,-X-,-,-,-,-,-X-.-.-.-E-.-.-,-,.,.,.,..-.-.-.-.-.-.-.-X-X-.-.-.-.-.-.-.-.-.-E-,-.-.-.-,-,-,-.-.-,-+Z+Z+Z+ZXZ,-XZXZXZXZXZXZ------
------------------------------------,-X-.-.-,-.-.-.-.-.-.-.-.-X-X-X-X-X-,-X-.-.-.-.-.-,-,-X.....X.X-.-.-.-.-.-.-.-X-X-.-.-.-.-.-.-.-.-.-.-,-.-.-.-,-,-X-.-.-,-+Z+Z+Z+ZXZ--------------------
------------------------------------,-X-.-.-E-.-E-.-E-.-E-.-E-.-E-.-E-X-,-X-X-+-+-+-X-X-X-X-.-.-X-X-X-X-X-X-X-.-.-X-X-.-.-X-X-X-X-X-X-X-X-X-,-,-,-X-X-X-.-.-,-XZXZXZXZXZ--------------------
------------------------------------,-X-.-.-,-.-.-.-.-.-.-.-.-.-.-.-.-XAX-X-X-.-.-.-X-X-X-.-tB.-.-X-------,-X-.-.-X-X-.-.-X-----------,-X-.-.-.-.-.-,-.-.-.-,-X-----------------------------
------------------------------------,-X-.-.-E-.-.-.-.-.-.-.-.-.-.-.-.-.-tA.-.-.-.-.-A-X-X-.-.-.-.-X-------,-X-.-.-.-.-.-.-X-------------,-X-.-.-.-.-,-.-.-,-X-------------------------------
------------------------------------,-X-.-.-,-.-.-.-.-.-.-.-.-.-.-.-.-.-tA.-.-.-.-.-A-X-X-.-.-A-.-X-------,-X-.-.-.-.-.-E-X---------------,-X-H-.-.-,-.-,-X---------------------------------
------------------------------------,-X-.-.-E-.-.-.-E-.-E-.-E-.-.-.-.-.-.-tA.-.-.-.-.-X-X-.-A-.-.-X-------,-X-X-X-X-X-X-X-X-----------------,-X-X-X-X-X-X-----------------------------------
------------------------------------,-X-.-.-,-.-.-.-.-.-.-.-.-.-E-.-.-.-.-t.t..-.-.-A-X-X-.-H-.-.-X-------------------------------------------------,-X-------------------------------------
------------,-,-,-------------------,-X-.-.-,-X-X-,-,-,-X-X-.-.-.-.-.-E-.-.-.-t.t.,-,-X-X-.-tB.-.-X-----------------------------------------------------------------------------------------
----------,-,-X-X-,-----------------,-X-.0.0.0X0X1.1.1,1X1X-.-.-.-.-.-.-.-.-E-.-,-X-X-,-X-.-.-.-.-X-----------------------------------------------------------------------------------------
--------,-,-X-.-.-X-,---------------,-X-.0.0.0.0.1.1.1,1.1.-.-.-.-.-.-.-.-.-.-,-X-----,-X-.-.-.-.-X-----------------------------------------------------------------------------------------
----,-,-,-X-.-.-.-.-X-,-----------,-,-X-.0.0.0.0.1.1A1,1.1.-.-.-.-.-.-.-.-.-,-X-------,-X-.-.-.-.-X-----------------------------------------------------------------------------------------
--,-,-X-X-.-.-.-.-.-.-X-,---------,-X-,-.0.0E0,0.1E1.1,1,1.-.-.-.-.-.-.-.-.-X---------,-X-X-+-X-X-X-----------------------------------------------------------------------------------------
,-,-X-.-.-.-.-.-.-.-.-.-X-,-,-,-,-,-X-,-.-X-X-X0X1.-.-.-X1X-H-.-.-.-.-.-.-H-X-----------,-X-+-X-,-------------------------------------------------------------------------------------------
,-X-.-.-.-.-.-.-.~.-.-.-.-X-X-X-X-,-X-X-X-X-X-X-X-.-.-.-X-X-X-X-X-X-X-X-X-X-------------,-XBtBXBX-------------------------------------------------------------------------------------------
X-E-.-.-.-.-.-.~.~.~.-.-.-.-.-E-.-X-X-,-.-.-.-.-.-.-.-.-X-------------------------------,-XBtBtBXB------------------------------------------------------------------------------------------
X7.-.-.-A-.-.~.~W~.~.~A-.-.-.-.-.-,-.-,-.-.-.-.-.-.-.-.-X-------------------------------,-X-E-.-X-------------------------------------------------------------------------------------------
X7E-.-.-.-.-.~.~.~.~.~.-.-.-.-.-.-,-.-,-.-.-.-.-.-.-.-,-X-------------------------------,-X-.-E-X-------------------------------------------------------------------------------------------
,-X-.-.-.-.-.-.~.~.~.-.-.-.-.-.-,-X-X-,-.-.-.-.-.-E-,-,-X-------------------------------,->->->-X-------------------------------------------------------------------------------------------
--,-X-.-.-.-.-.-.~.-.-.-.-X-.-.-X-X-X-X-X-,-,-X-X-,-,-.-X0----------------------------------------------------------------------------------------------------------------------------------
----,-X-.-.-.-.-.-.-.-,-X-XW+W+W+W.-.-X-X-,-,-X-,-X-.-E-X0----------------------------------------------------------------------------------------------------------------------------------
------,-X-.-.-.-.-.-,-X-,-XW+W+W+W.-.-X-X-.-.-.-X-X-E-.-X0----------------------------------------------------------------------------------------------------------------------------------
--------,-X-.-.-.-,-X-,-,-XW+W+W,-,-,-X-.-.-.-.-.-,-.-.-X-----------------------------------------------------------------------------------------------------------------------------------
----------,-X-.-,-X-,-,-XW+W+W,-,-.-,-.-.-.-.-.-.-,-.-.-X-----------------------------------------------------------------------------------------------------------------------------------
------------,-X-X---,-XW+W+W,-,-.-.-,-.-A-E-.-E-.-,-.-H-X-----------------------------------------------------------------------------------------------------------------------------------
--------------------,-X-.-.-,-,-X-X-X-X-X-X-X-X-X-X-X-X-X-----------------------------------------------------------------------------------------------------------------------------------
--------------------,-X-.-.-,-X-------------------------------------------------------------------------------------------------------------------------------------------------------------
----------------------,-X-X-X---------------------------------------------------------------------------------------------------------------------------------------------------------------
