------------------------------------------------------------------,-,-X-X-X-X-X-X-X-X-X-X-X-X-X-X-X-X-X-X-X-X-X-X-X-X-X-X-X-X-X-,---------------------------------------------------------------------------
----------------------------------------------------------------,-,-X-.-.-.-.-.-.-.-.-.-.-.-.-.-.-.-.-.-.-.-.-.-.-.-.-.-.-.-.-.-X-,-------------------------------------------------------------------------
--------------------------------------------------------------,-,-X-.-.-.-.-.-.-.-.-.-.-.-.-.-.-.-.-.-.-.-.-.-.-.-.-.-.-.-.-.-.-.-X-,-----------------------------------------------------------------------
------------------------------------------------------------,-,-X-.-.-.-.-.-.-.-.-.-.-.-.-.-.-.-.-.-.-.-.-.-.-.-.-.-.-.-.-.-.-.-.-.-X-,---------------------------------------------------------------------
------------------------------------------------------------,-X-.-.-.-.-.-.-.-.-.-.-.-.-.-.-.-.-.-.-.-.-.-.-.-.-.-.-.-.-.-.-.-.-.-.-.-X---------------------------------------------------------------------
------------------------------------------------------------,-X-.-.-.-.-.-.-.-.-.-.-.-.-.-.-.-.-.-.-.-.-.-.-.-.-.-.-.-.-.-.-.-.-.-.-.-X---------------------------------------------------------------------
------------------------------------------------------------,-X-.-.-.-.-.-.-.-.-.-.-.-.-.-.-.-.-.-.-.-.-.-.-.-.-.-.-.-.-.-.-.-.-.-.-.-X---------------------------------------------------------------------
------------------------------------------------------------,-X-.-.-.-.-.-.-.-.-.-.-.-.-.-.-.-.-.-.-.-.-.-.-.-.-.-.-.-.-.-.-.-.-.-.-.-X---------------------------------------------------------------------
------------------------------------------------------------,-X-.-.-.-.-.-.-.-.-.-.-.-.-.-.-.-H-.-.-.-.-.-.-.-.-.-.-.-.-.-.-.-.-.-.-.-X---------------------------------------------------------------------
------------------------------------------------------------,-X-.-.-.-.-.-.-.-.-.-,-,-,-,-X-X-X-X-X-X-.-.-.-.-.-.-.-.-.-.-.-.-.-.-.-.-X---------------------------------------------------------------------
------------------------------------------------------------,-X-.-.-.-.-.-.-.-.-.-,-,-,-,-X-X-X-X-X-X-.-.-.-.-.-.-.-.-.-.-.-.-.-.-.-.-X---------------------------------------------------------------------
------------------------------------------------------------,-X-.-.-.-.-.-.-.-.-.-,-,-,-,-+-W-+-+-H-X-.-.-.-.-.-.-.-.-.-.-.-.-.-.-.-.-X---------------------------------------------------------------------
------------------------------------------------------------,-X-.-.-.-.-.-.-.-,-,-,-,-,-,-X-X-X-X-+-X-H-,-,-,-H-,-,-.-H-.-.-.-.-.-.-.-X---------------------------------------------------------------------
------------------------------------------------------------,-X-.-.-.-.-.-,-,-,-.-.-.-.-H-X-,-,-X-H-X-X-.-.-.-.-.-,-,-,-.-.-.-.-.-.-.-X---------------------------------------------------------------------
------------------------------------------------------------,-X-.-H-.-.-,-H-.-,-,-,-,-,-,-X-X-X-X-.-X-X-,-,-,-,-,-,-,-,-,-,-.-H-.-.-.-X---------------------------------------------------------------------
------------------------------------------------------------,-X-X-X-X-X-X-X-,-,-.-B-.-.-.-.-E-.-.-.-.-.-E-.-.-.-.-B-,-,-,-X-X-X-X-X-X-X---------------------------------------------------------------------
------------------------------------------------------------------------,-X-.-.-.-.-.-.-.-.-.-.-.-.-.-.-.-.-.-.-.-.-.-.-,-X-,-------------------------------------------------------------------------------
----------------------------------------------------------------------,-,-X-.-.-.-.-.-.-.-.-.-E-.-.-.-E-.-.-.-.-.-.-.-.-.-.-X-------------------------------------------------------------------------------
----------------------------------------------------------------------,-X-.-.-.-.-.-.-.-.-.-.-.-.-.-.-.-.-.-.-.-.-.-.-.-.-.-X-,-----------------------------------------------------------------------------
--------------------------------------------------------------------,-,-X-.-.-,-,-,-,-,-,-,-E-,-,-,-B-,-E-,-,-,-,-,-.-.-.-.-.-X-----------------------------------------------------------------------------
--------------------------------------------------------------------,-X-.-.-.-,-X~.~.~.~.~.~.~.~.~.~.~.~.~.~.~.~.~X~X-.-.-.-.-X-----------------------------------------------------------------------------
--------------------------------------------------------------------,-X-.-.-.-,-X~.~.~.~.~.~.~.~.~.~.~.~.~.~.~.~.~X~X-.-.-.-.-X-----------------------------------------------------------------------------
--------------------------------------------------------------------,-X-.-E-,-X-X~.~.~.~.~.~.~.~.~.~.~.~.~.~.~.~.~.~X-.-.-E-.-X-----------------------------------------------------------------------------
--------------------------------------------------------------------,-X-.-.-,-X-.~.~.~.~.~.~.~.~.~.~.~.~.~.~.~.~.~.~X-X-.-.-.-X-----------------------------------------------------------------------------
--------------------------------------------------------------------,-X-.-.-,-X~.~.~,~,~,~,~,~.~.~.~.~,~,~,~,~,~.~.~X~X-.-.-.-X-----------------------------------------------------------------------------
--------------------------------------------------------,-,-,-,-,-,-,-X-,-,-,-X~.~.~,~.-.-.-,-.~.~.~.~,~.-.-.-,-.~.~X~X-,-,-,-X-,-,-,-,-,-,-----------------------------------------------------------------
--------------------------------------------------------,-X-X-X-X-X-XQXQ.1.1.1X1.~.~,~.-E-E-,-.~.~.~.~,~.-E-E-,-.~.~X~X1.1.1.1XQX-X-X-X-X-X-----------------------------------------------------------------
--------------------------------------------------------,-X-E-.-.-E-+Q+Q.-.-.-X-.~.~,~.-E-.-,-.~.~.~.~,~.-.-E-,-.~.~X~X-.-.-.-.-E-.-.-.-E-X-----------------------------------------------------------------
--------------------------------------------------------,-X-.-.-E-.-+Q+Q.-.-.-X-.~.~,~,-,-,-,-.~.~.~.~,~,-,-,-,-.~.~X~X-.-.-.-.-.-.-E-.-.-X-----------------------------------------------------------------
--------------------------------------------------------,-X-E-.-E-E-+Q+Q.-.-.-X-,~,~.~.~.~.~.~.~.~.~.~.~.~.~.~,~,~,~X~X-.-.-.-.-E-.-E-.-E-X-----------------------------------------------------------------
--------------------------------------------------------,-X-.-H-.-E-+Q+Q.-.-.-X-.-,-.~.~.~.~.~.~.~.~.~.~.~.~.~,~.-.-X-X-.-H-.-.-E-.-.-H-.-X-----------------------------------------------------------------
--------------------------------------------------------,-X-.-.-E-.-+Q+Q.-.-.-X-A-,-.~.~.~.~,~,~,~,~,~,~.~.~.~,~.-H-X-X-.-.-.-.-.-.-E-.-.-X-----------------------------------------------------------------
--------------------------------------------------------,-X-X-X-X-X-XQXQ,-,-B-X-.-,-.~.~.~.~,~.-.-.-.-,-.~.~.~,~.-.-X-X-,-,-,-XQX-X-X-X-X-X-----------------------------------------------------------------
--------------------------------------------------------------------,-X7.7.7.7X7.-,-.~.~.~.~,~.-B-.-A-,-.~.~.~,~.-,-X-X7.7.7.7X7----------------------------------------------------------------------------
--------------------------------------------------------------------,-X-,-,-,-X-X-,-.~.~.~.~,~.-.-.-.-,-.~.~.~,~,-X-X-,-,-,-X-,-----------------------------------------------------------------------------
--------------------------------------------------------------------,-X-,-,-,-X-X-X-X~X~X~.~,~.-.-.-.-,-,~,~X~X~X-X-X-,-.-.-X-------------------------------------------------------------------------------
--------------------------------------------------------------------,-X-,-,-,-.-,-X-X-X-X-X-X-X0X/X/X/X0X-X-X-X-X-X-,-,-,-,-X-------------------------------------------------------------------------------
------------------------------------------------------------------,-,-,-X-,-,-,-,-,-.-,-.-,-,-.0.-.-.-.0,-.-,-,-,-,-,-,-.-,-X-,-,---,-,-,-,-,-,-,-,---------------------------------------------------------
------------------------------------------------------------------,-X7X7X7,-.-,-,-,-,-,-.-,-,-.0.-E-.-.0,-.-,-,-,-,-,-,-,-,-X7X7X7--,-X-X-X-X-X-X-X---------------------------------------------------------
------------------------------------------------------------------,-X7E7,7,-,-,-,-.-,-,-.-,-,-.0.-.-.-.0,-.-,-,-.-,-,-,-,-,7E7H7X7,-,-X-.-.-.-.-.-X-,-------------------------------------------------------
------------------------------------------------------------------,-X7X7X7X7X-.-,-.-,-.-.-,-,-.0E-.-E-.0,-.-,-,-.-,-,-,-X7X7X-+-X-,-X-.-.-.-.-.-.-.-X-------------------------------------------------------
--------------------------------------------------------------------------,-,-X-X-X-,-.-.-,-,-.0.-.-.-.0,-.-,-,-,-X-X-X---,-X-A-X-,-X-.-.-.-.-.-.-.-X-,-----------------------------------------------------
----------------------------------------------------------------------------------,-X-X-X-X-X-X0,0,0,0X0X-X-X-X-X---,-,-,-,-X-+-X-X-.-,-,-,-,-.-.-.-.-X-,-,-,-,-,-,-----------------------------------------
--------------------------------------------------------------------------------------------,-X0.0.0.0X0------------,-X-X-X-X-+-X-X-.-,-t2t2t2,-.-.-.-X-X-X-X-X-X-X-,---------------------------------------
--------------------------------------------------------------------------------------------,-X0.0E0.0X0------------,-X-.-.-.-.-.-.-.-.-,-t2t2t2,-.-.-.-.-.-.-.-.-.-X-,-------------------------------------
--------------------------------------------------------------------------------------------,-X0.0.0.0X0------------,-X-<-.-.-.-.-.-H-,-.-t2t2t2t2H-.-.-.-.-.-.-.-.-.-X-------------------------------------
--------------------------------------------------------------------------------------------,-X0E0.0.0X0------------,-X-.-.-.-.-.-.-.-,-t2,-t2.-.-.-.-.-.-.-.-.-.-.-.-X-,-----------------------------------
----,-,-,-,-,-,-,-,-,-----------------------------------------------------------------------,-X0.0.0.0X0------------,-X-.-.-X-X-X-X-.-.-.-,-t2.-.-.-.-X-X-X-X-X-.-.-.-.-X-----------------------------------
----,-X~X~X~X~X~X~X~,-,-,-------------------------------------------------------------------,-X0.0.0.0X0------------,-X-.-.-X---,-X-.-.-.-.-.-.-.-.-,-X-------,-X-.-.-.-X-----------------------------------
----,-X~.~.~.~.~.~.~X~X~,-,-----------------------------------------------------------------,-X-L-L-L-X-------------,-X-.-.-X-----,-X-.-.-.-.-.-.-.-X---------,-X-.-.-.-X-----------------------------------
----,-X~.~.~.~.~.~.~.~.~X~X~,-------------------------------------------------------------,-,-X-L-L-L-X-------------,-X-.-.-X-----,-X-.-.-.-A-.-.-,-X-----------,-X-.-.-X-----------------------------------
----,-X~.~.~.~.~.~.~.~.~.~.~X-----------------------------------------,-,-,-,-,-,-,-,-,-,-,-.-X-.-.-.-X-,-,-,-,-,-,-,-X-+-+-X-------,-X-.-.-.-.-.-X-------------,-X-L-L-X-----------------------------------
----,-X~X~X~X~X~.~.~.~.~.~.~X~,-------------------------------------,-,-X-X-X-X-X-X-X-X-X-X-X-.-.-.-.-X-X-X-X-X-X-X-X-X-.-.-X-,-----,-X-X-X-X-X-X-X-----------,-,-X-+-+-X-,---------------------------------
------------,-X-.~.~.~.~.~.~.~X-----------------------------------,-,-X-.-.-.-.-.-.-.-E-.-.-.-.-.-.-.-.-.-.-.-.-.-.-.-.-.-.-.-X-,---------------------------,-,-X-.-B-.-.-X-,-------------------------------
----------,-,-,-X~.~.~.~.~.~.~X~,---------------------------------,-X-.-.-.-.-.-.-.-.-.-.-E-.-.-.-E-.-.-.-E-.-.-.-.-.-.-.-.-.-.-X-------------------------,-,-X-.-.-.-.-.-H-X-------------------------------
----,-,-,-,-X-X-X-.~.~.~.~.~.~,~X-,-,-----------------------------,-X-.-E-.-.-.-.-.-.-.-.-.-.-.-.-.-.-.-.-.-.-.-.-E-.-.-.-.-.-.-X---,-,-,-,-,-,---------,-,-X-.-.-.-.-.-.-.-X-,-,-,-,-,---------------------
----,-X-X-X-.-.-,-.~.~.~.~.~.~,~.-X-X-,---------------------------,-X-.-.-.-.-.-.-.-.-.-.-.-.-.-.-.-.-E-.-.-.-.-.-.-.-.-.-.-.-.-X---,-X-X-X-X-X---------,-X-.-E-.-.-X-X-.-.-.-X-X-X-X-X---------------------
--,-,-X-.-.-.-.-,-.~.~.~.~.~.~,~.-.-H-X---------------------------,-X-.-.-.-,-X-X-,-,-,-,-X-.-B-.-.-.-,-X-X-,-,-,-,-X-X-.-.-.-.-X---,-X-.-.-.-X---------,-X-.-.-.-.-X-.-X-.-.-.-.-.-B-X-,-,-,-,-,-,-,-,-,-,-
--,-X-.-.-.-.-.-,-.~.~.~.~.~.~,~.-.-.-X-,-------------------------,-X-.-.-,-X-,-X~.~.~.~.~,~X-.-.-.-.-X-X-.~.~.~.~.~X~,-X-.-.-.-X---,-X-.-.-.-X-------,-,-X-.-.-.-.-X-X-X-.-.-.-E-.-.-.-X-,-X-X-X-X-X-X-X-X-
,-,-X-.-.-.-.-.-,-.~.~.~.~.~.~,~.-.-H-.-X-,-,-,-,-,---------------,-X-.-.-,-X~X~X~.~.~.~.~,~X~.-.-.-,-X-X~.~.~.~.~.~X~X~X-.-.-.-X---,-X-A-.-A-X-------,-X-.-.-.-.-.-.-.-.-.-.-.-.-.-.-.-X-,-X-.-E-.-.-.-E-X-
,-X-.-.-.-.-.-.-,-.~.~.~.~.~.~,~.-.-.-.-X-X-X-X-X-X---------------,-X-E-.-,-.~.~.~.~.~.~.~.~,~X-.-.-X-X~.~.~.~.~.~.~.~,~.-.-E-.-X---,-X-.-A-.-X-----,-,-X-H-.-.-.-B-.-.-.-E-.-X-X-.-.-.-X-,-X-.-.-.-.-.-.->-
,-X-<-.-.-.-.-.-,-.~.~.~.~.~.~,~.-.-H-.-.-.-.-.-W-X---------------,-X-.-E-,-.~.~.~.~.~.~.~.~,~X-.-.-X-X~.~.~.~.~.~.~.~,~E-.-.-.-X---,-X-.-.-.-X---,-,-X-.-.-.-.-.-.-.-.-.-.-.-X-.-X-.-.-.-X-X-.-.-.-.-.-.->-
X-X-.-.-.-.-.-.-,-.~.~.~.~.~.~,~.-.-.-.-.-.-.-.-A-X---------------,-X-.-.-,-.~.~.~.~.~.~.~.~,~X-H-.-X-X~.~.~.~.~.~.~.~,~.-.-.-.-X---,-X-.-H-.-X---,-X-.-.-.-.-X-X-X-.-.-.-.-.-X-X-X-.-.-H-X-X-.-.-.-.-.-E->-
X-.-<-<-.-.-.-.-,-.~.~.~.~.~.~,~.-.-H-.-.-.-.-.-.-X-,-,-,-,-,-,-,-,-X-.-.-,-.~.~.~.~.~.~.~.~,~X-,-,-X-X~.~.~.~.~.~.~.~,~.-.-E-.-X---,-X-.-.-.-X-,-,-X-.-.-.-.-X-X-X-.-.-.-.-.-.-.-.-.-.-.-X-X-X-+-X-X-X-X-X-
X-X-.-.-.-.-.-.-,-.~.~.~.~.~.~,~.-.-.-.-.-.-.-.-.-X-X-X-X-X-X-X-X-,-X-.-.-,-.~.~.~.~.~.~.~.~.~.~.~.~.~.~.~.~.~.~.~.~.~,~.-.-.-.-X---,-X-.-.-.-X-X-X-X-.-.-.-.-X-W-.-.-.-.-E-.-B-.-.-.-.-.-X-,-X-+-X---------
,-X-<-.-.-.-.-.-,-.~.~.~.~.~.~,~.-.-H-.-.-.-.-.-.-.-.-.-.-.-.-.-X-,-X-.-.-,-.~.~.~.~.~.~.~.~.~.~.~.~.~.~.~.~.~.~.~.~.~,~.-.-E-.-X---,-X-.-.-.-X-X-X-X-.-.-.-.-X-X-X-X-X-X-X-X-X-.-.-.-.-A-X-,-X-.-X---------
,-X-.-.-.-.-.-.-,-.~.~.~.~.~.~,~.-.-.-.-X-X-.-.-.-.-.-.-.-.-.-B-X-X-X-.-.-,-.~.~.~.~.~.~.~.~.~.~.~.~.~.~.~.~.~.~.~.~.~,~.-.-.-<-X---,-X-X-.-.-.-.-X-X-.-.-.-.-X-.-.-.-.-.-.-.-.-X-.-.-.-.-X-X-.-.-X---------
--,-X-.-.-.-.-.-,-.~.~.~.~.~.~,~.-.-.-,-X-X-E-.-.-.-.-.-.-.-.-.-.-+-.-.-.-,-.~.~.~.~.~.~.~.~.~.~.~.~.~.~.~.~.~.~.~.~.~,~B-.-.-.-X-,-,-,-,-X-X-X-X-X-X-.-.-.-.-.-X-.-.-.-.-.-.-.-X-.-.-.-E-X-.-.-.-X---------
--,-X-.-A-.-.-.-,-.~.~.~.~.~.~,~.-.-.-X-,-X-.-.-.-.-.-.-.-.-.-E-.-+-E-.-.-,-.~.~.~.~.~.~.~.~,~,~,~,~,~,~.~.~.~.~.~.~.~,~.-.-A-.-XTXTX-X-X-X-X-X-,-,-X-.-B-.-.-.-.-X-X-X-X-X-.-.-X-X-.-.-.-.-.-.-E-X---------
----,-X-X-.-.-.-,-.~.~.~.~.~.~,~.-.-,-X-,-X-.-.-.-.-.-.-.-.-.-.-.-+-.-.-.-,-.~.~.~.~.~.~.~.~,~.-.-.-.-,-.~.~.~.~.~.~.~,~.-.-.-.-+T+T.-.-.-H-.-X-X-X-.-.-.-X-X-X-.-.-.-.-.-H-X-X-.-+-.-.-.-.-.-.-.-X---------
--------,-X-X-,-,-.~.~.~.~.~.~,~,-X-X---,-X-.-.-.-.-.-.-.-.-.-.-X-X-X-.-.-,-.~.~.~.~.~.~.~.~,~.-.-.-.-,-.~.~.~.~.~.~.~,~.-.-E-.-+T+TE-.-A-.-.-.-L-,-.-.-.-X-.-X-.-.-.-.-.-.-H-+-.-.-+-.-.-.-E-.-,-X---------
------------,-X-X~.~.~.~.~.~.~,~X-------,-X-.-.-.-.-.-.-.-.-.-.-X-,-X-,-,-,-,~,~,~,~,~,~,~,~,~,-,-,-,-,-,~,~,~,~,~,~,~,~.-.-.-.-+T+T,-,-.-H-.-X-X-X-.-.-.-X-X-.-.-.-.-E-.-H-.-X-X-.-+-.-.-.-,-X-X-----------
------------,-.-X~.~.~.~.~.~.~,~X-------,-X-.-.-.-.-.-.-B-X-X-X-X-,-X-X-X-X-X-X-X-,-,-,-X-X-X-XO+O+O+OX-X-X-X-,-,-,-X-X-X-X-X-X-XTXTX-X-.-.-X-X---,-X-.-.-.-.-.-.-X-X-X-X-X-X-.-.-X-B-.-.-X-X---------------
----------,-,-X~.~.~.~.~.~.~.~X~--------,-X-.-.-.-.-.-.-.-X-X-X-X-X-X-X-.-.-.-.-.-.-E-.-.-.-X-XO+O+O+OX-H-.-.-E-.-E-.-.-,-.-,-E-,-,-,-,-.-.-X-----,-X-.-.-.-.-.-X-.-.-.-.-.-.-.-X-.-.-.-H-X-----------------
----,-,-,-,-X~.~.~.~.~.~.~.~,~X---------,-X-.-.-.-.-.-.-.-.-,-,-,-,-,-.-.-.-.-.-.-.-.-.-.-.-X-XO+O+O+OX-.-E-.-.-.-.-.-.-,-X-X-X-X-X-X-X-X-X-X-----,-X-.-.-.-.-X-.-X-X-X-X-X-X-X-.-.-.-.-X-------------------
----,-X~X~X~.~.~.~.~.~.~.~.~X~----------,-X-t2.-.-.-.-.-.-.-,-,-,-,-,-.-.-.-.-.-.-.-.-.-.-E-X-XO+O+O+OX4.-.-.-.-.-E-.-.-,-X-X-X-,-,---------------,-X-.-.-.-.-X-.-X-.-H-.-.-.-.-.-.-.-.-X-------------------
----,-X~.~.~.~.~.~.~.~.~.~,~X~----------,-X-.-B-.-.-.-.-.-.-,-,-,-,-,-.-.-.-.-.-.-.-.-.-.-.-X-X-,-,-X-X4.-E-.-K-.-.-.-<-,-.-,-.-X-X-,-,-----------,-X-.-.-.-.-X-.-X-E-.-.-.-.-.-.-.-E-,-X-------------------
----,-X~.~.~.~.~.~.~.~.~,~X-------------,-X-.-.-.-.-.-.-.-X-X-X-X-X-X-X-.-.-.-.-.-.-.-.-A-<-X-X-,-,-X-X4.-.-.-.-.-.-.-.-,-.-,-.-,-.-X-X-----------,-X-.-.-.-.-X-.-X-.-.-.-.-.-.-.-.-.-X---------------------
----,-X~.~.~.~.~.~.~,~X~X---------------,-XU.-.-.-E-.-.-.-X-,-X-X-X-X-X-.-.-.-.-.-.-E-.-.-.-X-X-,-,-X-X-H-.-.-.-E-.-.-.-,-.-,-,-,-,-,-,-X---------,-X-.-B-.-.-X-X-X-.-.-X-X-X-.-.-.-.-X---------------------
----,-X~.~.~.~.~.~,~X~------------------,-XU,-.-.-.-.-.-.-X-,-X-.-.-W-+-B-.-.-.-.-.-.-.-.-A-X-X-,-,-X-X-.-B-E-.-.-E-.-.-,-X-X-X-,-,-.-.-X---------,-X-.-.-.-.-.-.-.-.-.-X-.-X-.-.-E-.-X---------------------
----,-X~X~X~X~X~X~X~------------------,-,-XU,-.-.-.-.-.-.-X-,-X-.-.-.-+-.-.-.-.-.-.-.-.-.-E-X-X-.-.-X-X-X-X-X-X-X-X-X-X-X-X-,-X-X-.-.-.-,-X---------,-X-.-H-.-.-.-A-.-.-X-X-.-.-.-.-.-X---------------------
--------------------------------------,-.-XU+U,-.-.-.-.-.-.-X-X-.-.-A-+-B-.-.-.-.-.-.-A-.-,-X-X-.-.-X---,-,-X-X-X-X-X-X-X-X-X-,-X-.-.-.-.-X---------,-X-.-.-.-X-X-X-.-.-.-.-.-.-.-.-.-X---------------------
--------------------------------------,-X-+U+U,-.-.-.-.-E-.-X-X-.-.-.-X-.-.-.-.-X-X-X-X-X-X-,-X-.-E-X-,-,-X-E-.-.-.-.-.-.-.-H-X-X-.-.-.-.-X---------,-X-.-.-.-X-.-X-.-.-.-.-.-E-.-B-,-X---------------------
--------------------------------------,-X-+U+UXUX-X-X-.-.-.-X-X-.-,-X-X-X-X-X-E-X-,-,-,-X-X-,-X-.-.-.-X-X-X-.-B-.-.-.-.-E-.-.-X-X-.-.-.-.-X-----------,-X-.-.-X-X-.-.-.-.-.-.-.-.-,-X-----------------------
--------------------------------------,-X-.-.-X-X-,-X-.-.-.-X-X-X-X-X-X~X~X~X~.~X~X~X~,-X-X-X-.-.-.-.-.-X-X-.-.-.-.-.-.-.-.-.-X-X-.-E-.-.-X-----------,-X-E-.-.-.-.-.-.-.-.-E-.-,-X-------------------------
--------------------------------------,-X-.-.-.-X-,-X-.-.-.-X-,-,-X~.~.~.~.~.~.~.~.~.~X~X-.-.-.-.-.-.-.-.-.-.-.-.-.-.-.-.-.-.-X-X-.-.-.-.-X-------------,-X-.-.-.-.-H-.-.-.-.-H-X---------------------------
--------------------------------------,-X-.-A-A-X---,-X-.-.-X-,-X~.~.~.~.~.~.~.~.~.~.~X~X-.-.-.-E-.-E-.-.-.-.-.-.-.-.-.-E-.-.-X-X-.-.-.-.-X-------------,-X-X-X-X-X-X-X-X-X-X-X-----------------------------
--------------------------------------,-X-.-.-.-X---,-X-.-.-X-X~.~.~.~.~.~.~.~.~.~.~.~X~X-.-.-.-.-.-.-.-.-.-.-.-.-.-.-.-.-.-.-X-X-.-.-.-.-X-----------------------------------------------------------------
--------------------------------------,-X5.5.5.5X5--,-X-.-,-X-X~.~.~.~.~.~.~.~.~.~.~.~X~X-B-.-E-.-E-.-E-.-.-.-.-.-.-.-.-.-.-E-X-X-.-.-.-.-X-----------------------------------------------------------------
--------------------------------------,-X-.-.-.-X---,-X-.-,-X-.~.~.~.~.~.~.~.~.~.~.~.~X~X-,-,-,-,-,-,-,-.-.-.-.-.-.-.-.-E-.-.-X-X-.-.-.-E-X-----------------------------------------------------------------
--------------------------------------,-X-.-.-.-X---,-X-.-,-X~.~.~.~.~.~.~.~.~.~.~.~.~X~X-X-,-,-,-,-,-X-X-X-.-.-.-.-.-.-.-.-.-X-X-.-.-.-.-X-----------------------------------------------------------------
--------------------------------------,-X-.-.-.-X---,-X-.-,-X~.~.~.~.~.~.~.~.~.~.~.~.~X~,-X-A-.-K-H-.-X---,-X-,-,-,-,-,-,-,-E-X-X-.-.-.-.-X-----------------------------------------------------------------
--------------------------------------,-X-.-.-.-X---,-X-.-,-X~.~.~.~.~.~.~.~.~.~.~.~.~.~X-X-.-.-.-.-.-X-----,-X-.-.-.-.-.-.-.-X-X-E-.-.-.-X-----------------------------------------------------------------
--------------------------------------,-X-.-.-.-X---,-X-.-,-X~.~.~.~.~.~.~.~.~.~.~.~.~.~X~X-.-.-.-.-.-X-----,-X-,-,-,-,-,-E-X-,-X-.-.-.-.-X-----------------------------------------------------------------
--------------------------------------,-X-.-.-.-X---,-X-.-,-X~,~,~,~,~,~,~,~.~.~.~.~.~.~.~X~X-.-.-<-.-X-,---,-X-.-.-.-.-.-.-X-,-X-.-.-.-.-X-----------------------------------------------------------------
--------------------------------------,-X-.-.-.-X---,-X-.-,-X-.-.-.-.-.-.-,-.~.~.~.~.~.~.~.~X-X-.-.-.-.-X-----X-,-,-,-,-,-X-,-,-X-.-.-E-.-X-----------------------------------------------------------------
--------------------------------------,-X-.-.-.-X---,-X-.-,-X-,-,-,-,-,-,-,-.~.~.~.~.~.~.~.~X~,-X-.-.-E-X-----,-X-.-.-.-.-X---,-X-.-.-.-.-X-----------------------------------------------------------------
--------------------------------------,-X-.-.-.-X---,-X-.-.-.-.-W-.-E-.-A-,-.~.~.~.~.~.~.~.~.~X~,-X-.-.-X-------,-X-,-,-,-X---,-X-.-.-.-.-X-----------------------------------------------------------------
--------------------------------------,-X-.-.-.-X---,-X-E-,-,-,-,-E-,-,-A-,-.~.~.~.~.~.~.~.~.~X~,-X-.-.-X-------,-X-.-.-.-X---,-X-.-.-.-.-X-----------------------------------------------------------------
--------------------------------------,-X-.-.-.-X---,-X-X-X-X-.-.-.-.-.-.-,-.~.~.~.~.~.~.~.~.~X~,-X-.-E-X-,-,-,-,-X-.-.-.-X-,---X-.-.-.-.-,-X---------------------------------------------------------------
--------------------------------------,-X-.-.-<-X---------,-X-,-,-,-,-,-,-,-.~.~.~.~.~.~.~.~.~X~,-X-.-.-X-X-X-X-X-X-.-.-.-X-X-X-,-X-H-.-.-.-X---------------------------------------------------------------
--------------------------------------,-X-.-.-.-X-,---------,-X~.~.~.~.~.~.~.~.~.~.~.~.~.~.~,~X~.-X-.-.-X-X-E-.-.-.-.-.-B-.-.-X-,-X-.-.-.-.-,-X-------------------------------------------------------------
--------------------------------------,-X-H-.-H-.-X-----------,-X~.~.~.~.~.~.~.~.~.~.~.~.~.~,~X-X-.-.-E-X-X-E-.-.-.-.-.-.-.-.-X-X-X-X-.-.-.-.-X-------------------------------------------------------------
--------------------------------------,-X-.-,-,-,-X-,-,-,-,-,-,-X~.~.~.~.~.~.~.~.~.~.~.~.~.~,~.-.-E-.-.-X-X-.-.-.-.-.-.-.-.-.-.-.-X-X-.-.-.-.-X-------------------------------------------------------------
----------------------------------------,-X-,-.-.-X-X-X-X-X-X-X-X~.~.~.~.~.~.~.~.~.~.~.~.~.~,~.-.-.-,-,-X-X-.-.-.-.-.-E-.-.-.-.-E-X-X-.-E-.-.-X-------------------------------------------------------------
----------------------------------------,-X-,-.-.-.-.-.-.-+-.-+-.~.~.~.~.~.~.~.~.~.~.~.~.~.~,~X-X-X-X-X-,-X-E-.-.-.-.-.-.-.-.-.-.-X-X-.-.-.-.-X-------------------------------------------------------------
------------------------------------------,-X-X-.-.-.-.-.-+-+-X-X~,~,~,~.~.~.~.~.~,~,~,~,~,~X~----------,-X-.-.-.-.-.-.-.-.-.-.-.-X-X-.-.-.-E-X-------------------------------------------------------------
--------------------------------------------,-X-.-.-.-.-.-.-.-X-,-X-.~,~,~,~,~,~,~.~,~,~,~X-------------,-X-.-.-.-.-.-.-.-E-.-.-.-X-X-.-.-.-.-X-------------------------------------------------------------
--------------------------------------------,-X-.-.-.-.-.-X-X-X-,-X-,-,-,-,-,-,-,-,-.-.-.-X-------------,-X-.-.-.-.-.-.-.-.-.-.-.-X-X-.-.-.-.-X-------------------------------------------------------------
--------------------------------------------,-X-.-.-.-.-.-X-,-,-X-.-.-.-.-.-.-.-.-.-.-.-.-X-,-,-,-,-,-,-,-X-.-.-.-.-.-.-.-.-.-.-.-X-X-.-.-.-.-X-------------------------------------------------------------
--------------------------------------------,-X-W-.-H-A-.-X-,-X-.-.-.-.-.-.-.-.-.-.-.-.-,-X-X-X-X-X-X-X-X-X-.-.-.-B-.-.-.-.-.-.-.-X-X-.-.-.-.-X-------------------------------------------------------------
--------------------------------------------,-X-.-.-.-.-.-X-,-X-.-.-.-.-.-.-.-.-.-.-.-,-X-X-.-.-.-.-.-.-+-+-.-.-.-.-.-.-.-.-.-.-.-X-X-.-.-.-.-X-------------------------------------------------------------
--------------------------------------------,-X-X-X-X-X-X-X-,-X-.-.-.-.-.-.-.-.-.-.-,-X-X-.-.-.-,-,-,-,-X-X-X-X-.-E-.-.-.-.-.-E-.-X-X-E-.-.-.-X-------------------------------------------------------------
------------------------------------------------------------,-X-.-.-.-.-.-.-.-.-.-,-X-X-.-.-.-,-X-X-X-X-,-,-,-X-.-.-.-.-.-.-.-.-.-X-X-.-.-.-.-X-------------------------------------------------------------
------------------------------------------------------------,-X-X-X-X-X-X-X-X-X-X-X-X-.-.-.-,-X-X-.-.-X-X-X-X-X-.-.-.-E-.-.-.-.-.-X-X-.-.-.-.-X-------------------------------------------------------------
------------------------------------------------------------------------------,-,-X-.-.-.-,-X-X-.-.-.-,-+-+-.-.-.-.-.-.-.-.-.-.-.-X-X-.-.-.-.-X-------------------------------------------------------------
------------------------------------------------------------------------------,-X-.-.-.-.-X-,-X-.-.-.-X-X-X-X-X-X-X-X-X-X-X-X-X-X-X-X-.-.-.-.-X-------------------------------------------------------------
------------------------------------------------------------------------------,-X-.-.-.-.-X-,-X-.-.-.-X-,-,-,-,-,-,-,-,-,-,-,-,-,-X-.-.-.-.-.-X-------------------------------------------------------------
------------------------------------------------------------------------------,-X-.-.-.-.-X-,-X-.-.-.-.-X-X-X-X-X-X-X-X-X-X-X-X-X-.-.-.-.-.-.-X-------------------------------------------------------------
------------------------------------------------------------------------------,-X-H-.-.-.-X-,-X-.-.-.-.-.-.-.-.-.-.-.-.-.-E-.-.-.-.-.-.-.-.-,-X-------------------------------------------------------------
------------------------------------------------------------------------------,-X-.-.-<-H-X-,-X-.-A-.-.-.-.-.-.-.-.-.-E-.-.-.-.-.-.-.-E-.-,-X---------------------------------------------------------------
------------------------------------------------------------------------------,-X-,-,-,-,-X---,-X-X-.-.-.-.-.-.-.-E-.-.-.-.-.-.-.-.-.-,-,-X-----------------------------------------------------------------
------------------------------------------------------------------------------,-X-.-.-.-.-X-----,-,-X-X-X-X-X-X-X-X-X-X-X-X-X-X-X-X-X-X-X-------------------------------------------------------------------
------------------------------------------------------------------------------,-X-A-W-.-H-X-----------------------------------------------------------------------------------------------------------------
------------------------------------------------------------------------------,-X-X-X-X-X-X-----------------------------------------------------------------------------------------------------------------
