----------------------------------------------------------------------------------------------------------------------------------------------------------------------------------,-X9X-X-X-X-X-X-X-X-X-X-X-X-----------
----------------------------------------------------------------------------------------------------------------------------------------------------------------------------------,-X-,9,-E-----------------X-----------
----------------------------------------------------------------------------------------------------------------------------------------------------------------------------------,-X-.-,9,-------------<---X-----------
----------------------------------------------------------------------------------------------------------------------------------------------------------------------------------,-X-.-.-,9,-,-,-,-,-------X-----------
----------------------------------------------------------------------------------------------------------------------------------------------------------------------------------,-X-.-.-.-X9X-X-X-X-------X-----------
----------------------------------------------------------------------------------------------------------------------------------------------------------------------------------,-X-.-.-.-X-.-.-.-X-------X-----------
----------------------------------------------------------------------------------------------------------------------------------------------------------------------------------,-X-.-.-.-X-.-.-.-X-E-----X-----------
----------------------------------------------------------------------------------------------------------------------------------------------------------------------------------,-X-.-.-.-X-.-.-.-X-----E-X-----------
----------------------------------------------------------------------------------------------------------------------------------------------------------------------------------,-X-.-.-.-X-.-.-.-X-------X-----------
,-,-,-,-,-,-,-,-,-,-,-------------------------------------------------------------------------------------------------------------------------------------------------,-,-,-,-,-,-,-X-.-E-.-X-.-.-.-X---E---X-----------
X-X-X-X-X-X-X-X-X-X-X-------------------------------------------------------------------------------------------------------------------------------------------------,-X6X6X6X6X6X-X-.-.-.-X-.-.-.-X-------X-----------
X-E-.-.-.-<-.-.-E-.-X---------------------------------------------------------------------------------------------------------------------------------,-,-,-,-,-,-----,-X6.6E6.6.6.-.-.-.-.-X-.-.-,-X-,-K-,-X-----------
X-.-A-,-,-,-,-,-.-.-X---------------------------------------------------------------------------------------------------------------------------------,-X-X-X-X-X-----,-X6.6.6.6.6.-.-.-.-.-X-.-,-,-X-.-.-E-X-----------
X-.-,-,-,-,-,-,-.-.-X---------------------------------------------------------------------------------------------------------------------------------,-X-E-.-E-X-----,-X6.6H6.6.6.-.-.-.-.-X-,-,-X-X-,-,-,-X-,---------
X-.-,-,-.-.-,-,-.-.-X---------------------------------------------------------------------------------------------------------------------------------,-X-.-A-.-X-----,-X6.6.6.6.6.-X-X-X-X-X-X-X~.~.~.~.~.~.~X-,-------
X-.-,-,-.-W-,-,-.-.-X-,-,-,-,-,-,-,-,-----------------------------------------------------------------------------------------------------------------,-X-E-.-.-X-----,-X6.6.6.6.6.-X-,-,-X-X~.~.~.~.~.~.~.~.~.~X-,-----
X-.-,-,-,-,-,-,-.-.-X-X-X-X-X-X-X-X-X-----------------------------------------------------------------------------------------------------------------,-X-.-.-E-X---,-,-X6,6,6,6X6X-X-X-X~.~.~.~.~.~.~.~.~.~.~.~.~X-----
X-.-,-,-,-,-,-,-.-B-.-.-.-.-E-.-.-.-X---------------------------------------------------------------------------------------------------------,-,-,-,-,-XY+Y+Y+YXY,-,-.-X-.-.-,-X-X-X~.~.~.~.~.~.~.~.~.~.~.~.~.~.~X~,---
X-.-E-.-.-.-.-.-.-.-.-.-.-.-.-.-.-.-X-----------------------------------------------------------------------------------------------------,-,-,-X-X-X-X-XY+Y+Y+YXYX-X-X6.-.-.-,-X~.~.~.~.~.~.~.~.~.~.~.~.~.~.~.~.~.~X~,-
X-.-.-.-.-.-.-.-.-X-X-X-X-X-.-.-.-.-X-,-,-,-,-----------------------------------------------------------------------------------------,-,-,-X-X-.-.-.-.-.-.-.-.-.-.-.-.-.6.6,-X-X~.~.~.~.~.~.~.~.~.~.~.~.~.~.~.~.~.~.~X~
X-X-X-X-X-X-X-.-.-X-.-.-.-X-.-.-.-.-X7X7X7X7X7----------------------------------------------------------------------------------------,-X-X-H-.-.-.-.-.-E-.-.-.-.-.-.-.-.-.-X6,-X~.~.~.~.~.~.~.~.~.~.~.~.~.~.~.~.~.~.~X~
----------,-X-.-A-X-.-.-.-X-.-.-.-.-.7.7.7.7X7--------------------------------,-,-,-,-,-,-,-------------------------------------------,-X-.-.-.-.-.-.-.-.-B-.-.-.-.-.-.-.-.-,-X-X~.~.~.~.~.~.~.~.~.~.~.~.~.~.~.~.~.~.~X~
----------,-X-.-.-X-.-.-.-X-.-.-.-.-.7.7.7.7X7----------------------------,-,-,-X-X-X-X-X-X-,-,---------------------------------------,-X-.-.-.-.-.-.-.-.-.-.-.-.-.-.-.-E-.-B-X-X~.~.~.~,~,~,~,~,~,~,~,~,~.~.~.~.~.~.~X~
----------,-X-.-.-X-X-X-X-X-.-.-.-.-.7.7.7.7X7------------------------,-,-,-X-X-.-.-.-.-.-.-X-X-,-,-,-,-,-,-,-------------------------,-X-.-.-.-.-.-.-A-.-.-.-.-.-.-.-.-.-.-,-,-.~.~.~.~,~,-,-,-,-,-,-,-,-.~.~.~.~.~.~X~
----------,-X-.-.-.-.-.-.-.-.-.-X-X-X7,7,7,7X7--------------------,-,-,-X-X-.-.-.-.-E-.-.-.-.-.-X-X-X-X-X-X-X-,-,-,-,-----------------,-X-.-.-.-.-.-.-.-X-X-X-X-.-.-.-.-.-.-,-,-.~.~.~.~,~.-.-.-K-.-.-,-,-.~.~.~.~.~.~X~
----------,-X-.-.-.-.-B-.-.-.-.-X-,-X-.-.-.-X-------------------,-,-X-X-.-.-.-.-X-X-X-X-X-X-.-.-.-.-.-.-E-.-.-X-X-X-X-,-,-,-,-------,-,-X-.-.-B-.-.-X-X-.-.-.-.-X-.-.-.-.-.-,-,-.~.~.~.~,~.-.-.-H-.-.-,-,-.~.~.~.~.~.~X~
----------,-X-.-.-.-.-.-.-.-.-.-X-,-X7.7.7.7X7------------------,-X-.-.-.-.-X-X-.-.-.-.-.-.-X-.-.-.-E-.-.-.-E-.-.-.-.-X-X-X-X-,-,-,-,-X-X-.-E-.-.-.-X-.-.-.-.-.-X-H-.-.-.-.-,-,-.~.~.~.~,~.-.-.-.-.-.-,-,-.~.~.~.~.~.~X~
----------,-X-E-E-,-E-,-,-.-.-.-X-,-X-.-.-.-X-----------------,-,-X-.-.-X-X-.-.-.-.-.-.-.-.-X-.-.-.-.-.-.-.-.-.-.-.-.-.-.-.-.-X-X-X-X-.-.-.-.-.-.-.-X-.-.-.-.-X-X-.-.-.-.-.-,-,-.~.~.~.~,~.-E-.-.-.-.-,-,-.~.~.~.~.~.~X~
--------,-,-X~.~.~.~.~.~X~X-X-X-X-,-X-.-.-.-X-----------------,-X-.-.-X-.-.-.-.-X-X-X-X-X-X-.-.-.-.-.-.-E-.-.-.-.-.-.-.-.-.-E-.-.-L-.-.-.-.-.-.-.-.-.-X-X-X-X-.-.-.-.-.-.-.-<-,-.~.~.~.~,~.-.-.-.-.-E-,-,-.~.~.~.~.~.~X~
------,-,-X~.~.~.~.~.~.~.~X~X~,-,-,-X-.-.-.-X-,-------------,-,-X-.-X-.-.-.-X-X-.-.-.-.-.-.-.-,-X-X-X-X-X-X-X-X-X-X-.-.-.-.-.-.-.-L-.-.-.-.-.-.-.-.-.-.-.-.-.-.-.-.-.-.-.-.-,-,-.~.~.~.~,~,-,-,-.-.-.-,-,-.~.~.~.~.~.~X~
------,-X-.~.~.~.~.~.~.~.~.~.~X~X~--,-X-B-.-.-X-----------,-,-X-.-.-.-X-X-X-.-.-.-.-E-.-.-.-.-X-X~X~X~X~X~X-,-,-,-X-X-.-.-.-.-.-.-L-.-.-.-.-B-.-.-.-E-.-.-.-.-.-E-.-.-.-E-.-,-,-.~.~.~.~,~,-,-,-.-.-.-,-,-.~.~.~.~.~.~X~
----,-,-X~.~.~.~.~.~.~.~.~.~.~.~X~,-,-X-.-.-.-X---------,-,-X-X-.-.-.-X-.-.-.-.-.-.-.-.-.-.-,-X-.~.~.~.~.~,~X~X-X-.-.-.-.-.-,-,-X-X-X-X-.-.-.-.-.-.-.-.-.-.-.-.-.-.-.-.-.-.-,-X-X~.~.~.~.~.~,~,~.-.-.-,-,-.~.~.~.~.~.~X~
----,-X~.~.~.~.~.~.~.~.~.~.~.~.~.~X-,-X-.-.-.-X-------,-,-X-.-.-.-.-.-.-.-.-.-,-X-X-X-X-X-X-X-X~.~.~.~.~,~,~.-,-X-.-.-.-,-X-X-X-,-,-,-,-X-X-X-A-,-,-,-,-E-,-,-,-,-,-,-.-.-.-X-,-X~.~.~.~.~.~,~,~.-.-.-.-,-,~.~.~.~.~.~X~
----,-X~.~.~.~.~.~.~.~.~.~.~.~.~.~X~,-X-+-+-+-X---,-,-X-X-.-.-.-.-.-.-.-.-,-X-X-X~X~X~X~,-,-X~.~.~.~.~,~,~.-,-,-.-.-.-,-X-,-,-X-X~X-X-X-,-,-,-X-X-.-.-.-.-.-.-B-.-.-X-X-X-X-X-,-X~.~.~.~.~.~,~,~.-.-E-.-,-,~.~.~.~.~.~X~
----,-X~.~.~.~.~.~.~.~.~.~.~.~.~.~X~,-X-+-+-+-X-,-,-X-.-.-.-.-.-.-.-.-,-X-X-,-X~.~.~.~X~,-X-.~.~.~.~,~,~,-,-,-.-.-.-,-X-,-X-X~.~.~.~.~.~X~X~X~X~X-,-,-,-,-,-,-,-,-,-X-X~X~X~X~X~X-.~.~.~.~.~.~,~.-.-.-.-,-,~.~.~.~.~,~X~
----,-X~.~.~.~.~.~.~.~.~.~.~.~.~.~.~X-X-.-.-.-X-,-X-.-.-.-.-.-.-,-X-X-X-,-X-X~.~.~.~.~X~,-X~.~.~.~.~,~,-,-,-.-E-,-E-X-X-X~.~.~.~.~.~.~.~.~.~.~.~.~.~.~.~.~.~.~.~.~.~.~,~,~,~,~X~,-X~.~.~.~.~.~,~.-.-.-.-,-,~.~.~.~,~X~--
----,-X~.~.~.~.~.~.~.~.~.~.~.~.~.~.~X~.-.-.-.-X-X-.-.-.-.-.-,-,-X-,-,-X-X~.~.~.~.~.~.~.~X~.~.~.~.~.~.~,~,-,-E-,-,-,-,-.~.~.~.~.~.~.~.~.~.~.~.~.~.~.~.~.~.~.~.~.~.~.~.~,~.2.2,2X~,-X~.~.~.~.~.~,~.-.-.-.-,-,~.~,~X~X~----
----,-X~.~.~.~.~.~.~.~.~.~.~.~.~.~.~,~.-.-.-.-.-.-.-.-.-.-,-X-X-,-X-X~.~.~.~.~X~X~.~X~.~.~.~.~.~.~.~.~.~,~,-,-H-,-,-.~.~.~.~.~.~.~.~.~.~.~.~.~.~.~.~.~.~.~.~.~.~.~.~.~,~.2.-,2X~,-X-.~.~.~.~.~,~.-.-.-.8X8X-X-X---------
----,-X~.~.~.~.~.~.~.~.~.~.~.~.~.~.~,~.-.-.-.-.-.-.-.-.-,-X-,-X-X~.~.~.~.~.~.~X~.~.~X~X~.~.~.~.~.~.~.~.~.~,~,-,-,-.~.~.~.~.~.~.~.~.~.~.~.~,~,~,~,~,~,~,~,~,~,~,~,~,~,~,~.2<-,2X~,-X-.~.~.~.~,~X~X8.8.8.-X---------------
----,-X~.~.~.~.~.~.~.~.~.~.~.~.~.~.~,~.-.-.-.-.-.-.-.-,-X-X-X~.~.~.~.~.~.~.~.~X~.~X~X~.~.~.~.~.~.~.~.~.~.~.~,~,-.~.~.~X~X~X~X~X~X~X~X~X~X~X~X-.-.-.-.-.-.-.-.-.-.-.-X-X~XR+RXRX~--,-X~,~X~X~X-,-X-L-L-L-X-,-------------
----,-X~.~.~.~.~.~.~.~.~.~.~.~.~.~.~,~.-.-.-.-.-.-.-.-,-X-.~.~.~.~.~.~.~.~.~.~X~<~X~X~.~.~.~.~.~.~.~.~.~.~.~.~.~.~.~.~X~X-X-X-X-X-X-X-X-X-X-X-,-,-,-,-,-,-,-,-,-,-,-X-X-XR+RXRX-,-,-X~X-------,-X-L-L-L-X-X-------------
----,-X-.~.~.~.~.~.~.~.~.~.~.~.~.~.~,~.-.-,-,-,-,-.-.-,-,~.~.~.~.~.~.~.~.~.~,~X~,~X~X~.~.~.~.~.~.~.~.~.~.~.~.~.~.~.~,~X~X-.-.-.-.-.-.-.-.-.-.-.-.-.-.-.-.-.-.-.-.-.-.-.-.-.-.-.-X-X-,-,-------,-X-.-.-.-.-X-------------
----,-X-.~.~.~.~.~.~.~.~.~.~.~.~.~.~,~.-,-,-.-.-,-,-.-,-,~.~.~.~.~.~.~.~.~.~,~X-,-X-X~.~.~.~.~.~.~.~.~.~.~.~.~.~.~.~,~X-X-.-E-.-.-.-.-.-.-.-.-.-.-.-.-.-.-.-.-.-.-.-.-.-.-.-E-.-.-.-X-X-,-,---,-X-.-.-.-.-X-------------
----,-X-.~.~.~.~.~.~.~.~.~.~.~.~.~.~,~.-,-.-E-.-E-,-.-,-,~.~.~.~.~.~.~.~.~.~,~X-,-X-X~.~.~X~X~X~.~.~.~.~.~.~.~.~.~.~,~.-,-.-.-.-.-.-.-.-.-.-.-.-.-.-.-.-.-.-.-.-.-.-.-.-.-.-.-.-.-.-.-.-X-X-,-,-X-.-.-.-.-X-------------
------,-X~.~.~.~.~.~.~.~.~.~.~,~,~,~,~.-,-.-.-.-.-,-.-,-,~.~.~.~.~.~.~.~.~.~,~X-,-X-X~.~.~X~X~X~X~.~.~.~.~.~.~.~.~.~,~.-,-.-.-H-X-X-X-X-X-X-X-X-X-X-X-X-X-X-.-.-.-X-X-X-.-.-.-.-.-.-.-.-.-.-X-X-.-.-.-.-.-X-------------
------,-X~.~.~.~.~.~.~.~.~.~.~,~.-.-,-.-,-,-E-.-E-,-.-,-,~.~.~.~.~.~.~.~.~.~,~X-,-X-X~.~.~.~H~X~X~.~.~.~.~.~.~.~.~.~,~.-,-.-.-.-X-,-,-,-,-,-,-,-,-,-,-,-,-X-.-.-.-X---,-X-XX.-.-.-.-.-.-.-.-.-.-.-.-.-.-,-X-------------
------,-X~.~.~.~.~.~.~.~.~.~.~,~.-H-,-.-.-,-,-,-,-.-.-,-,~.~.~.~.~.~.~.~.~.~,~X-,-X-X~.~.~X~X~X~X~.~.~.~.~.~.~.~.~.~,~.-,-.-.-.-X-X-X-X-X-X-X-X-X-X-X-X-X-X-.-.-.-X---,-,-XX+X+XXXX-.-.-.-.-.-.-.-.-.-.-X---------------
--------,-X~.~.~.~.~.~.~.~.~.~,~.-A-,-.-.-.-.-.-.-.-.-,-,~.~.~.~.~.~.~.~.~.~,~X-,-X-X~.~.~X~X~X~X~.~.~.~.~.~.~.~.~.~,~.-,-.-.-.-,-,-.-,-,-,-,-.-.-.-.-,-X-X-.-.-,-X---,-X-+X+XXX,-,-X-X-.-.-.-.-.-.-.-,-X---------------
----------,-X~.~.~.~.~.~.~.~.~,~.-A-,-.-.-E-.-E-.-.-E-,-,~.~.~.~.~.~.~.~.~.~,~X-,-X-X~.~.~.~.~.~.~.~.~.~.~.~.~.~.~.~,~X-X-.-.-.-,-,-.-,-,-,-,-.-.-.-A-,-X-.-.-.-X-----,-XX+X+XXXX-X-X-,-X-.-.-.-.-.-A-X-----------------
----------,-,-X~,~.~.~.~.~.~.~,~.-W-,-.-.-.-E-.-.-E-.-,-,-,~,~,~,~,~,~.~.~.~,~X-,-X-X~.~.~.~.~.~.~.~.~.~.~.~.~.~.~.~X~,-X-.-.-.-,-,-.-,-,-,-,-.-.-.-.-,-X-.-.-.-X-----,-X-.-.-.-.-A-X---,-X-.-.-.-X-X-X-----------------
----------,-X-,-X-,~.~.~.~.~.~,~.-A-X-.-.-.-.-E-.-.-.-,-X-X~.-.-.-.-,-.~.~.~X~,-X-.-X-.~.~.~.~.~.~.~.~.~.~.~.~.~,~X~X~,-X-L-L-L-X-X-X-X-X-X-X-X-X-.-.-,-X-.-.-.-X-----,-X-E-.-E-.-E-X---,-X-.-.-.-X---------------------
--------,-,-X-.-E-,~,~.~.~.~.~,~.-.-X-.-.-.-.-.-.-.-.-X-,-,-X-X-X-.-,-.~,~X~X~,-X-.-X-.~.~.~.~.~.~.~.~.~.~.~X~X-X-,-,-,-X-L-L-L-X-,-----------,-X-.-.-,-X-.-.-.-X-----,-X-.-.-.-.-.-X---,-X-.-.-.-X---------------------
--------,-X-.-.-.-E-,~,~.~.~.~,~X1.1X1X-B-.-.-.-.-.-.-X-------,-X-.-X-X-X-,-X-X-X-.-X-X~.~.~.~.~.~.~.~.~.~X~X-X-X-X-X-X-X-.-.-.-X-X-,-,-,-----,-X-.-H-,-X-.-.-.-X-,---,-X-E-.-E-.-E-X---,-X-.-.-.-X---------------------
--------,-X-.-.-.-.-E-,~,~.~.~X~X-.-X-X-.-.-,-,-,-,-,-X-------,-X-.-X-X-X-X-X-.-.-.-X-X-.~.~.~.~.~.~.~.~.~X~X-.-.-.-.-.-.-.-.-.-.-.-X-X-X-,-,-,-X-.-.-,-X-.-.-.-.-X-,-,-X-.-.-.-.-.-X---,-X-.-.-.-X---------------------
--------,-X-.-.-E-.-.-,-X-X~X~X~XQ+QXQX-,-,-,-,-,-,-.-X-------,-X-.-X-X-H-.-A-.-.-.-X-,-X~X~X~,~,~,~,~,~,~X~X-.-.-.-.-.-.-.-.-.-.-.-.-.-.-X-X-,-X-.-.-E-X-.-.-.-.-.-X-,-X-X-X-X-X-X-X---,-X-E-.-.-X---------------------
--------,-X-.-.-.-.-.-.-.-X-X-X-XQ+QXQX-.-,-,-,-.-.-.-,-X---,-,-X-X-X-X-.-.-.-.-.-.-X-,-,-,-,-X-X-.-.-.-X-,-X-.-.-,-,-,-,-,-,-,-,-,-,-.-.-.-X-,-X-.-.-,-,-.-.-.-.-.-.-X-X-,-------------,-X-.-.-.-X-,-,-,-,-,-,-,-,-,---
--------,-X-.-.-.-.-.-.-.-.-.-X-XQ+QXQ,-X-,-.-.-.-,-,-,-X---,-X-X-X-X-X-.-.-X-X-X-X-X-X-X-X-X-X-X-,-,-,-X-X-X-.-.-,-.-.-.-.-.-.-.-.-,-.-.-.-X-,-X-.-.-E-,-.-.-.-.-.-E-.-.-X-,-----------,-X-.-.-.-X-X-X-X-X-X-X-X-X-X---
------,-,-X-.-.-.-.-.-.-.-.-.-X-X-,-X-X-X3.-.-,-,-,-.-,-X-,-,-X-E-A-X-X-H-.-X-,-,-X-X-.-.-.-.-.-.-.-.-.-.-.-.-.-.-,-.-A-.-.-.-.-.-E-,-.-.-.-X-,-X-.-.-E-,-.-.-.-.-.-.-.-.-E-X-,-,-,-,-,-,-X-.-.-.-.-.-X-.-.-.-.-.-.-X---
------,-X-.-E-.-.-.-.-.-.-.-E-X-X-,-X3.3,3,-,-,-.-.-,-,-,-X-X-X-E-E-X-X-X-X-X-X-X-.-.-.-.-.-.-.-.-.-.-.-.-.-.-.-.-,-.-.-.-.-.-.-.-.-,-.-.-.-X-,-X-.-.-,-X-.-.-.-.-.-.-.-.-.-.-X-X-X-X-X-X-.-.-.-.-.-.-X-.-.-.-.-.-A-X---
------,-X-.-.-.-.-.-.-.-.-.-.-X-X-.3,-.3,3,-.-.-.-,-,-,-,-.-X-XY+Y+YXY,-,-X-X-.-.-.-.-.-.-.-.-.-.-.-.-.-.-.-.-.-.-,-.-E-.-X-X-X-.-.-,-.-.-.-X-,-X-.-.-,-X-X-X-,-.-.-.-.-.-.-.-.-.-.-.-.-.-.-.-.-B-.-.-X-.-.-.-.-<-.-X---
------,-X-.-.-.-.-X-X-X-.-.-.-X-X3.-,-,3,3X-.-.-,-,-,-,-,-.-X-XY+Y+YXYX-X-.-.-.-.-.-.-,-X-X-X-X-X-.-.-.-X-X-X-.-.-,-.-.-.-X-X-X-.-.-,-.-E-.-X-,-X-.-.-,-X-X-X-X-.-.-.-.-.-.-.-.-.-.-.-.-.-.-.-.-.-.-.-X-W-.-.-.-.-.-X-,-
------,-X-.-.-.-.-X-,-X-.-.-.-X-,-X-H-,-X3,-X-,-,-,-,-,-.-.-.-.-.-.-.-.-.-.-.-.-.-.-.-X-------,-X-.-.-.-X-,-X-.-.-,-.-.-.-X-X-.-.-.-,-.-.-.-X-,-X-.-A-,-.-,-,-,-.-.-.-.-.-.-.-.-.-.-.-.-.-.-.-.-.-.-.-+-.-.-.-.-<-.-X-X-
------,-X-.-.-.-.-X---,-X-.-.-X-,-X-,-X-----,-X-,-,-,-,-.-.-.-.-.-.-.-.-.-.-.-.-.-.-X-,-------,-X-.-.-.-X-,-X-.-.-,-.-.-.-X-X-.-././,/./././X/,-X-.-.-,-.-,-,-,-.-.-E-.-.-.-.-.-H-.-.-.-.-.-.-.-.-.-.-+-.-.-.-.-.-.-.-X-
------,-X-.-.-.-.-X---,-X-.-.-,-X-,-X---------,-X-X-X-.-.-.-.-.-.-.-.-.-.-.-.-.-.-.-X-,-,-,-,-,-X-.-.-.-X-,-X-.-.-,-.-.-.-.-.-.-././,/.-.-.-X-,-X-.-A-,-.-,-X-X-.-.-.-.-.-.-.-.-.-.-.-.-.-.-.-.-.-.-.-+-.-.-.-.-<-.-X-X-
------,-X-.-.-.-.-X---,-X-.-.-.-X-----------------,-X-X-X-X-X-X-X-X-X-X-.-.-.-.-.-X-X-X-X-X-X-X-XX.-.-.-X-,-X-.-.-,-.-.-E-.-.-.-././,/.-.-.-X-,-X-.-.-,-X-X-X-.-.-.-.-.-.-.-.-.-.-.-.-.-.-.-.-.-.-B-.-X-A-.-.-.-.-.-X---
------,-X-.-.-.-.-X---,-X-.-.-.-,-X-,-,-,-,-,-,-,-,-,-,-,-,-,-,-,-,-,-X-.-.-.-.-.-X-X-E-.-.-E-L-+X.-.-.-X-,-X-.-.-,-.-.-.-.-.-.-././,/.-.-.-X-,-X-.-.-,-X-.-.-.-.-.-.-.-.-.-.-.-.-.-.-.-.-.-.-.-.-.-.-X-.-.-.-.-<-.-X---
------,-X-.-.-.-.-X---,-X-E-E-E-.-X-X-X-X-X-X-X-X-X-X-X-X-X-X-X-X-X-X;X-.-.-.-.-.-X-X-.-.-E-.-L-+X.-.-.-X-,-X-.-E-,-.-.-.-X-X-.-././,/./././X/,-X-.-.-E-X-.-.-.-.-.-.-.-.-,-X-X-X-X-X-X-X-.-.-.-.-.-.-X-.-.-.-.-.-A-X---
------,-X-.-.-.-.-X---,-X-.-.-.-.-.-.-.-.-.-.-.-E-.-E-.-.-<-.-.-.-.-X;X-X-.-.-.-X-X-X-E-.-.-E-L-+X.-.-B-X-,-X-.-.-,-.-.-,-X-X-.-.-.-,-.-.-.-X-,-X-.-.-,-,-.-.-.-.-.-.-.-.-X-----------,-X-.-.-.-.-.-,-X-X-X-X-X-X-X-X---
------,-X-.-.-.-.-X---,-X-.-.-.-.-.-.-.-.-.-.-.-.-.-.-.-.-.-X-X-X-X-X;X-X-L-L-L-X-X-X-L-L-L-X-X-XX.-.-.-X-X-X-.-.-,-.-.-,-X-X-X-.-.-,-.-.-.-X-,-X-.-.-E-,-.-.-.-.-.-E-.-.-X-,-----------,-X-.-.-.-X-X-------------------
------,-X-.-.-.-.-X-----X-.-.-.-.-.-.-.-.-.-.-.-.-.-.-.-.-.-X-------,-X-.-.-.-.-.-X-X-+-+-+-X-,-X-.-.-.-.-.-.-.-.-,-.-.-,-X-X-X-.-.-,-.-.-.-X-,-X-.-.-E-,-.-.-.-.-.-.-.-.-.-X-,-,-------,-X-.-.-.-X---------------------
------,-X-.-.-.-.-X-----,-X-E-.-.-.-.-.-.-.-.-.-.-.-.-.-E-W-X-------,-X-,-,-E-,-,-X-X-.-.-.-X-,-X-.-.-.-.-.-.-.-.-,-.-.-.-.-.-.-.-.-,-.-E-.-X-,-X-.-.-,-X-.-.-.-.-.-.-.-.-.-.-X-X-,-----,-X-E-.-.-X---------------------
------,-X-.-.-.-.-X-----,-X-X-X-.-.-.-.-.-.-.-.-.-.-.-.-.-H-X---------,-X-.-.-.-X-,-X-.-.-.-X-,-X-.-.-.-.-,-,-,-,-A-.-E-.-.-.-.-.-E-,-.-.-.-X-,-X-.-.-,-X-.-.-.-.-.-.-.-.-.-.-.-.-X-,---,-X-.-.-.-X---------------------
------,-X-.-E-.-.-X-,-------,-,-X-X-X-X-X-.-.-,-,-A-B-A-,-,-X---------,-X-,-,-,-X-,-X-.-.-.-X-,-X-.-.-.-.-,-.-.-.-.-.-.-E-,-,-,-,-,-,-.-.-.-X-,-X-.-.-,-X-X-X-X-X-X-.-.-.-.-.-.-.-.-X---,-X-.-.-.-X---------------------
------,-X-.-.-.-.-.-X-----------------,-,-X-X-X-X-.-.-.-.-X-X-,-----,-,-X-,-,-.-X-,-X-.-.-.-X-,-X-.-.-.-.-,-.-.-.-.-<-.-,-.-.-.-.-.-.-.-.-.-X-,-X-.-.-.-X-------,-X-.-.-.-.-.-.-.-.-X---,-X-.-.-.-X---------------------
------,-X-.-.-.-.-.-X-,---------,-,-,-,-X-X-X-X-X-,-,-,-,-X-X-X-----,-X-X-.-,-,-X-,-X-.-.-.-X-,-X-.-.-.-.-,-.-H-.-.-W-.-,-.-.-.-.-.-.-.-.-.-X-,-X-.-.-.-X---------,-X-.-.-.-.-.-.-.-X---,-X-.-.-.-X---------------------
------,-X-.-.-.-.-.-.-X-,-,-,-,-,-X-X-X-.-.-.-.-.-.-.-.-.-.-E-,-X-,-,-X-,-,-.-.-X-,-X-.-.-.-X-,-X-E-.-.-.-,-.-.-X-X-X-.-,-.-.-.-.-.-.-.-.-,-X-,-X-.-.-.-X---------,-X-.-.-.-.-.-.-.-X-,-,-X-.-.-.-X---------------------
------,-X-.-.-.-.-.-.-X-X-X-X-X-X-.-.-.-.-.-.-.-.-.-.-.-.-.-.-.-X-X-X-,-.-,-,-,-X-,-X-.-.-.-X-,-X-X-X-.-.-,-.-A-X-.-X-.-,-.-.-X-X-L-L-L-X-X---,-X-.-A-.-X---------,-X-.-.-.-.-.-.-.-X-X-X-.-.-.-.-X---------------------
--------,-X-.-.-.-.-.-.-.-.-.-.-E-.-.-.-.-.-.-.-.-.-.-.-.-.-.-.-,-.-,-,-.-.-,-X---,-X-.-.-.-X-----,-X-.-.-,-.-.-X-X-X-.-,-.-.-X-X-L-L-L-X-----,-X-,-,-,-X---------,-X-.-.-.-.-.-.-.-.-.-.-.-.-.-.-X---------------------
----------,-X-.-.-.-.-.-.-.-.-.-.-.-.-,-X-X-X-X-.-.-.-.-.-.-.-.-,-.-,-,-,-.-,-X---,-X-.-.-.-X-----,-X-.-.-,-.-.-.-.-.-.-,-.-.-X-.-.-E-.-X-----,-X-.-.-.-X-------,-,-X-.-.-.-.-.-.-.-.-.-.-.-.-.-,-X---------------------
------------,-X-.-.-.-.-.-.-.-.-,-X-X-X-------,-X-.-.-.-.-.-.-.-,-.-.-,-,-,-X-----,-X-.-.-.-X-----,-X-.-.-,-.-A-.-A-.-H-,-.-.-X-.-.-.-.-X-----,-X-,-,-,-X-------,-X-.-.-.-.-.-.-.-.-.-.-.-.-.-.-X-----------------------
--------------,-X-X-X-X-X-X-X-X-X-------------,-X-.-E-.-.-.-.-.-,-.-.-,-,-X-------,-X-.-.-.-X-----,-X-.-.-,-,-,-,-,-,-,-,-.-.-X-.-.-.-.-X-----,-X-,-,-,-X-----,-,-X-.-.-.-.-.-.-.-.-.-.-.-.-,-X-X-----------------------
----------------------------------------------,-X-.-.-.-.-.-.-.-X-X-X-X-X---------,-X-.-.-.-X-----,-X-E-.-.-.-.-.-.-.-.-.-.-.-X-.-.-.-.-X-,---,-X-,-,-,-X-----,-X-.-.-.-.-.-.-.-.-.-.-,-X-X-X---------------------------
----------------------------------------------,-X-.-.-.-.-.-E-.-X-----------------,-X-.-.-.-X-----,-X-.-.-.-.-.-.-.-.-.-.-.-.-X-.-E-.-E-.-X---,-X-,-,-,-X---,-,-X-.-.-.-.-.-.-.-.-,-X-X---------------------------------
----------------------------------------------,-X-.-.-.-.-.-.-.-X-----------------,-X-.-.-.-X-,-,-,-X-,-,-,-,-,-,-,-,-,-,-,-H-X-.-.-.-.-.-X---,-X-,-,-,-X-,-,-X-.-.-.-.-.-.-.-,-X-X-------------------------------------
----------------------------------------------,-X-.-.-.-.-.-.-.-X-----------------,-X-,-,-,-X-,-X-X-X-X-,-,-,-,-,-,-,-,-,-,-X-X-.-.-.-.-.-X---,-X-,-,-,-X-,-X-.-.-.-E-.-.-,-X-X-----------------------------------------
----------------------------------------------,-X-.-.-.-.-.-.-,-X-,-,-,-,-,-,-,-,-,-X-+-+-+-X-X-.-H-.-.-.-.-.-.-.-.-.-H-.-.-,-,-.-.-.-.-.-X-,-,-X-.-.-.-X-,-X-.-.-.-.-E-,-X---------------------------------------------
----------------------------------------------,-X-.-E-.-.-.-.-,-X-X-X-X-X-X-X-X-X-X-X-L-L-L-X-.-.-.-.-.-.-.-.-.-.-.-.-.-.-.-,-,-.-.-.-.-.-X-X-X-.-.-.-.-X-X-.-.-.-.-.-.-X-----------------------------------------------
----------------------------------------------,-X-.-.-.-.-.-.-,-X-.-.-.-.-.-.-,-.-.-,-.-.-.-.-.-.-.-.-.-.-.-.-.-.-.-.-.-.-.-,-,-.-.-.-.-.-.-.-.-.-.-.-.-.-.-.-.-.-.-.-,-X-----------------------------------------------
----------------------------------------------,-X-.-.-.-.-.-E-,-X-.-.-.-.-.-.-,-.-.-,-.-.-.-.-.-.-.-.-.-E-.-E-.-.-.-.-.-E-.-,-,-.-.-.-.-.-.-.-.-.-.-.-.-.-.-.-.-.-.-,-X-------------------------------------------------
--------------------------------------------,-,-X-.-.-.-.-.-.-,-X-.-.-.-.-.-.-,-.-.-,-.-.-.-.-.-.-.-.-.-.-.-.-.-.-.-.-.-.-.-,-,-.-.-.-.-.-.-.-.-.-.-.-.-.-.-.-.-.-,-X---------------------------------------------------
----------------------------------,-,-,-,-,-,-X-.-.-.-.-.-.-.-,-,-.-.-.-.-.-.-,-.-.-,-.-.-.-.-.-.-.-.-.-.-.-.-.-.-.-.-.-E-.-,-,-.-.-.-,-,-,-,-,-,-,-,-,-.-E-.-.-.-X-----------------------------------------------------
--------------------------------,-,-X-X-X-X-X-.-.-.-.-.-.-.-.-,-,-.-.-.-.-.-.-,-.-.-,-.-.-.-.-.-.-.-.-.-.-.-.-.-.-.-.-.-.-.-,-X-.-.-.-,-.-.-.-.-.-.-.-,-,-.-.-.-,-X-----------------------------------------------------
----------------------------,-,-X-X-.-.-.-X-X[.-E-.-.-.-.-.-.-,-,-.-.-.-.-.-.-,-.-.-,-.-.-.-.-.-.-.-.-.-.-.-.-.-.-.-.-.-.-.-,-X-X-X-X-X-X-,-,-,-,-,-,-,-X-X-X-X-X-------------------------------------------------------
----------,-,-,-,-,-,-,-,-,-,-X-.-.-.-.-.-+-+[.-.-.-.-.-.-.-.-,-,-.-.-.-.-.-.-,-.-.-,-.-.-.-.-.-.-.-.-,-,-,-,-.-.-.-.-.-.-.-.-X-------,-X-.-.-.-.-.-.-,-X-,-,-,-,-,-,-,-,-----------------------------------------------
----------,-X-X-X-X-X-X-X-X-X-.-E-.-E-.-E-+-+[.-.-.-.-.-E-.-.-,-,-H-.-.-.-.-.-,-.-.-,-.-.-.-.-.-.-.-.-,-.-.-,-.-.-.-.-.-.-.-.-X-------,-X-.-.-.-.-.-.-,-X-X-X-X-X-X-X-X-X-----------------------------------------------
----------,-X-.-.-.-.-.-H-X-X-.-.-.-.-.-.-+-+[,-,-,-,-,-,-.-.-,-,-.-.-.-.-.-.-,-.-.-,-.-.-.-.-.-.-.-.-,-.-.-,-.-.-.-.-.-.-.-.-X-,-,-,-,-X-.-.-.-.-.-.-,-.-.-.-E-.-.-.-.-X-----------------------------------------------
----------,-X-.-.-.-.-.-.-X-X-.-E-.-H-,-X-X-X[X-.-.-.-.-X-X-X-X-X-.-.-.-.-.-.-,-.-.-,-.-.-.-.-.-.-.-.-,-,-,-,-.-.-.-.-.-.-.-<-X-X-X-X-X-X..-.-.-.-.-.-,-.-.-X-X-X-.-.-<-X-----------------------------------------------
----------,-X-.-.-.-.-.-.-X-X-.-.-.-X-X-,-X-X-X-,-,-,-,-X-X-X-X-X-.-.-.-.-.-.-,-.-.-,-.-.-.-.-.-.-.-.-.-.-.-.-.-.-.-.-.-.-.-.-X-X-.-.-,-...-.-.-.-.-.-,-.-.-X-,-X-.-.-.-X-----------------------------------------------
----------,-X-.-.-.-.-.-.-X-X-.-E-.-X-X-X-.-.-.-.-.-.-.-.-.-.-.-.-.-.-.-.-.-.-,-.-.-,-.-.-.-.-.-.-.-.-.-.-.-.-.-.-.-.-.-.-.-.-X-X-.-.-,-...-.-.-.-.-.-,-.-.-X-,-X-.-K-.-X-----------------------------------------------
----------,-X-.-.-.-.-.-,-X-X-.-.-,-X-.-.-.-.-.-.-.-.-.-.-.-.-.-.-.-.-.-.-.-.-,-.-.-,-.-.-.-.-.-.-.-.-.-.-.-.-.-.-.-.-.-.-.-.-X-X-,-,-,-X.,-,-,-,-,-,-,-.-.-X-,-X-E-.-E-X-----------------------------------------------
----------,-X-.-.-.-.-.-,-X-X-.-E-,-X-H-.-.-.-.-.-.-.-.-.-.-.-.-.-.-.-.-.-.-.-,-.-.-,-.-.-.-.-.-.-.-.-.-.-.-.-.-.-.-.-.-E-.-E-X-X.......X..-.-.-.-.-.-.-.-.-X-,-X-X-X-X-X-----------------------------------------------
----------,-X-.-.-.-E-.-,-.-,-.-.-,-,-.-.-.-.-.-.-.-.-.-.-.-.-.-.-.-.-.-.-.-.-,-.-.-,-.-.-.-.-.-.-.-.-.-.-.-.-.-.-.-.-.-.-.-.-X-X..........-.-.-.-.-.-.-.-E-X-----------------------------------------------------------
----------,-X-.-.-.-E-.-,-.-,-.-E-,-,-.-.-.-.-.-.-.-.-.-.-.-.-.-.-.-.-.-.-.-.-,-.-.-,-.-.-.-.-.-.-.-.-.-.-.-.-.-.-.-H-.-.-,-X-X-X.X.X.X.X.X-X-X-X-X-X-X-X-X-X-----------------------------------------------------------
----------,-X-.-.-.-.-.-,-.-,-.-.-,-,-.-.-.-.-.-.-.-.-.-.-.-.-.-.-.-.-.-.-.-.-,-.-.-,-.-.-.-.-.-.-.-.-.-.-.-.-.-.-.-.-,-X-X---------------------------------------------------------------------------------------------
----------,-X-.-.-.-E-.-,-.-,-.-E-,-,-.-.-.-.-.-.-.-.-.-.-.-.-.-.-.-.-.-.-.-.-,-X-X-X-.-.-.-.-.-.-.-.-.-.-.-.-.-.-,-X-X-------------------------------------------------------------------------------------------------
----------,-X-.-.-.-.-.-,-.-,-.-.-,-,-.-.-.-.-.-.-.-.-.-.-.-.-.-.-.-.-.-.-.-.-.-X-,-X-.-.-.-.-.-.-.-.-.-.-.-.-,-X-X-----------------------------------------------------------------------------------------------------
----------,-X-.-.-.-.-.-,-X-X-.-E-,-X-.-.-.-.-.-.-.-.-.-.-.-.-.-.-.-.-.-.-.-H-,-X-,-X-X-X-X-X-X-X-X-X-X-X-X-X-X---------------------------------------------------------------------------------------------------------
----------,-X-.-H-.-.-.-.-X-X-.-.-E-X-.-.-.-.-.-.-.-.-.-.-.-.-.-.-.-.-.-.-.-.-X-----------------------------------------------------------------------------------------------------------------------------------------
----------,-X-.-.-.-.-.-.-X-X-X-+-X-X-.-.-.-.-.-.-.-E-.-E-.-.-.-.-.-.-.-.-.-,-X-----------------------------------------------------------------------------------------------------------------------------------------
----------,-X-.-.-.-.-.-,-X-X-X-.-X-X-.-.-.-.-.-.-.-.-.-.-.-.-.-.-.-.-.-.-,-X-------------------------------------------------------------------------------------------------------------------------------------------
----------,-X-.-.-.-E-.-,-X-X-.-E-,-X-.-.-.-.-.-.-.-.-.-.-.-.-.-.-.-.-.-,-X---------------------------------------------------------------------------------------------------------------------------------------------
----------,-X-.-.-.-.-.-,-.-,-.-.-,-,-.-.-.-.-.-.-.-.-.-.-.-.-.-.-.-.-.-X-----------------------------------------------------------------------------------------------------------------------------------------------
----------,-X-.-.-.-E-.-,-.-,-.-E-,-,-.-.-.-.-.-.-.-.-.-.-.-.-.-.-.-.-,-X-----------------------------------------------------------------------------------------------------------------------------------------------
----------,-X-.-.-.-.-.-,-.-,-.-.-,-,-.-.-.-.-.-.-.-.-.-.-.-.-.-.-.-,-X-------------------------------------------------------------------------------------------------------------------------------------------------
----------,-X-.-.-.-E-.-,-.-,-.-E-,-,-.-.-.-.-.-.-.-.-.-.-.-.-.-.-.-X---------------------------------------------------------------------------------------------------------------------------------------------------
----------,-X-.-.-.-.-.-,-,-,-.-.-<-,-.-.-.-.-.-.-.-.-.-.-.-.-.-.-,-X---------------------------------------------------------------------------------------------------------------------------------------------------
----------,-X-.-.-.-.-.-,-X-X-.-.-.-X-.-.-.-.-.-.-.-.-.-.-.-.-.-,-X-----------------------------------------------------------------------------------------------------------------------------------------------------
----------,-X-.-.-.-.-.-.-X-X->->->-X-.-.-.-.-.-.-.-.-.-.-.-.-.-X-------------------------------------------------------------------------------------------------------------------------------------------------------
----------,-X-.-.-.-.-.-.-X-X-X-X-X-X-.-.-.-.-.-.-.-.-.-.-.-.-,-X-------------------------------------------------------------------------------------------------------------------------------------------------------
----------,-X-.-.-.-.-.-.-.-.-.-.-.-.-.-.-.-.-.-.-.-.-.-.-.-,-X---------------------------------------------------------------------------------------------------------------------------------------------------------
------------,-X-.-.-.-.-.-.-.-.-.-.-.-.-.-.-.-.-.-.-.-.-.-,-X-----------------------------------------------------------------------------------------------------------------------------------------------------------
------------,-X-.-.-.-.-.-.-.-.-.-.-.-.-.-.-.-.-.-.-.-.-.-X-------------------------------------------------------------------------------------------------------------------------------------------------------------
--------------,-X-.-.-.-.-.-.-.-.-.-.-.-.-.-.-.-.-.-.-.-,-X-------------------------------------------------------------------------------------------------------------------------------------------------------------
--------------,-X-.-.-.-.-.-.-.-.-.-.-.-.-.-.-.-.-.-.-,-X---------------------------------------------------------------------------------------------------------------------------------------------------------------
----------------,-X-.-.-.-.-.-.-.-.-.-.-.-.-.-.-.-.-.-X-----------------------------------------------------------------------------------------------------------------------------------------------------------------
----------------,-X-.-.-.-.-.-.-.-.-.-.-.-.-.-.-.-.-,-X-----------------------------------------------------------------------------------------------------------------------------------------------------------------
------------------,-X-X-X-X-X-X-X-X-X-X-X-X-X-X-X-X-X-------------------------------------------------------------------------------------------------------------------------------------------------------------------
