----------------------------------------------------------------------------------------------------------------------------------------------------,-,-,-X-X-X-X-X-X-X-X-X-XWX-X-,-,-,-,-----------------------------------------------------------------------------------------
--------------------------------------------------------------------------------------------------------------------------------------------------,-,-X-X-,-:-.-.-.-.-.-.-.-.-.-A-X-X-X-X-----------------------------------------------------------------------------------------
----------------------------------------------------------------------------------------------------------------------------------------------,-,-,-X-.-.-.-,-.-.-.-.-.-.-K-.-E-.-E-H-E-X-----------------------------------------------------------------------------------------
--------------------------------------------------------------------------------------------------------------------------------------------,-,-X-X-.-.-.-.-,-,-.-.-.-.-.-.-.-.-A-,-X-X-X-----------------------------------------------------------------------------------------
------------------------------------------------------------------------------------------------------------------------------------------,-,-X-.-.-.-.-.-.-,-X-X-X-X-X-X-X-XWX-X-X-----------------------------------------------------------------------------------------------
--------------------------------------------------------------------------------------------------------------------------------------,-,-,-X-.-.-.-.-.-.-,-X---------------------------------------------------------------------------------------------------------------------
------------------------------------------------------------------------------------------------------------------------------------,-,-X-X-.-.-.-.-.-:-,-X-----------------------------------------------------------------------------------------------------------------------
--------------------------------------------------------------------------------------------------------------------------------,-,-,-X-.-.-:-.-.-.-.-,-X-------------------------------------------------------------------------------------------------------------------------
------------------------------------------------------------------------------------------------------------------------------,-,-X-X-.-.-.-.-.-.-.-,-X---------------------------------------------------------------------------------------------------------------------------
------------------------------------------------------------------------------------------------------------------------------,-X-.-.-.-.-.-.-.-.-,-X-----------------------------------------------------------------------------------------------------------------------------
----------------------------------------------------------------------------------------------------------------------------,-,-X-,-,-.-.-.-.-.-,-X-----------------------------------------,-,-,-,-,-,-,-------------------------------------------------------------------------
----------------------------------------------------------------------------------------------------------------------------,-X-.-.-,-,-.-.-:-,-X---------------------------,-,-,-,-,-,-,-,-,-X-X-X-X-X-X-,-,-,-------------------------------------------------------------------
--------------------------------------------------------------------------------------------------------------------------,-,-X-.-.-.-,-,-,-,-X---------------------,-,-,-,-,-X-X-X-X-X-X-X-X-.-.-.-,-.-.-X-X-X-,-,---------------------------------------------------------------
--------------------------------------------------------------------------------------------------------------------------,-X-.-.-.-.-.-.-,-X-----------------------,-X-X-X-X-.-.-.-.-.-.-.-.-E-.-E-,-.-.-.-.-.-X-X-,-,-,---------------------------------------------------------
------------------------------------------------------------------------------------------------------------------------,-,-X-.-.-.-.-.-.-.-X-----------------------,-X-,-,-.-E-.-E-.-E-.-E-.-E-.-,-,-.-.-.-.-.-.-.-X-X-X-,-,-,---------------------------------------------------
------------------------------------------------------------------------------------------------------------------------,-X-,-,-,-.-:-.-.-.-X-----------------------X-,-,-,-.-.-.-.-.-.-.-.-.-.-.-,-.-.-.-.-.-.-.-.-.-H->->->-X-,-,-----------------------------------------------
------------------------------------------------------------------------------------------------------------------------,-X-.-.-,-,-,-,-,-.-X---------------------X-----,-,-,-.-.-.-.-E-.-E-.-E-.-E-.-.-.-.-.-.-.-.-.-,->-.->-.-X-X-----------------------------------------------
------------------------------------------------------------------------------------------------------------------------,-X-,-,-.-.-.-.-,-.-X-------------------X---------,-,-,-.-.-.-.-.-.-.-.-.-,-,-.-.-.-.-.-.-.-.-,->->->-.-X-------------------------------------------------
----------------------------------------------------------------------------------------------------------------------,-,-X-.-E-,-,-,-.-,-.-X-----------------X-----------,-,-,-,-.-.-E-,-X-X-X-X-.-X-X-X-X-X-X-X-.-.-H-.-H-.-H-X-------------------------------------------------
----------------------------------------------------------------------------------------------------------------------,-X-A-.-H-,7E-,-.-,-.-X---------------X---------------,-,-X-X-X-X-X-----,-X-L-X-----------,-X-X-X-X-X-X-X---------------------------------------------------
----------------------------------------------------------------------------------------------------------------------,-X-A-.-A-,7,-,-.-,-.-X-----------X-X-------------------,-X-------------,-X-.-X-----------------------------------------------------------------------------
--------------------------------------------------------------------------------------------------------------------,-,-X-.-.-,-,7.-,-.-,-.-X---------X-----------------------X---------------,-X-X-X-----------------------------------------------------------------------------
--------------------------------------------------------------------------------------------------------------------,-X-,-H-H-,-,-,-E-.-,-.-X-------X-------------------------X---------------------------------------------------------------------------------------------------
--------------------------------------------------------------------------------------------------------------------,-X-,-,-,-,-,-,-,-,-,-.-X-----X-------------------------X-----------------------------------------------------------------------------------------------------
--------------------------------------------------------------------------------------------------------------------,-X-.-.-.-.-.-.-.-.-.-.-X---X-------------------------X-------------------------------------------------------------------------------------------------------
------------------------------------------------------------------------------------------------------------------,-,-X-,-,-,-,-,-,-,-.-.-.-X-X---------------------------X-------------------------------------------------------------------------------------------------------
------------------------------------------------------------------------------------------------------------,-,-,-,-X-X-.-.-.-.-.-.-X-.-.-.-X-,-------------------------X-----------------------------------------,-,-,-,-,-,-,-,-,-----------------------------------------------
------------------------------------------------------------------------------------------------------,-,-,-,-X-X-X-,-.-.-.-.-.-.-X-X-.-.-.-.-,-,---------------------X-------------------------------------,-,-,-,-X-X-X-X-X-X-X-X-,---------------------------------------------
------------------------------------------------------------------------------------------------,-,-,-,-X-X-X-.-.-.-,-.-.-.-.-.-.-X-,-X-.-.-.-.-,-,-------------------X---------------,-,-,-,-,-,-,-,-,-,-,-,-X-X-X2.-.-.-.-.-.-.-.-X-,-,-----------------------------------------
--------------------------------------------------------------------------------------------,-,-,-X-X-X-.-.-.-.-.-.-,-.-.-.-.-.-.-.-X-,-,-.-.-.-.-,-,-,-------------X-----------,-,-,-,-X-X-X-X-X-X-X-X-X-X-X-.-.-X-E2,2,-,-.-.-.-.-.-X-X-,---------------------------------------
----------------------------------------------------------------------------------------,-,-,-X-X-,-.-.-.-.-.-.-.-.-,-.-.-.-.-.-.-.-X-,-X-,-.-.-.-.-.-,-,-----------X-----,-,-,-,-X-X-X-,-X-.-E-.-.-.-X-.-.-.-.-.-X---,-X2X-X-.-.-.-.-E-.-X-,-------------------------------------
------------------------------------------------------------------------------------,-,-,-X-X-.-.-,-X-X-X-X-X-.-.-.-,-X-X-.-.-.-.-X-X-X-X-,-,-.-.-.-.-.-,-,-------X---,-,-,-X-X-X-.-.-.-,-X-.-.-.-.-.-X-.-E-X-X-.-X-,-,-.-E-X-.-E-.-.-.-.-.-X-,-,---------------------------------
--------------------------------------------------------------------------------,-,-,-X-X-.-.-.-.-,-X-,-,-X-X-.-.-.-.-X-X-.-.-.-.-.-X-X-.-.-,-,-.-.-.-.-.-,-,---X-,-,-,-X-X-.-.-.-.-.-.-,-X-.-.-X-.-.-X-.-.-X-X-.-X-X-X-.-.-X-X-.-.-.-.-.-.-.-X-X-,---------------,-,-------------
----------------------------------------------------------------------------,-,-,-X-X-.-.-.-.-.-.-X-,-X-X-.-.-.-.-.-.-X-X-.-.-:-.-.-.-.-X-X-X-X-.-.-.-.-.-.-,-,-X-X-X-X-,-,-.-.-.-.-E-.-,-X-.-.-X-.-.-X-.-.-X-X-E-.-.-.-.-.-.-X-.-.-.-.-.-.-.-.-.-X3,-,-------,-,-,-X-,-,---------
--,-,-,-----------------------------------------------------------------,-,-,-X-X-.-.-.-.-.-.-.-,-X-X-.-.-.-.-.-.-A-,-X-X-X-X-X-.-.-.-+-.-X-X-X-.-.-.-.-.-.-,-X-X-.-.-.-,-,5,-,-.-.-.-.-,-.-.-.-X-.-E-.-.-.-X-X-.-,-X-X-XR+R+RXRX-X-.-.-.-.-.-.-.-.-X3XS,---,-,-X-X-.-X-X-,-,-----
--,-X-X-,-,-,-------------------------------------------------------,-,-,-X-X-.-.-.-.-.-.-.-.-,-X-,-X-H-.-.-.-.-,-X-X-,-X-X-X-X-.-.-.-X-.-.-X-,-X-.-.-.-.-.-.-,-.-.-.-,-,-.5.5,5,-.-.-.-,-.-.-.-X-.-.-,-X-X-X-X-X-X---,-XR.-E-.-X-,-X-X-.-.-.-.-.-.-.-+SXS,-,-X-.-.-.-.-.-X-X-,---
--,-X-.-X-X-X-,-,-,-,-----------------------------------------,-,-,-,-X-X-.-.-.-.-.-.-.-.-.-,-,-X-X-H-.-E-.-.-,-X-,-,-X-.-.-.-.-.-.-.-X-.-W-X-,-X-.-.-X-X-X-X-,-,-.-.-,-.5.-.-.-,5.-.-.-,-X-X-X-X-X-X-X---------------,-X-E-A-E-X-----,-X-X-.-.-.-.-+S+S.-X-XT.-.-.-.-.-.-.-.-X---
,-,-X-.-.-.-<-X-X-X-X-,-,-,-----------------------------,-,-,-,-X-X-X-.-<-.-.-.-.-.-.-.-.-,-,-.-.-X-X-.-.-.-,-X---,-X-.-:-.-A-X-.-.-.-X-X-X-X-X-.-.-.-X-.-.-X-.-,-.-.-,-.5.-.-,-,5.-.-,-X-----------------------------,-X-X-X-X-X---------,-X-X4X4.-+S.-.-.-.-.-.-.-.-.-E-.-.-X-,-
,-X-.-.-.-.-.-.-.-.-.-X-X-X-,-,-,-------------------,-,-,-X-X-X-.-,-.-.-.-.-.-.-.-.-A-,-,-,-.-.-.-X---X-.-X-X-,-,---,-X-.-.-H-X-.-.-.-X-,-,-X-.-.-.-.-X-.-.-X-.-,-,-.-,-.5.-.-,5.-,-X-X---------------------------------------------------------,-X4XSX-.-+T.-.-.-.-.-.-.-.-.-.-X-
,-X-.-H-.-.-:-.-.-.-.-.-.-.-X-X-X-,-,-,-,-----,-,-,-,-X-X-.-.-.-.-,-.-.-.-.-.-.-.-.-,-,-.-.-.-.-.-.-X-,-X-X-X-X-X-----,-X-X-X-X-.-.-.-.-X-X-X-.-.-.-.-X-.-.-X-.-.-,-.-,-,5,5,5,5,-X-------------------------------------------------------------------,-XT+T.-.-.-.-E-.-.-.-H-,-X-
,-X-.-.-.-.-.-.-.-.-.-.-.-.-.-.-.-X-X-X-X-,-,-,-X-X-X-.-.-.-.-.-,-X-X-X-X-X-.-.-.-,-,-.-.-.-.-.-.-.-X-X-X-.-.-.-X-------,-,-X-.-.-.-.-.-.-X-X-.-.-.-.-X-.-.-.-X-.-,-,-.-.-.-.-,-X---------------------------------------------------------------------,-,-XT.-.-.-.-.-.-.-.-.-X---
,-X-.-.-.-.-.-.-.-.-.-.-.-.-.-.-.-.-.-.-.-X-X-X-.-.-.-.-.-.-.-,-X-,-X-X-.-.-.-.-,-,-.-.-.-:-.-.-.-.-.-.-.-.-E-.-X-----,-,-X-.-.-E-.-.-.-,-X-X-X-.-.-.-.-X-X-.-X-.-.-,-.-.-,-X-X-----------------------------------------------------------------------,-X-.-.-.-.-.-.-.-W-.-A-X---
X-.-.-.-.-.-.-.-X-X-X-X-X-X-.-.-.-.-.-.-.-,-.-.-.-.-.-.-.-.-,-X-,-X-.-E-.-.-.-.-,-X-.-.-.-.-.-.-.-.-.-.-.-.-.-A-X-,---,-X-H-.-.-.-.-.-.-X-----,-X-X-.-.-.-.-X-X-.-.-,-,-,-X-,-,-,-,-,-,-,-,-,-,-,-,-,-,-,---------------------------------------------,-X-.-.-.-.-.-.-.-.-.-X-----
X-.-.-.-.-.-.-X-.-.-.-.-.-.-X-X-.-E-.-.-.-,-.-.-.-.-.-H-.-,-X-,-,-X-.-.-.-E-.-.-X-,-X-.-.-.-.-.-.-.-.-.-.-.-.-X-,-X-,---,-X-.-.-E-.-.-.-X-----,-,-X-.-.-.-.-.-.-.-.-.-,-X-X-X-X-X-X-X-X-X-X-X-X-X-X-X-X1X-,-,-------------------------------------------,-X-.-.-.-.-E-.-H-,-X-----
X-.-.-.-.-.-X-.-.-.-.-.-.-.-.-X-.-.-.-.-.-,-.-.-.-.-.-,-X-X---,-X-.-.-.-.-.-.-,-X-,-,-X-.-.-.-.-.-.-.-.-,-X-X-X-X-.-X-,---,-X-.-.-.-.-.-X-,-,-,-X-X-.-.-.-.-.-.-.-.-.-.-X-X-E-X-X-E-X-E-X-E-X-E-X-X-X-.1.-X-X-,-,---------------------------------------,-X-.-.-.-.-.-,-X-X-------
,-X-.-.-.-.-X-.-.-.-.-X-X-X-.-.-X-.-.-.-.-,-.-.-.-.-,-X---------,-X-.-.-,-X-X-X-,-X-X-.-.-.-.-.-.-.-.-.-X-,-X-.-E-.-.-X-,-,-X-.-E-.-.-.-X-X-X-X-.-.-.-.-.-XU.-.-.-.-.-.-,-X-X-X-X-,-X-,-X-,-X-,-X-X-X-.1H-.-.-X-X-,-,-------------------------------------,-X-.-,-X-X-X-----------
,-X-.-.-.-.-X-.-.-.-X-.-.-X-.-.-X-.-.-.-.-,-.-.-.-,-X-----,-,-----,-X-X-X-,-,-X-X-.-.-.-.-.-.-.-.-.-.-.-.-X-.-X-X-.-.-X-,-.-X-.-.-.-.-.-.-.-.-,-.-.-.-.-X-XU+U+U.-.-.-.-,-XQXQ.-,-,-.-.-.-.-.-.-.-,-.1.-.-.-.-.-.-X-X-,-,-,-------------------------------,-X-X-X-----------------
,-X-.-.-.-.-X-.-.-.-X-H-.-X-.-.-.-X-.-.-.-,-.-.-.-X-----,-,-X-,-----,-,-,-X-X-.-.-.-.-.-.-X-X-.-.-.-.-.-.-.-.-X-X-X-W-X-,-X-H-.-X-X-X-.-.-.-,-,-H-.-.-.-X-X-.-.-.-XU.-.-,-+Q+Q.-,-,-,-,-.-.-.-.-.-,-.1.-.-.-,-,-.-.-.-X-X-X-,-,---------------------------------------------------
--,-X-.-.-.-X-.-.-X-.-E-.-X-.-.-.-X-.-.-.-,-.-.-.-X---,-,-X-.-X-,-,-,-X-X-.-E-.-.-.-.-.-.-X-X-X-X-X-.-.-.-.-.-X-X-X-X-X-,-X-X-X-X-X-X-.-.-.-,-.-.-.-.-X-.-X-E-.-E-X-.-.-,-+Q+Q,-,-.-,-,-.-.-.-.-.-,-X1.-.-,-,-,-,-.-,-,-.-.-X-X-,-,-----------------------------------------------
--,-X-.-.-.-X-X-X-.-.-.-A-X-.-.-.-X-.-.-.-,-X-.-.-X-,-,-X-.-.-E-X-,-X-.-A-.-.-.-.-.-.-.-.-.-.-X-X-X-X-X-.-.-.-.-.-.-X-X-X-X-X-.-.-.-.-.-.-,-X-X-X-.-.-.-X-X-X-X-X-X-.-.-,-+Q+Q,-,-.-,-.-.-.-.-.-.-X-X-.-E-,-,-,-,-,-,-,-.-.-.-.-X-X-,-,-------------------------------------------
--,-X-.-.-.-.-.-.-.-.-.-.-X-.-.-X-.-.-.-,-X-X-.-.-X-X-X-.-H-.-X---,-X-.-.-.-E-.-.-.-.-.-.-.-.-.-.-.-X-X-.-.-.-.-.-.-.-.-,-.-.-.-<-.-.-.-,-X---,-X-.-.-.-X-.-.-X-X-X-.-.-,-+Q+Q.-,-,-,-.-.-.-,-X-X-X-X-X-.-.-,-,-.-,-,-,-.-.-.-.-.-,-X-X-,-----------------------------------------
----,-X-.-.-.-.-.-.-.-.-X-.-.-.-X-.-.-,-X---,-X-.-.-.-.-.-.-,-X---,-X-A-.-,-X-X-X-X-.-.-.-.-.-.-.-.-.-.-.-.-.-.-.-.-.-,-X-.-.-.-.-.-.-.-X-------,-X-.-.-.-X-X-.-.-.-.-.-,-+Q+Q.-,-X-X-X-X-X-X---------,-X-X-X-X-,-,-,-.-.-.-.-.-,-E-.-.-X-----------------------------------------
----,-X-.-.-.-X-X-.-.-X-.-.-.-X-.-,-,-X-----,-X-.-.-.-.-.-.-X-----,-X-X-X-X-,-,-,-,-X-X-X-.-.-.-.-.-.-.-.-.-.-.-.-.-,-X-,-X-.-.-.-.-.-.-X-,-----,-X-.-.-.-.-.-.-.-.-.-,-X-XQXQX-X-----------------------------,-X-X-X-X-E-.-.-,-,-.-.-.-X-,---------------------------------------
----,-X-.-.-.-X-.-X-X-.-.-.-.-X-,-,-X-,-------,-X-.-.-X-X-X-X-----------,-,-,-X-X-X-,-,-,-X-X-,-,-,-X-X-X-.-.-.-.-.-X-,---,-X-,-,-,-,-,-X-X-,-,-X-X-,-.-.-.-.-.-.-,-X-X-----------------------------------------------,-X-X-,-,-.-.-.-E-.-X---------------------------------------
------,-X-.-.-X-X-.-.-.-X-X-X-,-,-.-.-X-,-,-,-,-X-.-.-X-,-----,-,---,-,-,-X-X-.-.-.-X-X-X-,-X-.-.-.-X-,-X-.-.-.-.-.-.-X-,-,-X-.-.-.-.-.-.-.-X-X-.-.-,-,-.-.-.-,-X-X-------------------------------------------------------,-X-X-.-.-E-E-.-X-,-------------------------------------
------,-X-.-.-.-.-X-X-X-.-.-W-,-.-.-.-.-X-X-,-X-X-.-H-X-X-,-,-,-X-,-,-X-X-.-.-.-H-.-.-.-X-,-X-.-H-.-X-,-X-E-H-.-.-E-.-,-X-,-X-.-.-.-.-.-.-.-,-.-.-.-.-,-,-,-X-X---------------------------------------------------------------,-X-.-.-.-.-.-X-,-----------------------------------
------,-X-.-.-.-.-.-.-A-.-,-,-.-.-.-.-E-.-.-X-.-.-.-.-.-.-X-X-X-A-X-X-X-E-.-.-.-.-.-.-E-X-,-X-.-.-.-X-,-X-.-.-.-.-.-.-X---,-X-.-.-.-.-.-.-.-,-.-H-.-,-X-X-X-------------------------------------------------------------------,-X-.-.-,-,-,-.-X-----------------------------------
--------,-X-.-.-.-.-.-E-.-,-X-.-.-.-.-.-.-.-.-.-.-.-.-.-.-.-.-.-.-,-X-X-.-.-.-.-.-.-.-.-X-,-X-.-:-.-X-,-X-.-.-E-.-H-,-X-,-,-X-.-.-.-.-.-.-.-,-.-,-X-X---------------------------------------------------------------------------,-X-.-,-.-,-,-X-,---------------------------------
--------,-X-.-.-.-.-.-.-,-X-,-X-X-.-.-.-E-.-.-.-.-.-.-.-.-.-.-.-.-X-,-X-,-,-,-X-X-X-.-.-X-,-X-.-.-.-X-,-,-X-.-.-,-X-X-,-,-X-.-.-.-:-.-.-.-,-X-X-X---------------------------------------------------------------------------------,-X-,-,-.-,-,-X-,-------------------------------
--------,-X-.-.-.-.-.-,-X-------,-X-.-.-.-.-.-.-.-,-X-X-X-X-.-.-.-X-X-X-.-X-X---,-,-X-.-X-,-X-.-.-.-X-,-,-,-X-X-X---,-,-X-,-.-.-.-.-.-,-X-X---------------------------------------------------------------------------------------,-X-.-,-,-,-.-.-X-------------------------------
----------,-X-.-.-.-,-X---------,-X-.-.-.-.-.-,-X-X-------,-X-X-X-.-.-.-.-.-X---,-,-X-.-X-X-X-.-.-.-.-X-X-,-,-,-,-,-,-X-.-,-.-.-.-,-X-X---------------------------------------------------------------------------------------------,-X-.-.-.-.-.-X-,-----------------------------
----------,-X-.-.-.-X---------,-,-,-X-.-.-.-.-X---------------,-X-.-.-.-.-.-X-,-,-X-X-.-.-.-.-.-.-.-.-.-.-X-X-X-X-X-X-.-.-,-.-,-X-X---------------------------------------------------------------------------------------------------,-X-.-H-.-.-.-X-----------------------------
----------,-X-.-.-.-X---------,-X-X-X-.-.-.-.-X-------------,-,-X-.-.-.-.-.-.-X-X-.-.-.-.-:-.-.-.-.-.-.-.-.-.-.-.-.-.-.-.-,-X-X-------------------------------------------------------------------------------------------------------,-X-.-.-.-.-.-X-,---------------------------
------------,-X-.-.-X-------,-,-X-,-.-.-.-.-.-X---------,-,-,-X-X-.-.-.-.-.-.-,-.-.-.-.-.-.-.-.-.-.-.-.-.-.-.-.-.-.-.-.-.-.-.-X-,-,-----------------------------------------------------------------------------------------------------,-X-.-.-.-H-.-XQ--------------------------
------------,-X-.-.-X-------,-X-.-,-.-E-.-E-,-X-,-----,-,-X-X-,-.-.-.-.-.-.-.-,-.-.-.-.-.-.-.-.-.-.-.-.-.-.-.-.-.-.-.-.-.-.-.-.-X-X-,-----------------------------------------------------------------------------------------------------,-X-.-.-.-+QXQ--------------------------
------------,-X-.-.-X-----,-,-X-.-,-.-.-.-,-,-.-X-----,-X-.-.-,-.-.-.-.-.-.-.-,-.-.-.-.-.-.-.-.-,-,-,-.-.-.-.-.-.-.-.-.-.-.-.-.-.-.-X-,---------------------------------------------------------------------------------------------------,-X-.-+Q+Q+QX-,-------------------------
--------------,-X-.-X-----,-X-.-.-,-X-X-X-X-.-.-X-,---,-X-.-.-,-.-.-.-.-.-.-.-,-.-.-.-.-.-.-.-,-,-.-,-,-,-.-.-,-,-.-.-.-.-.-.-.-.-.-.-X-,-,-------------------------------------------------------------------------------------------------,-XQ+Q+Q.-A-X-------------------------
--------------,-X-.-X-,-,-,-X-.-.-,-X---,-X-.-.-.-X-,-,-X-.-.-,-X-X-X-X-X-X-X-X-X-.-.-.-<-.-.-,-,-.-.-,-,-.-.-,-,-,-.-.-.-A-.-.-.-.-.-.-X-,-,-------------------------------------------------------------------------------------------------,-XQ.-W-E-X-,-----------------------
--------------,-X-.-.-X-X-X-.-.-.-X-----,-X-.-.-.-.-X-,-X-.-.-.-X---------------,-X-X-.-.-.-.-.-,-,-,-,-.-.-.-,-.-,-,-.-,-,-,-,-.-.-.-.-.-X-X-,-------------------------------,-,---,-,-,-------------------------------------------------------,-X-X-.-A-X-----------------------
----------------,-X-.-.-.-X-.-.-.-X-------,-X-.-.-.-.-X-X-.-.-.-X-------------------,-X-X-.-.-.-.-,-,-.-.-.-.-,-.-.-,-,-,-.-.-,-,-.-.-.-.-.-.-X-,-----------------------,-,-,-X-X-,-X-X-X-----------------------------------------------------------,-X-,-X-----------------------
----------------,-X-.-.-.-.-.-.-.-X-,---,-,-X-.-H-.-.-X-X-.-.-.-X-----------------------,-X-X-.-.-.-.-.-.-.-.-,-,-.-.-,-,-.-.-.-,-,-.-.-.-.-.-.-X-,-,-------------,-,-,-,-X-X-,-X-X-.-,-X-,-----------------------------------------------------------,-X-------------------------
----------------,-X-.-.-.-.-.-.-.-.-X-,-,-X-.-.-.-.-.-.-X-.-.-.-X---------------------------,-X-X-.-.-.-.-.-.-.-,-.-.-.-.-.-.-.-.-,-,-.-.-E-.-.-.-X-X-,---,-,-,-,-X-X-X-X-.-,-,~.-,-.-,-.-X---------------------------------------------------------------------------------------
------------------,-X-.-.-.-.-.-.-.-X-X-X-.-.-.-.-.-.-.-.-.-.-.-X-------------------------------,-X-X-.-.-.-.-.-,-,-.-.-.-.-.-.-.-,-,-.-.-.-.-.-.-.-.-X-,-,-X-X-X-.-.-.-.-.-.-.-E-,-.-,-.-X-,-------------------------------------------------------------------------------------
------------------,-X-.-.-.-.-.-.-.-.-.-.-.-.-.-.-.-.-.-.-.-.-.-X-----------------------------------,-X-X-X-.-.-.-,-.-.-.-.-.-.-,-,-.-.-.-.-.-.-.-.-.-,-X-X-.-.-.-.-.-.-E-.-.-.-.-,-.-,-.-.-X-------------------------------------------------------------------------------------
------------------,-X-.-.-.-.-.-.-.-.-.-.-.-.-.-.-.-.-.-.-.-.-,-X-----------------------------------------,-X-X-.-,-,-.-.-.-.-,-,-.-.-.-.-.-.-.-.-.-.-,-.-.-.-.-.-.-.-.-.-.-.-.-E-,-.-,-W-,-X-------------------------------------------------------------------------------------
--------------------,-X-.-.-.-.-.-.-.-.-.-.-.-.-.-.-.-.-.-.-,-X-----------------------------------------------,-X-X-,-,-,-,-,-,-.-.-.-.-.-.-.-.-.-.-.-,-.-.-.-.-.-.-.-.-E-.-E-.-.-,-,-,-X-X---------------------------------------------------------------------------------------
--------------------,-X-.-.-.-.-.-.-.-.-.-.-.-.-.-.-.-.-.-.-X-----------------------------------------------------,-X-X-.-.-.-.-.-.-.-.-.-.-.-.-.-.-.-,-.-.-.-.-.-.-.-.-.-.-.-.-.-,-X-X-------------------------------------------------------------------------------------------
--------------------,-X-.-.-.-.-.-.-.-.-.-.-.-.-.-.-.-.-.-,-X---------------------------------------------------------,-X-X-.-.-.-.-.-.-.-.-.-.-.-E-.-,-.-.-.-.-.-.-.-.-.-.-E-,-X-X-----------------------------------------------------------------------------------------------
----------------------,-X-.-.-.-.-.-.-.-.-.-.-.-.-.-.-E-,-X---------------------------------------------------------------,-X-X-X-.-.-.-.-.-.-.-.-.-.-,-.-.-.-.-.-.-.-.-.-,-X-X---------------------------------------------------------------------------------------------------
----------------------,-X-X-X-.-.-.-.-.-.-.-.-,-X-X-X-X-X-----------------------------------------------------------------------,-X-X-.-.-.-.-.-.-.-.-,-.-.-.-.-.-.-.-.-,-X-------------------------------------------------------------------------------------------------------
----------------------------,-X-.-.-.-.-.-.-.-X-------------------------------------------------------------------------------------,-X-X-.-.-.-.-.-.-,-.-.-A-.-.-.-,-X-X---------------------------------------------------------------------------------------------------------
----------------------------,-X-.-.-<-.-.-.-,-X-----------------------------------------------------------------------------------------,-X-X-.-.-.-.-,-.-.-.-.-,-X-X-------------------------------------------------------------------------------------------------------------
------------------------------,-X-.-.-.-<-.-X-----------------------------------------------------------------------------------------------,-X-X-.-.-,-.-.-,-X-X-----------------------------------------------------------------------------------------------------------------
------------------------------,-X-.-<-.-<-,-X---------------------------------------------------------------------------------------------------,-X-X-,-,-X-X---------------------------------------------------------------------------------------------------------------------
--------------------------------,-X-.-:-.-X---------------------------------------------------------------------------------------------------------,-X-X-------------------------------------------------------------------------------------------------------------------------
--------------------------------,-X-,-<-,-X-,-,-----------------------------------------------------------------------------------------------------------------------------------------------------------------------------------------------------------------------------------
----------------------------------,-X-,-X-,-,-X-,---------------------------------------------------------------------------------------------------------------------------------------------------------------------------------------------------------------------------------
----------------------------------,-X-,-X-,-X-,-X---------------------------------------------------------------------------------------------------------------------------------------------------------------------------------------------------------------------------------
----------------------------------,-X-X-X-X-X-X-----------------------------------------------------------------------------------------------------------------------------------------------------------------------------------------------------------------------------------
--------------------------------------,-X-X---------------------------------------------------------------------------------------------------------------------------------------------------------------------------------------------------------------------------------------
