----------------------------------------------,-,-X~X~X~X~X~X~X~X~X~X~X~X~X~X~X~X~X~X~X~X~X~X~X~X~X~X~X~X~X~X~X~,-------------------------------------------------------------------------------------------------------
--------------------------------------------,-,-X~.~.~.~.~.~.~.~.~.~.~.~.~.~.~.~.~.~.~E~.~.~.~.~.~.~,~X~X~X~X~.~X~,-----------------------------------------------------------------------------------------------------
------------------------------------------,-,-X~,~,~,~,~,~,~,~,~,~,~,~,~,~,~,~,~,~,~,~,~,~,~,~,~,~,~X~X/X/X/,-X~,~X~----------------------------------------------------------------------------------------------------
----------------------------------------,-,-X~,~,~.-.-.-.-.-.-.-.-.-.-.-.-.-.-.-.-.-.-.-.-.-.-.-,-X-X/./././X/,-X~,-,-,-,-,-,-,-,-,-------------------------------------------------------------------------------------
----------------------------------------,-X~,~,~,-,-,-,-,-,-,-,-,-,-,-,-,-,-,-,-,-,-,-,-,-,-,-,-,-X/./././E/./X/,-X-X-X-X-X-X-X-X-X-,-----------------------------------------------------------------------------------
----------------------------------------,-X~,~,-,-.-.-.-.-.-.-.-.-.-.-.-.-.-.-.-.-.-.-.-.-.-.-.-.-X/././././././X/.-.-.-.-.-.-.-B-.-X-,---------------------------------------------------------------------------------
----------------------------------------,-X~.-,-.-A-.-.-.-.-.-.-.-.-.-.-.-.-.-.-.-.-.-.-.-.-.-E-.-,/././K/././././.-.-.-.-.-.-.-.-.-.-X---------------------------------------------------------------------------------
----------------------------------------,-X~.-,-.-.-.-.-,-,-,-,-,-,-,-,-,-,-,-,-,-,-,-,-,-,-,-,-,-X0./././././,/X/.-.-.-.-.-.-.-.-E-.-X---------------------------------------------------------------------------------
----------------------------------------,-X~.-,-.-.-.-,-,-,-,~,~,~,~,~,~,~,~,~,~,~,~,~,~,~,~,~,~,~X0X/././,/X/X-,-X-X-X-X-X-.-.-.-.-.-X---------------------------------------------------------------------------------
----------------------------------------,-X~.-,-.-.-,-,-,~.~.~.~.~.~.~.~.~.~.~.~.~.~.~.~.~.~.~.~.~.~X~X/X/X/--------------,-X-.-E-.-.-X---------------------------------------------------------------------------------
----------------------------------------,-X~.-,-E-.-,-,-.~.~.~.~.~.~.~.~.~.~.~.~.~.~.~.~.~.~.~.~.~.~.~X~X~X~----------------,-X-.-.-E-X---------------------------------------------------------------------------------
----------------------------------------,-X~.-,-,-.-,-,~.~.~.~.~.~.~,~,~,~,~,~,~.~.~.~.~.~.~.~.~.~.~.~E~.~X~----------------,-X-.-.-.-X---------------------------------------------------------------------------------
----------------------------------------,-X~.-,-,-.-,-,~.~.~.~.~.~,~,~,-,~,~,~X-X~X~X~X~X~,~,~,~,~,~,~,~,~X~----------------,-X-X-X-.-X---------------------------------------------------------------------------------
----------------------------------------,-X~.-,-,-.-,-,~.~.~.~.~,~,~,~.-.-E-.-.-X-,-,-,-,-X-.-.-.-.-.-X-X-,-,-,-,-,-,-,-,-,-,-,-,-X-+-X---------------------------------------------------------------------------------
----------------------------------------,-X~.-,-,-.-,-,~.~.~.~.~,~,-.-.-.-.-.-A-.-X-X~X~X~X-,-,-,-,-,-X-X~X~X~X~X~X~X~X~X~X~X~X-X-X-,-X-X-X-X-X-------------------------------------------------------------------------
----------------------------------------,-X~.-,-,-E-,-,~.~.~.~.~,~,~.-.-.-.-.-.-A-X-X~E~.~.~.~.~.~.~.~.~.~.~.~,~.-.-,-.~.~.~,~.-,-,-,-,-,-,-----X-----------------------------------------------------------------------
----------------------------------------,-X~.-,---,-,-,~.~.~.~.~,~,~.-E-.-<-.-A-.-X-X~.~.~.~.~.~.~,~,~,~,~.~.~,~.-H-,-.~.~.~,~,-,-,-,-,-.-,---E---X---------------------------------------------------------------------
----------------------------------------,-X~.-,---,-,-,~.~.~.~.~,~,~.-.-.-.-.-.-H-X-,-X~X~X~X~.~.~,~.-.-,-.~.~,~,-,-,-.~.~.~.~,~,-,-,-,-.-,-------X---------------------------------------------------------------------
----------------------------------------,-X~.-,---,-,-,~.~.~.~.~,~X-X-.-.-.-.-.-,-X-X-X-X-X-,-X~.~,~.-.-,-.~.~,~,~,~,~,~,~,~,~,~,-,-,-,-,-,-------X---------------------------------------------------------------------
----------------------------------------,-X~.-,-,-,-,-,~.~.~.~.~.~X~,-X-.-.-.-.-,-.-.-.-.-.-X-X-,~,~,-,-,-.~,~,~.-.-.-.-,-,-----,-,-----------A-A-X---------------------------------------------------------------------
----------------------------------------,-X-X-X-.-.-,-X-X~X~X~X~X~X~,-X-.-.-.-W-,-.-.-.-.-E-X-X-X-.~.~.~.~.~,~.~,-,-,-,-,-,---,-,-,-,---------A---X---------------------------------------------------------------------
----------------------------------------,-X-X-X-L-L-L-X-,-,-,-,-,-,-,-X-.-.-.-.-,-.-.-.-.-.-.-L-,-.~.~.~.~,~,~,-,-----------,-,-,-,-,-,-----E---X-----------------------------------------------------------------------
----------------------------------------,-X-X-X-.-.-.-X-X-X-X-X-X-X-X-X-.-.-.-.-,-.-.-.-.-,-X-X-X-.~.~.~.~,~.-,-------E-----,-.-,-,~X-X-X-X-X-X-------------------------------------------------------------------------
----------------------------------------,-X~A~.-.-.-.-.-.-.-.-.-.-.-+-.-.-.-.-.-,-.-.-.-.-X-,-,-X~.~.~.~.~,~.-,-------------,-.-,-A~X~----------------------------------------------------------------------------------
--------------------------------------,-,-X~,~.-.-.-.-.-.-B-.-X-X-X-X-X-.-.-.-X-X-X-X-X-X-X-X-X~.~.~.~B~.~,~.-,-------W---,-,-,-,-,~X~----------------------------------------------------------------------------------
------------------------------------,-,-X~,~,~.-.-.-.-.-.-.-.-X-----,-X-.-.-X-X~X~X~X~X~X~X~.~.~.~.~.~.~.~,~.-,---------,-,-.~.~.~X~,-,---------------------------------------------------------------------------------
----------------------------------,-,-X~.~,~.~.-.-.-.-.-.-.-.-X-,-,-,-X-X-X-X~.~.~.~.~.~.~.~.~.~.~B~.~B~.~,~.-,-------,-,-,-.~.~,~X~X~X~,-------------------------------------------------------------------------------
--------------------------------,-,-X~.~,~,~.-E-.-.-.-.-E-.-.-X-,-X~X~X~X~X~.~.~.~.~.~.~.~.~.~.~.~.~.~.~.~,~,~,-,-----,-,-.~.~,~,~.~.~.~X~,-----------------------------------------------------------------------------
--------------------------------,-X~.~.~,~.-.-.-.-.-.-.-.-.-,-X-,-X~E~.~.~.~.~.~.~.~.~.~.~.~.~.~.~.~.~.~.~.~,~.-,---E-,-,~.~.~,~.~.~.~.~.~X~X-X-X-X-X-X-X-X-------------------------------------------------------------
--------------------------------,-X~.~.~,~.-.-.-.-E-.-.-.-,-X---,-X~.~.~.~.~.~.~.~.~.~.~.~,~,~,~,~,~.~.~.~.~,~,-,-----,-,~.~.~,~.~.~.~.~.~,~------------E-X-------------------------------------------------------------
--------------------------------,-X~.~.~,~.-.-.-.-.-.-.-.-X-----,-X~.~E~.~.~.~.~.~.~.~.~,~,~,-,-,-,-,~.~.~.~.~,~,-,---,-,-,~.~,~,~.~.~.~,~X~X-X-X-X-X-X---X-------------------------------------------------------------
--------------------------------,-X~.~.~,~.-.-.-.-.-.-.-.-X-----,-X~X~X~X~X~X~X~X~X~,~,~,~,-.-.-.-,-,-.~.~.~.~,~.-,---,-.-,~.~.~,~,~.~,~X~------------X---X-------------------------------------------------------------
--------------------------------,-X~.~.~,~.-.-.-.-.-.-.-.-X-----,-X2X2X2X2X2X-X-X-X-,-,-.-,-.-.-.-.-,-,-.~.~.~,~,~,-,-,-.-,-.~.~.~X~X~X~--------------X---X-------------------------------------------------------------
--------------------------------,-X~.~.~,~.-.-.-.-.-.-.-.-X-----,-X2.2.2.2,2.-.-.-,-,-,-.-,-.-.-.-.-,-,-.~.~.~.~,~.-,-,-,-,-.~.~.~X~------------------X-E-X-------------------------------------------------------------
--------------------------------,-X~.~E~,~.-.-.-.-.-.-.-.-X-,---,-X2.2.2.2,2.-.-.-,-,-,-.-,-.-.-<-E-W-,-,~.~.~.~,~.-,---,-,~,~,~,~X~------------------X---X-------------------------------------------------------------
--------------------------------,-X~.~.~,~.-.-.-.-.-.-.-.-.-X---,-X2.2.2.2,2,-,-.-,-,-,-,-,-.-.-.-,-,-,-,-.~.~.~,~.-,-,-,-.-.-.-,~X~------------------X---X-------------------------------------------------------------
--------------------------------,-X~.~.~,~.-.-.-.-.-.-.-.-.-X-,-,-X2.2.2.2X2X-X-X-X-,-.-.-,-,-.-,-,-,-,-.~.~.~.~,~.-,-,-,-,-,-,-,-X-,---------------,-X-,-X-------------------------------------------------------------
--------------------------------,-X~.~.~,~.-.-.-.-.-.-.-.-.-.-X-,-X-.-.-.-.-E-X-,-X~,~,~,~,-,-,-,-.-,-.~.~.~.~.~,~.-,-.-.-.-.-.-.-.-X-,---,-,-,-,-,-,-X~.~X~,-,-,-,-,-,-------------------------------------------------
--------------------------------,-X~.~.~,~.-.-.-.-.-.-.-.-.-.-X-,-X-.-.-.-.-,-X-,-X~.~.~.~,~,-,~,-,-,-.~.~.~.~.~,~.-,-.-.-.-.-.-.-.-.-X-,-,-X~X~X~X~X~X~.~X~X~X~X~X~X~X~------------------------------------------------
--------------------------------,-X~.~.~,~.-.-.-.-.-.-.-.-.-.-X-,-X-.-.-.-,-,-X-,-X~.~.~.~.~.~.~.~.~.~.~.~.~.~.~,~.-,-.-.-.-.-.-.-.-.-.-X-,-X~E~.~.~.~.~.~.~.~.~.~.~B~X~------------------------------------------------
------------------------------,-,-X~.~.~,~.-.-.-.-.-B-B-.-.-.-X-,-X-.-.-.-,---X-,-X~.~.~.~.~.~.~.~.~.~.~.~.~.~,~,~.-,-,-.-.-E-.-.-.-.-.-X-,-X~.~.~.~.~.~.~.~.~.~.~.~.~X~------------------------------------------------
----------------------------,-,-X~.~.~.~,~.-.-.-.-.-B-.-.-.-,-X-,-X-.-.-.-,-,-X-,-X~.~.~B~.~.~.~.~.~.~.~.~.~.~,~.~.-.-,-.-.-.-.-.-.-.-.-.-X-X~.~,~,~,~,~,~,~,~,~.~.~.~X~------------------------------------------------
--------------------------,-,-X~.~.~.~.~,~.-.-.-.-.-.-.-.-.-,-X-X-X-,-,-.-.-.-X-,-X~.~.~.~B~.~B~.~.~.~.~.~.~.~,~.~.-.-,-,-.-.-.-.-.-.-.-.-X-X-,~,~,-,~.-.-.-.-,-.~.~.~X~------------------------------------------------
--------------,-,-,-,-,-,-,-X~.~.~.~.~.~,~.-.-.-.-.-.-.-.-,-X-X-+-+-E-,-.-.-.-X-,-X~.~.~.~.~.~.~.~.~.~.~.~.~.~,~.~.-.-.-,-.-.-.-E-.-.-.-.-L-L-,-.-,-,~.-.-.-E-,-.~.~.~X~------------------------------------------------
------------,-,-X~X~X~X~X~X~.~.~.~.~.~,~,~.-.-.-.-.-.-.-,-X-,-X-+-+-,-,-.-.-.-X-,-X~.~.~.~.~.~.~.~.~.~.~.~.~.~,~.~.-.-.-,-.-.-.-.-.-.-E-.-L-L-.-E-,-,~.-.-.-.-,-.~.~.~X~------------------------------------------------
------------,-X-.~.~.~.~.~.~.~.~.~,~,~,~.-.-.-.-.-.-.-,-X---,-X-X-+-X-.-.-.-.-X---,-X~.~.~.~.~.~.~.~.~.~.~.~.~,~,~,-,-,-,-.-.-.-.-.-.-.-.-L-L-.-.-,-,~E-.-.-.-,-.~.~.~X~------------------------------------------------
----------,-,-X~.~.~.~.~.~.~.~.~,~,~.~.-.-.-.-.-.-.-A-X-------,-,-X-X-X-.-.-.-X-----,-X~X~X~X~X~X~X~,~,~,~,~,~X~X-.-.-.-.-.-.-.-.-B-.-,-,-X-X-,-,-,-,~,-,-,-,-,-.~.~.~X~------------------------------------------------
----------,-X-.~.~.~,~,~,~,~,~,~,~.~.-.-.-.-.-.-.-.-.-X-------------,-X-L-L-L-X-----------------,-X-.-.-.-.-.-X-X-H-.-.-.-.-E-.-.-.-.-,-X-,-X~.~.~.~.~.~.~.~.~.~.~E~.~X~------------------------------------------------
--------,-,-X~.~.~,~,~.-.-.-.-.-.-.-.-.-.-.-.-.-.-.-.-X-----------X-X-X-,-,-,-X-X-X-X-X-X-X-X-X-X-X-.-.-.-.-.-X-X-X-X-X-X-X-X-X-X-X-X-X-,-X~,~,~,~.~.~.~.~.~.~.~.~.~.~X~------------------------------------------------
------,-,-X~.~.~.~,~.~.-.-.-.-.-.-.-.-.-.-.-.-.-.-.-.-X-------,-,-X-,-,-,-,-,-,-,-,-,-,-,-,-,-,-.~.~.~.~.~.~.~X~,-,---------------------,-X~.-H-,-.~.~.~.~.~E~.~.~.~.~X~------------------------------------------------
------,-X-.~.~.~,~,~.-.-.-.-.-.-.-.-.-.-.-.-.-.-.-:-.-X-------,-X-X-,-.-.-.-.-,-.-,-.-.-.-.-,-,-.~.~.~.~.~B~,~X~X-X-------------------,-,-X~,-,-,-.~.~.~.~.~.~.~.~.~.~X~------------------------------------------------
,-,-,-,-X~.~.~,~,~.-.-.-.-.-.-.-.-.-.-.-.-.-.-.-.-.-.-X-------,-X-,-,-.-.-.-.-,-,-,-.-.-.-,-,-.~.~.~.~.~.~,~,~.-.-X-----------------,-,-X~H~.~.~.~.~.~H~.~.~A~.~.~.~.~X~----------,-,-,-,-,-,-,-,-,-,-,-,-,-,-,-,-,-----
X-X-X-X-.~.~.~,~.~.-.-.-.-.-.-.-.-.-.-,-,-,-.-.-.-.-,-X-------,-X-,-,-.-.-.-,-,-,-,-,-E-.-,-.~.~.~.~.~.~,~,~.-.-.-X-----------------,-X~,~,~.~.~.~.~.~.~.~.~.~.~.~.~.~X~--------,-,-X~X~X~X~X~X~X~X~X~X~X~X~X~X~X~X~,---
X-.-X-,-.~.~,~,~.-.-.-.-.-.-.-.-.-.-.-,-.-,-,-,-,-,-X---------,-X-,-,-.-.-,-,-.-,-.-,-,-.-,-.~.~.~.~.~,~,~.-.-A-A-X-----------------,-X~.~,~,~.~.~.~,~,~,~,~,~,~.~.~.~X~,-,-,-,-,-X~,~,~.~,~.-.-,-,~,~.~.~.~.~E~,~,~X~,-
X-,-X-,-.~.~,~.-.-.-.-.-.-.-.-.-.-.-.-,-.-,4.4.4.4X4----------,-X-,-,-,-,-,-.-E-,-.-.-,-.-,-.~.~.~.~,~,~.-.-.-.-A-X-,-------------,-,-X~.~.~,~,~.~.~,~.-.-.-.-,-.~.~,~X~,-X-X-X-X~t6t6t6.~,~.-.-.-.-,-,~.~.~.~,~,~,-,~X~
X7t7t7,-.~.~,~.-.-.-,-,-,-,-,-,-.-.-.-,-.-,-.4.4.4X4----------,-X-,-,-.-.-.-.-.-,-.-.-,-.-,-.~.~.~,~,~,-,-.-.-E-.-.-X-,---------,-,-X-,-,~.~.~,~.~.~,~.-.-.-E-,-.~,~X~--,-X-t6X-X~t6.-t6.~,~.-t5.-,-,-,-,~,~,~,~.-.-,-X~
X7t8t7,-.~.~,~.-.-.-A-,-,-,-,-,-.-.-.-,-.-,-.4.4.4X4----------,-X-,-,-.-.-.-.-,-,-.-,-,-.-,-.~.~.~,~.-.-,-,-.-.-.-.-.-X---------,-X-.-.-,-,~.~,~.~.~,~.-.-.-.-,-,~X~,-,-,-X5t5X5X~t6t6t6.~,~,-,-,-,-,~,-.-.-.-,-,-K-,-X~
X7t7t7,-.~.~,~.-.-.-A-,-t8t8t8,-.-.-.-,-.-,-.4.4.4X4----------,-X-,-,-,-,-,-,-,-.-,-,-.-.-,-.~.~.~,~.-.-.-,-,-.-.-.-.-X---------,-X-.-E-.-,-,~,~.~.~B~.-.-.-.-,-X~X-X-X-X-.-.-.-X-.~.~.~.~.~.~.~.~.~.~,~,-,-,-,-,~,-X---
X-.-.-,-.~.~,~.-.-.-A-,-t8t7t8,-.-.-.-E-.-,4.4.4.4X4----------,-X-,-,-.-.-.-.-.-.-,-.-.-.-,-.~.~.~,~.-.-.-.-B-.-.-E-.-X---------,-X-.-.-.-,-,~X~X~X~X~X1.1.1.1X1,-X-.-+-+-.-E-.-X-X~.~.~.~.~.~.~.~.~.~.~.~.~.~.~.~.~X~--
X-.-.-,-.~.~,~.-.-.-A-,-t8.-t8,-.-.-.-,-.-,-.-E-.-X-----------,-X-,-,-.-.-.-.-.-.-,-.-.-.-,-.~.~.~,~.-.-.-.-,-.-.-.-.-X---------,-X-.-.-.-,-E~X~----,-X1.1.1.1X1,-X-X-X-X-.-.-,-X-X~.~.~.~.~.~.~.~.~.~.~.~.~.~.~.~.~X~,-
X-.-.-,-.~.~,~.-.-.-A-,-t8t8t8,-.-.-.-,-.-,-.-.-.-X-,---------,-X-,-,-.-.-.-E-.-.-,-.-.-.-,-.~.~.~,~.-.-.-.-,-.-.-.-.-X-,-------,-X-.-W-.-,-.~X~,---,-X1.1.1.1X1--------,-X-.-X-X~.~.~.~.~.~.~.~.~.~.~.~.~B~.~.~.~.~.~X-
X-H-.-,-.~.~,~.-.-.-,-.-.-.-.-,-.-.-.-,-.-,-.-.-.-.-X-,-------,-X-,-,-.-.-.-.-.-.-,-.-.-.-,-.~.~.~,~.-.-.-.-,-.-.-.-.-.-X-,-----,-X-.-.-.-,-.~.~X~,-,-X1.1.1.1X1,-,-,-,-,-X-+-X-.~.~.~.~.~.~.~.~.~.~.~B~.~.~B~.~.~.~.~X~
X-.-.-,-.~.~,~.-.-.-,-.-.-.-.-,-.-.-.-,-.-,-.-.-.-.-A-X-,-----,-X-X-,-.-.-.-.-.-,-,-.-.-,-,-.~.~.~,~.-.-.-.-,-.-.-.-.-.-.-X-----,-X-.-.-.-,-,~,~.~X~X~X1,1,1,1X1X-X-X-X-X-X-,-X-.~.~.~.~.~.~.~.~.~.~.~.~.~.~,~,~,~,~.~X~
X-.-.-,-.~.~,~.-.-.-,-.-.-.-.-,-.-.-.-,-.-,-.-.-.-.-.-.-X-,-,-,-,-X-,-.-.-E-.-,-,-.-.-,-,-.~.~.~.~,~.-.-.-.-,-.-.-.-.-.-.-X-,-----,-X-.-.-.-.-,~,~,~,~.-.-.-.-.-.-.-.-.-.-,-,~X~H~,~,~,~,~,~,~,~,~,~,~,~.~.~,~.-.-,-.~X~
X-.-X-,-.~,~,~.-.-.-,-.-.-.-.-,-.-E-.-,-.-,-.-.-.-.-.-.-.-X-X-X-X-X-,-,-,-,-,-,-.-.-,-,-.~.~.~.~,~,~,-,-,-,-,-.-.-:-:-.-.-.-X-,-----,-X-.-.-E-.-.-,-,~.-.-.-.-.-.-.-E-.-.-,-,~X-.-.-.-.-.-.-.-.-,-,-,-,-.~.~,~,-W-,-.~X~
X-.-.-,-.~,~,-,-,-,-,-.-.-.-.-,-,-,-,-,-,-,-.-.-.-.-.-.-.-.-,-.-+-,-----------,-,-,-,-.~.~.~.~,~,~.-.-.-.-,-,-.-.-.-:-.-.-.-H-X-,-,-,-,-X-.-.-.-.-,-,~.-.-.-.-.-.-.-.-.-.-,-,~,-.-.-.-.-.-.-.-.-,->-,-,-.~.~.~,~.-,-.~X~
X-.-.-,-.~,~,-.3.3.3,3.3.-.-.-.-.-.-.-.-,-,-.-.-E-.-.-<-.-E-,-.-+-,-------------,-,-.~.~.~.~,~,~.-.-.-.-,-,-,-.......-.-.-.-:-X-,-X~X~X~X-,-,-,-,-,-,~.-.-.-.-.-.-.-.-E-.-,-,~,-.-.-.-.-.-E-.-.-,->-,-,-.~.~.~,~.-,-.~X~
X-.-.-,-.~,~,-.3.3.3,3.-.-.-.-.-.-.-.-.-H-,-.-.-.-.-.-.-.-.-,-.-+-,-------------,-.~.~.~.~,~,~.-.-.-.-,-,-.-,-.........-.-.-.-X-,-X~,~,~,~,~,~,~,~,~,~.-.-.-.-.-.-.-.-.-.-,-,~,-.-.-.-.-.-.-.-.-,->-,-,-.~.~.~,~.-,-.~X~
X-E-.-,-.~,~,-.3.3.3,3.-.-.-.-.-.-.-E-.-,-,-.-.-.-.-.-.-,-X-X-X-X-X-------------,-.~.~.~.~,~.-.-.-.-.-,-.-.-,-...........-.-.-X-,-X~,~.-.-.-.-.-.-.-.-.-.-.-.-.-.-B-.-.-.-,-,~,-,-,-,-,-,-,-.-.-.-,-,-,-.~.~.~,~.-,-.~X~
X-.-.-,-.~,~,-.3.3.3,3.-.-.-.-.-.-.-.-.-,-,-E-.-.-.-.-,-X-------,-X-,-E-,-,---E-,-.~.~.~.~,~.-.-.-.-.-,-.-.-,-...........-.-.-X-,-X~,~.-.-.-.-.-.-.-.-.-.-.-.-.-.-.-.-B-.-,-,~X-,-,-,-,-,-,-.-.-.-,-H~.~.~.~.~,~,-,~.~X~
X-.-.-,-.~,~,-,3.3.3,3.3.-.-B-.-.-.-.-.-,-,-.-.-.-B-,-X---------,-X-,-,-.9,9,---,-.~.~.~.~,~.-.-.-.-.-,-.-.-,-...........-<-.-X-,-X~,~.-.-.-.-.-E-.-.-.-.-.-.-.-.-B-.-.-.-,-,~X~.~.~.~.~.~,~.-.-.-,-.~.~.~.~,~,~,-.~.~X~
X-.-.-,-.~,~.-,-.-.-,-.-.-.-.-.-.-.-.-E-,-,-.-.-.-,-X-----------,-X-,-.9A9.9,9--,-.~.~.~.~,~.-.-.-.-.-,-.-.-,-...........-.-.-X-,-X~,~.-.-.-.-.-.-.-.-,-,-,-,-,-,-,-,-,-,-,-,~X~X~X~,~,~,~,~.-E-.-,-.~.~.~,~.~,-,-.~,~X-
X-.-.-,-.~,~.-,-.-E-,-.-.-.-.-B-.-.-.-.-,-,-.-.-.-X-------------,-X-,-,9.9,9,9--,-.~.~.~.~,~.-B-.-B-.-,-,-.-,-...........-.-.-X-,-X~,~.-.-.-.-.-.-.-.-,-.-,-,-,-,-,-,-,-.-,-,~X-X-X-,-,-,-,-.-.-.-,-,~,~,~.~,-.~.~.~X~--
X-.-.-,-.~,~.-,-.-.-,-.-.-B-.-.-.-.-.-.-,-,-.-.-.-X-------------,-X-.-,-,9,9----,-.~.~.~.~,~.-.-.-.-.-.-,-,-,-.........-.-.-.-X-,-X~,~.-.-<-.-W-.-.-.-,-.-,-,-,-,-,-,-,-.-,-,~.-L-.-.-.-.-.-.-.-.-,-,-,~,-,-.~.~.~.~X~--
X-.-X-,-.~,~.-,-.-.-,-.-.-.-.-.-.-.-.-.-,-,-.-.-.-X-------------,-X-.-.-.-,-,---,-.~.~.~.~,~,-.-B-.-.-.-.-.-,-.......-.-.-.-.-X-,-X~,~.-.-.-.-.-.-.-.-,-.-,-,-,-,-,-,-,-.-,-,~.-L-.-.-.-.-.-.-.-.-,-.~.~.~.~.~.~.~.~X~,-
X-.-.-,-.~,~.-,-.-.-,-.-.-.-.-.-.-.-.-.-,-,-.-.-A-X-------------,-X-.-.-.-.-,-,-,-.~.~.~.~.~,~,-.-.-.-.-.-.-,-.-.-.-.-.-,-,-,-X-,-X~,~.-.-.-.-.-.-.-.-,-.-,-,-,-,-,-,-,-.-,-,~.-L-.-.-.-.-.-E-.-.-,-.~.~.~.~.~.~.~.~.~X-
X-.-.-,-.~,~.-,-.-.-,-.-.-.-.-.-.-.-.-E-,-,-.-.-A-X-------------,-X-.-.-.-.-.-,-,-,~.~.~.~.~.~,~,-.-.-.-.-E-,-.-.-.-.-,-,-.-.-X-,-X~,~.-.-.-.-.-.-.-.-,-,-,-,-,-,-,-,-,-,-,-,~X-X-X-,-,-,-,-,-,-,-,-.~.~.~.~.~.~.~E~.~X~
X-.-.-,-.~,~.-,-.-.-,-.-.-.-.-.-,-,-,-,-,-,-.-.-A-X-------------,-X-.-.-.-.-.-.-,-,-,~.~.~.~.~.~,~,-,-,-,-,-.-.-.-E-,-,-.-.-.-X-,-X~,~.-.-.-.-.-.-.-.-.-.-.-.-.-.-.-.-.-E-,-.~X~,-X~.~.~.~.~.~.~.~.~.~.~.~.~.~.~.~.~.~X~
X-.-.-,-.~,~.-,-.-.-,-.-.-.-.-.-,-,-,-.-,-,-.-.-A-X-------------,-X-.-.-.-.-.-.-,-,-,-,~.~.~.~.~.~,~.-.-.-.-.-.-.-.-,-.-.-K-.-X-,-X~,~,-,-,-,-,-,-,-,-,-,-,-,-,-,-,-,-,-,-,-.~X~,-X~.~.~.~.~.~.~.~.~.~.~.~.~E~.~.~.~,~X~
X-.-.-,-.~,~.-,-.-.-,-.-.-.-.-.-,-,-,-.-,-,-.-.-.-X---------------,-X-X-.-.-.-.-.-,-,-,-,~.~.~.~.~,~.-.-.-.-.-E-.-.-,-.-.-.-.-X-,-X~H~.~.~.~.~.~.~.~.~.~.~.~.~.~.~.~.~.~.~.~.~X~--,-X~.~.~.~.~.~.~.~.~.~.~.~.~.~.~,~X~--
X-.-.-,-.~,~.-,-.-.-,-.-.-.-.-.-,-,-,-.-,-,-.-.-.-X-,-----------------,-X-,-,-,-,-,-,-,-,-X~,~,~,~,~,-X-X-X-X-X-X-X-X-X-X-X-X-X-,-X~X~X~X~X~X~X~X~X~X~X~X~X~X~X~X~X~X~X~X~X~X~X~----,-X~X~X~X~X~X~X~X~X~X~X~X~X~X~X~----
X-.-.-,-.~,~.-,-.-.-,-.-A-,-,-,-,-,-,-.-,-,-.-.-.-.-X-,-------------,-,-,-X-.-.-.-.-.-X-X-X-.-.-,-X-X-,-,-,-,-,-,-------------------------------------,-,-X-X-X-X-X-X-X-.-X-,-------------------------------------------
X-.-.-,-.~,~.-,-.-.-,-,-,-.-.-.-.-,-,-,-,-,-.-.-.-.-.-X-,-----------,-X-X-X-,-,-,-,-,-X-X-X-.-.-,-X-X-X-X-X-X-X-X-,-,-----------------------------,-,-X-X-.-.-.-.-.-.-,-,-.-X-,-----------------------------------------
X-.-.-,-.~,~.-,-.-.-.-.-,-,-,-,-,-,-.-E-.-,-.-.-.-.-.-.-X-,-,-,-,-,-,-X-.-.-.-.-E-.-.-.-.-,-.~.~,~.-.-.-.-.-.-.-B-X-X-,-,-,-,-,-,-,-,-,-,-,-,-,-,-,-X-.-.-.-E-.-.-.-.-.-,-,-.-X-,---------------------------------------
X-.-X-,-.~,~.-,-E-.-.-.-,-.-.-.-.-,-.-,-,-,-,-.-.-W-.-.-.-X-X-X-X-X-X-X-.-.-.-.-.-.-.-.-.-,-.~.~,~.-.-E-.-.-.-.-B-.-,-X-X-X-X-X-X-X-X-X-X-X-X-X-X-X-.-.-.-.-.-.-.-B-.-.-.-,-,-.-X---------------------------------------
X-.-A-,-.~,~.-,-.-.-.-.-,-,-,-,-,-,-.-.-,-,-,-,-.-:-.-.-.-.-,-,-,-.-+-,-.-.-.-.-.-.-.-.-,-,-.~.~,~.-.-.-.-.-.-.-.-B-,-.-,-,-.-.-,-.-,-.-.-.-.-.-.-,-,-,-,-,-.-.-.-.-.-.-.-.-,-.-X---------------------------------------
X-.-.-,-.~,~.-,-.-.-.-.-,-,-,-,-,-,-.-.-.-B-,-,-,-.-.-.-,-,-,---,-.-+-,-.-.-.-.-.-.-.-,-,-.~.~.~,~.-.-.-.-.-.-.-.-.-,-.-,-E-.-.-,-.-,-.-.-.-.-.-,-,-.~.~,~,-,-.-.-.-.-.-.-.-A-.-X---------------------------------------
X-.-.-,-.~,~.-,-.-.-.-.-.-.-.-.-.-.-.-.-.-.-.-,-,-,-,-,-,-,-,-,-,-,-+-,-.-.-.-.-.-.-.-,-.~.~.~.~,~,~.-.-.-.-.-B-.-.-,-.-,-,-.-.-,-.-,-.-.-.-.-.-,-,~,~,~,~,~,-.-.-.-.-.-.-.-,-.-X---------------------------------------
X-.-.-,-.~,~.-,-.-.-.-E-.-.-.-.-.-.-.-.-.-.-B-.-,-,-,-,-,-,-,~,~,~X-X-X-.-E-.-.-.-.-.-,-.~.~.~.~.~,~,-,-,-,-,-,-,-,-,-,-,-,-,-,-,-,-,-,-,-,-,-,-,-,~.-.-,-,~,-.-.-.-.-.-.-E-A-.-X---------------------------------------
X-.-.-,-.~,~.-,-.-.-.-.-.-.-.-.-.-.-.-.-.-.-.-.-.-.-.-.-H-,-.~.~.~X~,-X-.-.-.-.-.-.-.-,-.~.~.~.~.~,~,~,~,~,~,~,~,~,~,~,~,~,~,~,~,~,~,~,~,~,~,~,~,~,~.-.-,-,~,-.-.-.-.-.-.-.-A-.-X---------------------------------------
X-.-.-,-.~,~.-,-.-.-.-.-.-.-.-.-.-.-.-.-.-.-.-.-.-E-.-B-,-,-.~.~.~X~,-X-.-.-.-.-.-.-.-,-,~.~.~.~,~,~.-.-.-.-.-.-.-.-,-.-,-,-.-,-,-.-.-,-.-.-.-.-,-,~,-,-,-,~,-.-.-.-.-.-.-.-A-.-X---------------------------------------
X-.-.-,-.~,~.-,-,-,-,-,-,-,-,-,-,-,-,-,-,-,-,-,-,-,-,-,-,-,-.~.~E~X~,-X-.-.-.-.-.-.-.-.-,-,~,~,~,~.-.-.-.-.-.-B-.-.-,-.-,-,-.-,-,-.-.-,-.-.-.-.-,-,~,~,~,~,-.-.-.-.-.-.-.-.-A-.-X---------------------------------------
X-.-.-,-.~,~,-,-,-,-,-,-,-,-,-,-,-,-,-,-,-,-,-,-,-,-,-,-,-,-.~.~.~X~,-X-.-.-.-.-.-E-.-.-.-.-.-.-.-.-.-.-.-.-.-.-.-.-,-.-,-,-.-,-,-.-.-,-E-.-.-.-.-,-,-,-,-.-.-.-.-.-.-.-.-.-,-.-X---------------------------------------
X-.-X-,-.~.~.~.~.~.~.~.~.~.~.~.~.~.~.~.~.~.~.~.~.~.~.~.~.~.~.~.~,~X~,-X-B-.-.-.-.-.-.-.-.-.-.-.-.-.-.-.-.-.-.-.-.-.-,-.-,-,-.-,-,-.-.-,-.-.-.-.-.-.-.-.-.-.-.-.-.-.-.-.-.-,-,-,-X---------------------------------------
X-.-X-,-,~.~.~.~.~.~.~.~.~.~.~.~.~.~E~.~.~.~.~.~.~.~.~.~.~E~.~.~X~--,-X-X-X-X-X-X-X-X-X-X-X-X-X-X-X-X-X-X-X-X-X-X-X-X-X-X-X-X-X-X-X-X-X-X-X-X-X-X-X-.-.-.-.-.-.-.-.-.-,-,-,-,-X-----------------------------------------
X-.-.-.-,-,~,~,~,~,~,~,~,~,~,~,~,~,~,~,~,~,~,~,~,~,~,~,~.~.~B~,~X-----------,-X-X---------,-X-X---------,-X-X-------------------------------------,-X-X-.-.-.-.-.-.-,-,-.-,-X-------------------------------------------
,-X-.-.-.-X-.-.-.-.-.-.-X-X-.-.-.-.-.-.-.-X-.-.-.-.-.-X-X~X~X~X~------------------------------------------------------------------------------------,-,-X-.-.-<-.-<-,-X-,-X---------------------------------------------
--,-X-X-.-X-.-.-.-E-.-.-X-X-H-.-A-A-.-A-.-X-.-.-.-W-.-X-------------------------------------------------------------------------------------------------,-X-X-.-.-.-X-X-X-----------------------------------------------
------,-X-.-.-.-.-.-.-.-.-.-.-.-.-.-.-.-.-.-.-.-.-.-.-X-------------------------------------------------------------------------------------------------,-X-X-.-<-.-X---------------------------------------------------
--------,-X-X-X-X-X-X-X-X-X-X-X-X-X-X-X-X-X-X-X-X-X-X-X---------------------------------------------------------------------,-,-,-,-,-,-,-,-------------,-X-<-.-.-.-X-----------,-,-,-,-,-,-,-,-------------------------
----------------------------------------------------------------------------------------------------------------------------,-X-X-X-X-X-X-X-,-,-,-,-,-,-,-X-X-.-<-.-X---,-,-,-,-,-X-X-X-X-X-X-X-,-----------------------
--------------------------------------------------------------------------------------------------------------------------,-,-X-.-,-,-.-.-.-X-X-X-X-X-X-,-,-X-,-,-,-X-,-,-X-X-X-X-.-.-.-,-.-.-.-X-,---------------------
--------------------------------------------------------------------------------------------------------------------------,-X-.-.-,-.-.-.-.-.-.-.-.-.-.-X-X-X-,-,-,-X-X-X-.-.-.-.-.-.-.-,-,-.-.-.-X-,-------------------
--------------------------------------------------------------------------------------------------------------------------,-X-.-.-,-.-.-.-.-.-.-.-.-.-.-.-.-.-.-.-.-.-.-.-.-.-.-.-.-.-.-.-,-,-.-.-.-X-,-----------------
--------------------------------------------------------------------------------------------------------------------------,-X-.-.-,-.-.-.-.-.-.-.-.-.-.-.-.-.-.-.-.-.-.-.-.-.-.-.-.-.-.-.-.-,-.-.-.-.-X-----------------
------------------------------------------------------------------------------------------------------------------------,-,-X-.-,-,-.-.-.-.-.-.-.-.-.-.-.-.-.-.-.-.-.-.-.-.-.-.-.-.-.-.-.-.-,-,-.-.-.-X-----------------
------------------------------------------------------------------------------------------------------------------------,-X-.-.-,-.-.-.-.-.-.-.-.-.-.-.-.-.-.-.-.-.-.-.-.-.-.-.-.-.-.-.-.-.-.-,-.-.-.-X-----------------
------------------------------------------------------------------------------------------------------------------------,-X-.-.-,-.-.-.-.-.-.-.-.-.-.-.-.-.-.-.-.-.-.-.-.-.-.-.-.-.-.-.-.-.-.-,-.-.-.-X-,---------------
------------------------------------------------------------------------------------------------------------------------,-X-.-.-,-.-.-.-.-.-.-.-.-.-.-.-.-.-.-.-.-.-.-.-.-.-.-.-.-.-.-.-.-.-.-,-.-.-.-.-X---------------
------------------------------------------------------------------------------------------------------------------------,-X-.-.-,-.-.-.-.-.-.-.-.-.-.-.-.-.-.-.-.-.-.-.-.-.-.-.-.-.-.-.-.-.-.-,-.-.-.-.-X---------------
------------------------------------------------------------------------------------------------------------------------,-X-.-.-,-.-.-.-.-.-.-.-.-.-.-.-.-.-.-.-.-.-.-.-.-.-.-.-.-.-.-.-.-.-,-,-.-.-.-.-X---------------
------------------------------------------------------------------------------------------------------------------------,-X-.-.-,-.-.-.-.-.-.-.-.-.-.-.-.-.-.-.-.-.-.-.-.-.-.-.-.-.-.-.-.-.-,-.-.-.-.-.-X---------------
------------------------------------------------------------------------------------------------------------------------,-X-.-.-,-.-.-.-.-.-.-.-.-.-.-.-.-.-.-.-.-.-.-.-.-.-.-.-.-.-.-.-.-.-,-.-.-.-.-,-X---------------
------------------------------------------------------------------------------------------------------------------------,-X-.-.-,-.-.-.-.-.-.-.-.-.-.-.-.-.-.-.-.-.-.-.-.-.-.-.-.-.-.-.-.-.-,-.-.-.-.-X-----------------
------------------------------------------------------------------------------------------------------------------------,-X-.-.-,-.-.-.-.-.-.-.-.-.-.-.-.-.-.-.-.-.-.-.-.-.-.-.-.-.-.-.-.-.-,-.-.-.-,-X-----------------
------------------------------------------------------------------------------------------------------------------------,-X-.-.-,-.-.-.-.-.-.-.-.-.-.-.-.-.-.-.-.-.-.-.-.-.-.-.-.-.-.-.-.-,-,-.-.-.-X-------------------
------------------------------------------------------------------------------------------------------------------------,-X-.-.-,-.-.-.-.-.-.-.-.-.-.-.-.-.-.-.-.-.-.-.-E-.-.-.-.-.-.-,-,-,-.-.-.-,-X-------------------
------------------------------------------------------------------------------------------------------------------------,-X-.-.-,-,-.-.-.-.-.-.-.-.-.-.-.-.-.-.-.-.-.-.-.-.-.-.-.-,-,-,-.-.-.-.-.-X---------------------
--------------------------------------------------------------------------------------------------------------------------,-X-.-.-,-,-,-.-.-.-.-.-.-.-.-.-.-.-.-.-.-.-.-.-.-.-,-,-,-.-.-.-.-.-.-,-X---------------------
--------------------------------------------------------------------------------------------------------------------------,-X-.-.-.-.-,-,-.-.-.-.-.-.-.-.-.-.-.-.-.-,-,-,-,-,-,-.-.-.-.-.-.-.-.-X-----------------------
----------------------------------------------------------------------------------------------------------------------------,-X-.-.-.-.-,-,-,-.-.-.-,-,-,-,-,-,-,-,-,-.-.-.-.-.-.-.-.-.-.-.-.-,-X-----------------------
------------------------------------------------------------------------------------------------------------------------------,-X-X-.-.-.-.-,-,-,-,-,-.-.-.-.-.-.-.-.-.-.-.-.-.-.-.-.-.-.-.-.-X-------------------------
----------------------------------------------------------------------------------------------------------------------------------,-X-X-.-.-.-.-.-.-.-.-.-.-.-.-.-.-.-.-.-.-.-.-.-.-.-,-X-X-X-X-------------------------
--------------------------------------------------------------------------------------------------------------------------------------,-X-X-.-.-.-.-.-.-.-.-.-.-.-.-.-,-X-X-X-X-X-X-X-X---------------------------------
------------------------------------------------------------------------------------------------------------------------------------------,-X-X-.-.-.-,-X-X-X-X-X-X-X-X-------------------------------------------------
----------------------------------------------------------------------------------------------------------------------------------------------,-X-X-X-X-----------------------------------------------------------------
