X-X-X-X-X-,-,-,-,-,-,-,-,-,-,-,-,-,-------------------------------------------------------------------------------------------------------------------------------
X-.-.-.-.-X-X-X-X-X-,-X-X-X-X-X-X-X-------------------------------------------------------------------------------------------------------------------------------
X-.-.-.-.-.-.-.-.-X-,-X1X1X2+Q+P+PXP------------------------------------------------------------------------------------------------------------------------------
X-.-.-.-.-.-.-.-.-X---X0,1+Q+Q+P+PXP------------------------------------------------------------------------------------------------------------------------------
X-.-.-.-.-.-.-.-.-X---X-,-.6,6+P+PXP------------------------------------------------------------------------------------------------------------------------------
X-.-.-.-.-.-.-.-.-X---X-,-.6.6,6,-X-------------------------------------------------------------------------------------------------------------------------------
X-.-.-.-.-.-.-.-.-X---X-,-,6,6,6.-X-------------------------------------------------------------------------------------------------------------------------------
X-.-.-.-.-.-.-.-.-X-,-X-,-.-.-,-,-X-------------------------------------------------------------------------------------------------------------------------------
X-.-.-.-.-.-.-.-.-X-,-X-,-,-,-,-.-X-------------------------------------------------------------------------------------------------------------------------------
X-.-.-.-.-.-.-.-.-X-,-X-.-E-.-.-.-X-------------------------------------------------------------------------------------------------------------------------------
X-.-.-.-.-.-.-.-.-X-,-X-.-.-.-E-.-X-------------------------------------------------------------------------------------------------------------------------------
X-.-.-.-.-.-.-.-.-X-,-X-.-.-.-.-.-X-------------------------------------------------------------------------------------------------------------------------------
X-.-.-.-.-.-.-.-.-X-,-X-.-.-.-.-.-X-------------------------------------------------------------------------------------------------------------------------------
X-.-.-.-.-.-.-.-.-X-,-X-.-.-.-.-.-X-------------------------------------------------------------------------------------------------------------------------------
X-.-.-.-.-.-.-.-.-X-,-X-,-,-,-,-,-X-------------------------------------------------------------------------------------------------------------------------------
X-.-.-.-.-.-.-.-.-X-,-X-,-,-,-,-,-X-------------------------------------------------------------------------------------------------------------------------------
X-.-.-.-.-.-.-.-.-X-,-X-.-.-.-.-.-X-,-----------------------------------------------------------------------------------------------------------------------------
X-.-.-.-.-.-.-.-.-X-X-.-.-.-.-.-.-.-X-------------------------------------,-,-------------------------------------------------------------------------------------
X-.-.-.-.-.-.-.-.-X-X-.-.-.-.-.-.-.-X-,-,-,-,-,-,-,-,-,-,-,-,-,-,-,-,-,-,-,-X-,-,---------------------------------------------------------------------------------
X-.-.-.-.-.-.-.-.-X-X-H-.-.-.-.-.-.-X-X-X~X~X~X~X~X~X~X~X~X-X-X-X-X-X~X~X~X~X-X-X-,-,-----------------------------------------------------------------------------
X-.-.-.-.-.-.-.-.-X-X-.-.-.-.-.-.-.-.-,-.~.~.~.~.~.~,~,~.-.-.-.-.-.-,-,~.~X~X-.-.-X-X-,-,-------------------------------------------------------------------------
X-.-.-.-.-.-.-.-.-X-X-.-.-.-.-.-.-.-E-,-,~,~.~.~.~.~,~.-.-,-,-,-,-.-.-,-.~X~X-.-.-.-.-X-X-,-,---------------------------------------------------------------------
X-.-.-.-.-.-.-.-,-X-X-X-,-X-X-,-X-X-X-,-,~,-,~.~.~.~,~.-.-,-.~.~,~.-.-,-.~X~X-.-.-.-.-.-.-X-X-,-,-----------------------------------------------------------------
X-.-.-.-.-.-.-.-,-X-X-X-,-X-X-,-X-X-X-,-,~.-,-,~,~.~,~.-.-,-.~.~,~.-.-,-,~X~X-.-.-.-.-.-.-.-.-X-X-,-,-------------------------------------------------------------
X-.-.-.-.-.-.-.-,-.-,-.-,-.-.-,-,-X-X~.~,~,-,-,~,-,~,~.-.-,-.~.~,~.-.-.-.-X-X-.-.-.-.-.-.-.-.-.-.-X-X-,-,---------------------------------------------------------
X-.-.-.-.-.-.-.-,-.-,-.-,-.-.-.-,-X-X~.~.~,~,-,~.-,~,~.-,-,-.~.~,~.-.-.-.-X-,-X-.-.-.-.-.-.-.-.-.-.-.-X-X-,-,-----------------------------------------------------
,-X-.-.-.-.-.-.-,-.-,-,-,-,-,-,-,-X-X~.~.~.~.~,~,-,-,~,-,-.~.~.~,~.-.-.-.-.-X-X-,-.-.-.-.-.-.-.-.-.-.-.-.-X-X-,-,-------------------------------------------------
,-X-.-.-.-.-.-.-,-.-,-,-,-,-,-,-.-X-X~.~.~.~.~.~.~.~.~.~.~.~.~.~,~.-.-.-.-.-.-.-,-,-.-.-.-.-.-.-.-.-.-.-.-.-.-X-X-,-,---------------------------------------------
,-X-.-.-.-.-.-.-,-,-,-,-,-,-.-.-.-X-X~X~X~X~X~X~X~X~X~X~X~X~X~X~X~X-X-X-X-.-.-.-.-,-,-.-.-.-.-.-.-.-.-.-.-.-.-.-.-X-X-,-,-----------------------------------------
,-X-.-.-.-.-.-.-,-,-,-.-.-.-.-.-.-X-X-X-X-X-X-X-X-,-,-,-,-X-X-X-X-X-X-X-X-.-.-.-.-,-,-,-.-.-.-.-.-.-.-.-.-.-.-.-.-.-.-X-X-,-,-------------------------------------
,-X-.-.-.-.-.-.-.-,-,-.-.-.-.-.-.-.-.-B-B-B-.-.-.-X-X-X-X-.-.-.-B-.-.-,-X-,-.-.-.-.-,-,-X-.-.-.-.-.-.-.-.-.-.-.-.-.-.-.-.-X-X-,-,---------------------------------
,-X-.-.-.-.-.-.-.-,-,-.-.-.-.-.-.-.-.-.-B-B-.-B-.-.-B-.-B-.-B-.-.-.-.-.-,-,-,-.-.-.-.-X-,-X-X-X-X-X-X-X-X-X-X-X-X-X-X-X-X-X-X-X-X---------------------------------
,-X-.-.-.-.-.-.-.-,-,-.-.-.-.-.-.-.-.-.-.-.-.-.-.-.-.-.-.-.-.-.-B-.-.-.-.-,-,-,-.-.-E-.-X-X-X-X-X-X-X-,-X-X-X-X-----------,-X-X-X---------------------------------
,-X-.-.-.-.-.-.-.-,-,-,-.-.-E-.-.-.-.-.-.-.-.-.-.-.-.-.-.-.-.-.-.-.-B-.-.-.-,-,-X-X-.-.-.-,-,-,-,-,-X-,-X-E-.-X-,-,-,-,-,-,-X-.-X---------------------------------
,-X-.-.-.-.-.-.-.-,-,-,-,-E-.-.-.-.-.-.-.-.-.-.-.-.-E-.-E-.-.-.-.-.-.-.-.-.-.-,-X-,-X-E-.-.-.-.-.-.-X-X-X-.-.-X-X-X-X-X-X-X-X-.-X---------------------------------
,-X-.-.-.-.-.-.-.-.-,-,-,-,-,-,-,-.-.-.-.-.-.-.-.-.-.-.-.-.-.-.-.-.-.-.-.-.-.-.-.-X-X-,-.-.-.-.-.-.-.-.-.-.-.-.-.-E-.-.-E-.-.-E-X---------------------------------
,-X-.-.-.-.-.-.-.-.-.-.-,-,-,-,-,-,-,-.-.-.-.-.-.-.-.-.-.-,-,-,-,-,-E-,-E-,-E-.-.-X-X-,-,-.-.-.-.-.-.-.-.-.-.-.-.-.-.-.-.-.-.-.-X---------------------------------
,-X-.-.-.-.-.-.-.-.-.-.-.-.-.-,-,-,-,-,-,-.-.-.-.-.-.-.-.-,-.-.-.-.-.-.-.-,-.-.-.-X-X-.-,-E-,-,-,-,-,-,-,-,-.-.-.-.-.-.-.-.-.-.-X---------------------------------
,-X-.-.-.-.-.-.-.-.-.-.-.-.-.-.-.-,-,-,-,-.-.-.-.-.-.-.-.-,-,-,-,-,-,-,-,-,-.-.-.-X-X-X-X-.-.-.-X-X-X-.-.-X-X-X-.-.-.-.-.-.-.-E-X---------------------------------
,-X-.-.-.-.-.-.-.-.-.-.-.-.-.-.-.-.-.-,-,-.-.-.-.-.-.-.-.-,-X-X-L-L-L-L-X-X-X-X-X-X---,-X-.-.-.-X-,-X-.-.-X-,-X-.-.-.-.-.-.-X-X-X---------------------------------
,-X-.-.-.-.-.-.-.-.-.-.-.-.-.-.-.-.-.-,-,-.-.-.-.-.-.-.-.-.-X-X-.-.-.-.-X-X-X-X-,-----,-X-X-X-X-X-,-X-X-X-X-,-X-.-.-.-.-.-.-X-------------------------------------
,-X-.-.-.-.-.-.-.-.-.-.-.-.-.-.-.-.-.-,-,-.-.-.-.-.-.-.-.-,-X-X-H-.-.-.-,-,-,-X-,-,-,-,-,-,-,-,-,-,-,-,-,-,-,-X-,-,-,-,-,-,-X-,-,---------------------------------
,-X-.-.-.-.-.-.-.-.-.-.-.-.-.-.-.-.-.-,-,-.-.-.-.-.-.-.-.-,-X-X-.-.-,-,-,-E-,-,-X-X-X-X-X-X-X-X-X-X-X-X-X-X-X-X-.-.-.-.-.-.-X-X-X---------------------------------
,-X-.-.-.-.-.-.-.-.-.-.-.-.-.-.-.-.-.-,-,-.-.-.-.-.-.-.-.-,-,-,-,-,-,-.-.-.-,-.-,-.-.-.-,-.-.-.-E-.-.-.-.-,-.-.-.-.-.-.-.-.-.-H-X---------------------------------
,-X-.-.-.-.-.-.-.-.-.-.-.-.-.-.-.-.-.-,-,-.-.-.-.-.-.-.-.-.-,-,-,-.-.-.-.-,-,-.-,-.-.-.-,-.-.-.-,-.-.-.-.-,-.-.-.-.-.-.-.-.-.-.-X---------------------------------
,-X-.-.-.-.-.-.-.-.-.-.-.-.-.-.-.-.-.-,-,-.-.-.-.-.-.-.-.-.-,-,-,-.-.-.-.-,-.-.-,-.-.-.-,-.-.-.-,-.-.-.-.-,-.-.-.-.-.-.-.-.-.-.-X---------------------------------
,-X-.-.-.-.-.-.-.-.-.-.-.-.-.-.-.-.-.-,-,-.-.-.-.-.-.-.-.-.-.-,-,-X-.-.-,-,-.-.-,-.-.-.-,-.-.-.-,-.-E-.-.-,-.-.-.-.-.-.-.-.-.-.-X---------------------------------
,-X-.-.-.-.-.-.-.-.-.-.-.-.-.-.-.-.-.-,-,-.-.-.-.-.-.-.-.-.-.-,-X-,-X-,-,-.-.-.-,-.-.-.-,-.-.-.-,-.-.-.-.-,-.-.-.-.-.-.-.-.-.-.-X---------------------------------
,-X-.-.-.-.-.-.-.-.-.-.-.-.-.-.-.-,-,-,-,-.-.-.-.-.-.-.-.-.-.-.-.-X-X-,-,-,-.-.-,-.-.-.-,-.-.-.-,-.-.-.-.-,-.-.-.-.-.-.-.-.-.-.-X---------------------------------
,-X-.-.-.-.-.-.-.-.-.-.-.-.-,-,-,-,-,-,-,-.-.-.-.-.-.-.-.-.-.-.-.-.-.-,-,-,-,-X-X-,-,-,-,-,-E-,-,-,-,-,-,-,-.-.-.-.-.-.-.-.-.-.-X---------------------------------
,-X-.-.-.-.-.-.-.-.-.-,-,-,-,-,-,-,-,-.-.-.-.-.-.-.-.-.-.-.-.-.-.-.-.-.-.-,-X~X-,-X-.-.-.-,-X-X-X-,-,-,-,-X-X-X-.-.-.-.-.-.-.-E-X---------------------------------
,-X-.-.-.-.-.-.-.-,-,-,-,-,-,-,-.-.-.-.-.-.-.-.-.-.-.-.-.-.-.-.-.-.-.-.-.-,-,-.~X~X~,-,-,-,-X-X-X-,-,-.-.-X-X-,-X-.-.-.-.-.-,-X-----------------------------------
,-X-.-.-.-.-,-,-,-,-,-,-,-.-.-.-.-.-.-.-.-.-.-.-.-.-.-.-.-.-.-.-.-.-.-.-.-.-,-.~.~,~------,-.-,-,-.-,-,-.-E-X---,-X-.-E-.-.-X-------------------------------------
,-X-.-,-,-,-,-,-,-,-,-.-.-.-.-.-.-.-.-.-.-.-.-.-.-.-.-.-.-.-.-.-.-.-.-.-.-.-,-,-.~,~--,-,-,-.-,-,-.-.-,-,-.-X---,-X-,-,-,-,-X-------------------------------------
,-X-,-,-,-,-,-,-.-.-.-.-.-,-,-,-,-.-.-.-.-.-.-.-.-.-.-.-E-.-.-.-.-.-.-.-.-.-.-,-.~,~,-,-..,...,-,-.-.-.-,-,-X---,-X-.-.-.-,-X-------------------------------------
,-X-,-,-,-.-.-.-.-.-.-,-,-,-.-.~,-,-,-.-.-.-.-.-.-.-.-.-.-.-.-.-.-.-.-.-.-.-.-,-.~.~.~.~.~,~,~.-.-.-.-.-.-,-X---,-X-.-.-.-,-X-,-----------------------------------
,-X-,-,-.-.-.-.-,-,-,-,-.-.~.~.~.~.~,-,-,-.-.-.-.-.-.-.-.-.-.-.-.-.-.-.-.-.-.-,-,-.~.~.~.~.~,~.-.-.-.-.-.-.-X---,-X-,-,-,-,-.-X-----------------------------------
,-X-,-,-.-.-,-,-,-.-.~.~.~.~.~.~.~.~.~.~,-,-,-.-.-.-.-.-.-.-.-.-.-.-.-.-.-.-.-.-,-.~.~.~.~.~,~,..-.-.-.-.-B-X---,-X-.-.-.-,-.-X-----------------------------------
,-X-,-,-.-.-,-.~.~.~.~.~.~.~.~.~.~.~.~.~.~.~,-,-,-.-.-.-.-.-.-.-.-.-.-.-.-.-.-.-,-.~.~.~.~.~.~,~.-.-.-.-.-,-X-,-,-X-.-.-.-,-.-X-----------------------------------
,-X-,-,-.-.-,-.~.~.~.~.~.~.~.~.~.~.~.~.~.~.~.~.~,-,-E-.-.-.-.-.-.-.-.-.-.-.-.-,-,-.~.~.~.~.~.~,~,~.-.-.-,-,-.~X~,-X-,-,-,-,-.-X-,---------------------------------
,-X-,-,-.-.-,-.~.~.~.~.~.~.~.~.~.~.~.~.~.~.~.~.~.~,~.-.-.-.-.-.-.-.-.-.-.-.-,-,-.~.~.~.~.~.~.~.~,~,-,-,-,-.~.~.~X~X-.-.-.-,-.-.-X---------------------------------
,-X-,-,-.-.-,-.~.~.~.~.~.~.~.~.~.~.~.~.~.~.~.~.~.~,~.-.-.-.-.-.-.-.-.-.-.-,-,-.~.~.~.~.~.~.~.~.~.~.~.~.~.~.~.~.~,~,-.-.-.-,-.-.-X---------------------------------
,-X-,-,-.-.-,-.~.~.~.~.~.~.~.~.~.~.~.~.~.~.~.~.~.~,~.-.-.-.-.-.-.-.-.-.-,-,-.~.~.~.~.~.~.~.~.~.~.~.~.~.~.~.~.~.~,~,-,-,-,-,-.-.-X---------------------------------
,-X-,-,-.-.-,-.~.~.~.~.~.~.~.~.~.~.~.~.~.~.~.~.~.~,~.-.-.-.-.-.-.-.-.-,-,-.~.~.~.~.~.~.~.~.~.~.~.~.~.~.~.~.~.~.~,~,-.-.-.-,-.-.-X-,-------------------------------
,-X-,-,-.-.-,-.~.~.~.~.~.~.~.~.~.~.~.~.~.~.~.~.~.~,~.-.-.-.-.-.-.-.-,-,-.~.~.~.~.~.~.~.~.~.~.~.~.~.~.~.~.~.~.~.~,~,-.-.-.-,-,-.-.-X-------------------------------
,-X-,-,-.-.-,-.~.~.~.~.~,~,~,~,~.~.~.~.~.~.~.~.~.~,~.-.-.-.-.-.-.-,-,-.~.~.~.~.~.~.~.~.~.~.~.~.~.~.~.~.~.~.~.~.~,~,-.-.-.-.-,-.-.-X-------------------------------
,-X-,-,-.-.-,-.~.~.~,~,~,~.~.-,~,~,~.~.~.~.~.~.~.~,~.-.-.-.-.-.-.-,-.~.~.~.~.~.~.~.~.~.~.~.~.~.~,~,~,~.~.~.~.~.~,~,-,-,-,-,-,-,-.-X-------------------------------
,-X-,-,-.-.-,-.~,~,~,~.~.-.-.-.-.-,~,~,~.~.~.~.~.~,~.-.-.-.-.-.-.-,-.~.~.~.~.~.~.~.~.~.~.~.~.~.~,~./,/,/,~.~.~,~X~X-.-.-.-.-.-,-,-X-,-----------------------------
,-X-,-,-.-.-,-.~,~.-.-.-.-.-.-.-.-.-.-,~,~,~.~.~.~,~.-.-.-.-.-.-.-,-.~.~.~.~.~.~.~.~.~.~.~.~,~,~,-,/,/,/,/,~,~X~,-X-,-,-,-,-,-,-,-,-X---,-,-,-,-,-,-,-,-----------
,-X-,-,-.-.-,-.~,~.-.-.-.-.-.-E-.-.-.-.-.-,-.~.~.~,~.-.-.-.-.-.-.-,-.~.~.~.~.~.~.~.~.~.~.~,~,~------------,-X-,-,-X-.-.-.-.-.-.-.-,-X---,-X-X-X-X-X-X-X-----------
,-X-,-,-.-.-,-.~,~.-.-.-.-.-.-.-.-.-.-.-.-,-.~.~.~,~.-.-.-.-.-.-.-,-,~,~,~.~.~,~,~,~.~,~,~,-----------E-,-,-X-,-X-.-.-.-.-.-.-.-.-.-X-,-,-X-.-.-.-.-.-X-,-,-------
,-X-,-,-.-.-,-.~,~.-.-.-.-.-H-.-.-.-.-.-.-,-.~.~.~,~.-.-.-.-,-,-,-X-X~X-,-,~,~,~,-X-X~X~,-,-----------,-,-,-X-X-.-.-.-.-.-.-.-.-.-.-.-X-X-.-.-.-.-.-.-.-X-X-,-----
,-X-,-,-.-.-,-.~,~.-.-.-.-.-.-.-.-.-.-.-.-,-.~.~.~,~.-.-.-.-,-,-,-X-X-X-.-.5.5.5.-X-X-X-,-,-----------,-,-,-X-X-.-.-E-.-.-.-.-.-.-E-.-,-.-.-.-.-.-.-.-.-,-X-X-,---
,-X-,-,-.-.-,-.~,~.-.-.-.-.-.-E-.-.-.-,-,-,-.~.~.~,~.-.-.-.-,-,-,-X-X-.-E-.-K5.-.-E-X-X-,-,-----------,-,-,-L-.-.-.-.-.-.-.-.-.-.-.-.-,-.-.-.-.-.-.-.-.-,-X-X-X-,-
,-X-,-,-.-.-,-.~,~,-,-.-.-.-.-.-.-,-,-,-.~.~.~.~.~,~.-.-.-.-,-,-,-L-.-.-.-.-.-.-.-.-L-,-,-,-----------,-,-,-L-.-.-.-.-.-E-.-.-.-.-.-.-,-.-.-.-.-.-.-.-.-,-X-X-,-X-
,-X-,-,-.-.-,-.~.~.~,~,~,-,-.-,-,-,-.~.~.~.~.~.~.~,~.-.-.-.-,-,-,-X-X-.-.-.-.-.-.-,-X-X-,-,-----------,-,-,-L-.-.-.-.-.-.-.-.-.-.-.-.-,-.-.-.-.-.-.-.-.-,-X-X-X---
,-X-,-,-.-.-,-.~.~.~.~.~.~,~,~,-.~.~.~.~.~.~.~.~.~,~.-.-.-.-,-,-,-X-X-.-.-.-.-.-.-,-X-X-,-,-----------,-,-,-L-.-.-.-.-.-.-E-.-.-.-.-.-,-.-.-E-.-.-.-E-.-,-X-X-X---
--,-X-,-.-.-,-.~.~.~.~.~.~.~.~.~.~.~.~.~.~.~.~.~.~,~.-.-.-.-.-.-,-.-,-.-.-.-.-.-.-,-E-.-,-,-----------,-,-,-X-X-.-.-.-.-.-.-.-.-.-.-.-,-.-.-.-.-.-.-.-.-,-X-X-----
--,-X-,-.-.-,-.~.~.~.~.~.~.~.~.~.~.~.~.~.~.~.~.~.~,~.-.-.-.-.-.-,-X-X-E-,-,-,-,-,-,-X-X-,---B---------,-,-,-X-X-.-.-.-.-.-.-.-.-.-.-,-X-X-.-.-.-E-.-.-,-X-X-------
--,-X-,-.-.-,-.~.~.~.~.~.~.~.~.~.~.~.~.~.~.~.~.~.~,~.-.-.-.-.-.-.-.-X-X-,-,-,-,-,-,-X-X---B-----------------X-,-X-.-.-.-.-.-.-.-.-.-X---,-X-,-,-,-,-,-X-----------
--,-X-,-.-.-,-.~.~.~.~.~.~.~.~.~.~.~.~.~.~.~.~.~.~,~.-.-.-.-.-.-.-.-,-X-X-.-.-.-.-X---X---------------------X---,-X-,-,-,-,-,-,-,-,-X-,-,-X-.-.-.-.-.-X-,---------
--,-X-,-.-.-,-.~.~.~.~.~.~.~.~.~.~.~.~.~.~.~.~.~.~,~.-.-.-.-.-.-.-.-E-,-,-,-,-,-,-X---X-----------------------X-,-,-X-,-.-.-.-.-.-.-.-X-X-.-.-.-.-.-.-.-X---------
--,-X-,-.-.-,-.~.~.~.~.~.~.~.~.~.~.~.~.~.~.~.~,~,~,~.-.-.-.-.-.-.-,-,-.-.-.-.-.-.-X---X-------------------B-----X-X-.-,-,-,-,-,-,-,-,-X-X-.-.-.-.-.-.-.-X---------
--,-X-,-.-.-,-.~.~.~.~.~.~.~.~.~.~.~.~.~.~,~,~,~.-.-.-.-.-.-.-.-.-,-,-,-,-,-,-,-,-X-X-------------------E---------,-.-.-,-.-.-.-.-.-.-X-X-.-.-.-.-.-.-.-X---------
--,-X-,-.-.-,-,~,~.~.~.~.~.~.~.~.~.~.~,~,~,~.-.-.-.-.-.-.-.-.-.-.-,-X-X-.-.-.-.-,-X-X-----------------------------,-,-.-,-.-.-.-.-.-.-X-X-.-.-.-.-.-.-.-X---------
--,-X-,-.-.-.-.-,-,-,~.~.~.~.~.~.~,~,~,~.-.-.-.-.-.-.-.-.-.-.-.-.-,-X-X-,-,-,-,-X---X-------------------------------,-.-,-,-,-,-.-.-X-,-X-.-.-.-.-.-.-.-X---------
--,-X-,-,-.-.-.-.-.-,-,-,-,~.~,~,~,~.-.-.-.-.-.-.-.-.-.-.-.-.-.-.-,-X-X-.-.-.-.-X---X-------------------E-----------,-.-,-.-.-,-,-,-X-,-X-.-.-.-.-.-.-.-X---------
--,-X-,-,-,-,-,-.-.-.-.-.-,-,-,~.-.-.-.-.-.-.-.-.-.-.-.-.-.-.-.-.-E-,-.-.-.-.-.-X---X-----,-,-,-,-----------------,-,-.-,-.-.-.-.-.-X-,-X-.-.-.-.-.-.-.-X---------
--,-X-,-,-.-.-,-,-,-.-.-.-.-.-.-.-.-.-.-.-.-.-.-.-.-.-.-.-.-.-.-,-,-,-,-,-,-,-,-X---X-----,-,-,-,-----------------,-.-.-,-,-.-.-.-.-X-,-X-.-.-.-.-.-.-.-X---------
--,-X-,-,-,-,-.-.-,-,-,-,-.-.-.-.-.-.-.-.-.-.-.-.-.-.-.-.-.-.-.-,-,-.-.-.-.-.-.-X-X-----,-,-.-.-,-,-------------X-X-X-X-X-,-,-,-.-X-,-,-X-.-.-.-.-.-.-.-X---------
--,-X-,-.-.-,-,-,-,-.-.-,-,-,-,-.-.-.-.-.-.-.-.-.-.-.-.-.-.-.-.-,-X-X-,-,-,-,-,-X-X-A---,-A-.-.-.-,-A-------A-X-,-,-,-X-.-.-.-,-,-X---,-X-.-.-.-.-.-E-.-X---------
--,-X-,-.-.-.-.-.-,-,-,-.-.-.-,-,-,-.-.-.-.-.-.-.-.-.-.-.-.-.-.-,-X-X-.-.-.-.-.-X-X-X-X-X-X-XT+T+TXTX-X-X-X-X-,-X-X-X-,-.-.-.-.-,-X---,-X-.-.-.-.-.-.-.-X---------
--,-X-,-.-.-.-.-.-.-.-,-,-,-,-.-.-,-,-,-.-.-.-.-.-.-.-.-.-.-.-.-,-X-X-.-.-.-.-.-X-X-X-X-X-X-XT+T+TXTX-X-X-X-X-X-,-.-.-,-,-.-.-,-X-----,-X-.-.-X-X-.-.-.-X---------
--,-X-,-.-.-.-.-.-.-.-.-.-.-,-,-,-.-.-,-.-.-.-.-.-.-.-.-.-.-.-,-,-,-.-.-.-.-.-.-.-.-.-.-.-.-.-E-.-.-.-.-.-.-X-X-,-.-E-.-,-E-.-X-------,-X-.-E-X-X-.-.-.-X---------
--,-X-,-.-.-.-.-.-.-.-.-.-.-.-.-,-,-.-,-.-.-.-.-.-.-.-.-.-.-.-,-.-,-.-.-.-.-E-.-.-.-.-.-.-.-.-.-.-.-.-.-.-.-.-,-,-.-.-.-.-,-,-X-------,-X-.-.-.-.-.-E-.-X---------
--,-X-,-.-.-.-.-.-.-.-.-.-.-.-.-.-,-.-,-.-.-.-.-.-.-.-.-.-.-.-,-.-,-.-.-.-.-.-.-.-.-.-.-.-.-.-.-.-.-.-.-E-.-.-,-,-,-.-.-,-,-X---------,-X-.-.-.-.-.-.-.-X---------
--,-X-,-.-.-.-.-.-.-.-.-.-.-.-.-.-,-.-,-.-.-.-.-.-.-.-.-.-.-.-,-.-,-.-.-.-.-.-.-.-.-.-.-.-.-.-.-.-.-.-.-.-.-.-,-.-,-,-,-X-X---------,-,-X-.-.-.-.-.-.-X-,---------
--,-X-,-.-.-.-.-.-.-.-.-.-.-.-.-.-H-.-,-.-.-.-.-.-.-.-.-.-.-.-,-.-,-.-.-.-.-.-.-.-.-.-.-.-E-.-.-.-.-.-.-.-.-X-X-,-X-X-X-------------,-X-.-.-.-.-.-.-.-X-----------
--,-X-,-.-.-.-.-.-.-.-.-.-.-.-.-.-,-.-,-.-.-,-,-,-,-,-,-.-.-.-,-.-,-,-.-.-.-.-.-.-.-,-,-,-,-,-,-,-,-,-,-,-,-X-X-X-------------------,-X-.-.-.-.-.-.-,-X-----------
--,-X-,-.-.-,-,-,-,-,-,-.-.-.-.-.-,-.-,-.-.-X-X-.-E-,-X-X-.-.-,-,-.-,-.-.-.-.-.-.-.-,-.-.-A-.-.-.-.-.-.-.-.-X---------------------,-,-X-.-.-.-.-.-.-X-------------
--,-X-,-,-,-,-,-XWXW+WXWX-,-.-.-.-,-.-,-.-,-X-X-,-,-X-,-X-.-.-.-,-X-X-.-.-H-.-.-.-X-X-X-.-.-.-.-.-.-.-X-X-X-X-------------------,-,-X-.-.-.-.-.-.-,-X-------------
--,-X-,-,-,-+W+WX-X7.7X7X-,-,-,-.-,-.-,-.-X-,-X-,-,-X---,-X-.-.-H-X-X-X-X-X-X-X-X-X-,-X-X-X-X-X-X-X-X-X-----------------------,-,-X-.-.-.-.-.-.-,-X---------------
--,-X-X-+W+W.-.-.-<-<-<-.-.-.-,-,-X-X-X-X-X-,-X-X-E-X---,-X-X-X-X-X---------------------------------,-,-,-,-,-,-,-,-,-,-,-,-,-,-X-.-.-.-.-.-.-.-X-----------------
--,-X-X-.-.-.-.-<-.-.-.-.-.-.-.-.-X-X---,-,-,-,-XS.3XS,-,---------------------------------------,-,-,-X-X-X-X-X-X-X-X-X-X-X-X-X-X-X-.-.-.-.-.-X-,-----------------
--,-X-.-.-.-.-.-.-.-.-.-.-.-.-.-.-.-X-,-,-X-X-X-.-.-X-X-X-,-----------------------------------,-,-X-X-.-.-.-.-.-.-.-.-.-.-.-.-.-X-X-,-,-.-E-,-X-------------------
--,-X-.-.-.-.-.-.-.-.-.-.-.-.-.-.-.-X-X-X-X-.-.-.-.-.-.-X-X-,-,-,-------------------------,-,-X-X-.-.-.-.-.-.-.-.-.-.-.-.-.-.-.-.-.-.-,-X-,-X---------------------
--,-X-.-.-.-.-.-.-.-.-.-.-.-.-.-.-.-.-,-,-.-.-.-.-.-.-.-,-X-X-X-X---------------------,-,-,-X-.-.-.-.-.-.-.-.-.-.-.-.-.-.-.-.-.-.-.-.-.-X-X-----------------------
--,-X-.-.-.-.-.-.-.-.-.-.-.-.-.-.-.-.-,-,-.-.-.-.-.-.-.-,-.-.-.->-------------------,-,-X-X-.-.-.-,-,-E-,-,-,-,-,-,-.-.-.-.-.-.-.-.-.-.-.-X-,---------------------
--,-X-.-.-.-.-.-.-.-.-.-.-.-.-.-.-.-.-,-,-.-.-.-.-.-.-.-,-.-.-.->-------------------,-X-.-.-.-,-,-,-,-,-,-,-,-,-,-,-,-,-.-.-.-.-.-.-.-.-.-.-X---------------------
----,-X-.-.-.-.-.-.-.-.-.-.-.-.-.-.-.-,-,-.-.-.-.-.-.-.-,-X-X-X-X-------------------,-X-.-.-,-X-,-.-.-.-.-.-.-.-.-.-.-,-,-X-.-.-.-.-.-.-.-.-X---------------------
------,-X-.-.-.-.-.-.-.-.-.-.-.-:-.-X-X-X-X-,-,-,-,-,-,-X-X-------------------------,-X-.-.-X-X-X-.-.-.-.-.-.-.-.-.-.-.-X-X-X-.-.-.-.-.-.-.-X---------------------
--------,-X-X-X-X-,-,-,-X-X-.-.-.-.-X---,-X-,-,-,-,-,-,-X---,-,-,-,-------,-,-------,-X-.-.-X-X-X-.-.-.-.-.-.-.-.-E-.-,-X-X-X-.-.-.-.-.-.-.-X---------------------
--------------,-X-.-A-,-X;XY.-.-.-.-X-,-,-X-.-.-.-.-.-.-X-,-,-X-X-X-,-,-,-,-XY,---,-,-X-.-.-X-X-X-.-.-.-.-.-.-.-.-.-.-,-X-X-X-.-.-.-.-.-.-.-X---------------------
--------------,-X-X-X-X-X;+Y.-.-.-.-.-X-X-.-.-.-.-.-.-.-.-X-X-.-,-X9X-X-X-XYXYXY,-,-X-X-.-.-,-.-,-.-.-,-,-,-,-E-.-.-,-,-.-,-.-.-.-.-.-.-.-.-X---------------------
----------------------,-X;XY.-.-.-.-.-.-.-.-.-.-.-.-.-.-.-.-.-.-,-,9.-.-,-.-.-XYX-X-,-.-.-.-,-.-,-,-,-,-,-.-,-,-,-,-,-.-.-,-.-.-.-E-.-.-.-.-X-,-------------------
--------------------------,-X-.-.-.-.-.-.-.-.-.-.-.-.-.-.-.-.-.-,-,9.-E-,-.-.-.-.-.-,-.-.-.-,-.-.-.-.-,-.-.-.-,-.-.-.-.-.-,-.-.-.-.-.-.-.-.-X-X-------------------
----------------------------,-X-.-.-.-.-.-.-.-.-.-E-.-.-.-.-.-.-,-,9.-.-,-.-.-.-.-.-,-.-.-.-,-.-.-.-.-,-,-.-W-,-.-.-.-.-.-,-.-.-.-.-.-.-.-H-X-X-------------------
------------------------------,-X-.-.-.-.-.-.-.-.-.-.-.-.-.-.-.-,-,9.-.-,-.-.-.-.-.-,-.-.-.-,-,-,-,-,-,-,-,-,-,-,-,-,-,-,-,-.-.-.-.-.-.-.-.-X---------------------
--------------------------------,-X-X-.-.-.-.-.-.-.-:-.-.-.-.-.-,-,9.-.-,-,-,-X-X-X-,-.-.-.-,-,-.-.-.-.-.-.-.-.-.-.-.-.-,-,-.-.-.-.-.-.-.-.-X---------------------
------------------------------------,-X-X-X-.-.-.-.-.-.-.-.-.-.-,-X9X-X-X-X-X-X---,-X-X-.-,-,-X-.-.-.-.-.-.-.-.-.-E-.-.-,-X-.-.-.-.-.-.-.-.-X---------------------
------------------------------------------,-X-X-X-X-X-X-X-X-X-X-X-X-,-,-,-,-,-,-,-,-,-X-.-,-X-X-X-.-.-.-.-.-.-.-.-.-.-.-X-X>X-.-.-.-.-.-.-.-X---------------------
------------------------------------------,-X-X-X-X-X-X-X-X-X-X-X-X-X-X-X-X-X-X-X-X-X-X-.-.-X-X-X-.-.-.-.-.-.-.-.-.-.-.-X-X>X-.-.-.-.-.-.-,-X---------------------
--------------------------------------------,-X-.-.-.-.-.-.-.-.-.-.-.-.-.-.-.-.-.-.-X-X-.-.-X-X-X-,-.-.-.-.-.-.-.-.-.-,-X-X-X-.-.-A-.-A-X-X-X---------------------
----------------------------------------------,-X-.-.-.-.-.-.-.-.-.-.-.-.-.-.-.-.-.-X-X-.-.-.-.-.-,-,-.-.-.-.-.-.-,-,-,-.-.-.-A-A-,-X-X-X-X-X---------------------
------------------------------------------------,-X-.-.-.-.-.-.-.-.-.-.-.-.-.-.-.-.-X-X-.-.-.-.-.-.-,-E-,-,-,-,-,-,-.-.-.-.-.-,-X-X-X-X-.-X-----------------------
--------------------------------------------------,-X-X-.-.-.-.-.-.-.-.-.-.-.-.-.-.-X-X-.-.-.-.-.-.-.-.-.-.-.-.-.-.-.-.-.-.-,-X-,-X-.-.-,-X-----------------------
------------------------------------------------------,-X-.-.-.-.-.-.-.-.-.-.-.-.-.-X-X-.-.-.-.-.-.-.-.-.-.-.-.-.-.-.-.-.-,-X-X-X-.-.-.-X-------------------------
--------------------------------------------------------,-X-.-.-.-.-.-.-.-.-.-.-.-.-X-X-X-X-X-X-X-,-,-X-X-,-,-,-X-X-,-,-X-X-X-,-,-,-.-,-X-------------------------
----------------------------------------------------------,-X-.-.-.-.-.-.-.-.-.-.-.-X-X-X-X-X-X-X-.-.-X-X-,-,-,-X-X-.-.-X-X-.-.-.-,-.-X---------------------------
------------------------------------------------------------,-X-.-.-.-.-.-.-.-.-.-.-.-,-,-.-.-.-.-.-.-.-.-.-.-.-.-.-.-.-.-.-.-.-,-,-.-X---------------------------
--------------------------------------------------------------,-X-.-.-.-.-.-.-.-.-.-.-.-,-.-.-.-.-.-.-.-.-.-.-.-.-.-.-.-.-.-.-.-,-.-,-X---------------------------
----------------------------------------------------------------,-X-.-.-.-.-.-.-.-.-.-.-,-,-.-.-.-.-.-.-.-.-.-.-.-.-.-.-.-.-.-,-,-.-X-----------------------------
------------------------------------------------------------------,-X-X-.-.-.-.-.-.-.-.-.-,-.-.-.-.-.-.-.-.-.-.-.-.-.-.-.-.-.-,-.-,-X-----------------------------
----------------------------------------------------------------------,-X-.-.-.-.-.-.-.-.-,-.-.-.-.-.-.-.-.-.-.-.-.-.-.-.-.-.-,-.-X-------------------------------
------------------------------------------------------------------------,-X-.-.-.-.-.-.-.-,-,-.-.-.-.-.-.-.-.-.-.-.-.-.-.-.-,-,-,-X-------------------------------
--------------------------------------------------------------------------,-X-.-.-.-.-.-.-.-,-.-.-.-.-.-,-,-,-.-.-.-.-.-.-.-,-.-X---------------------------------
----------------------------------------------------------------------------,-X-.-.-.-.-.-.-,-.-.-.-.-.-,-.-,-,-,-.-.-.-.-.-,-.-X---------------------------------
------------------------------------------------------------------------------,-X-.-.-.-.-.-,-,-.-.-.-,-,-.-.-.-,-.-,-,-.-,-,-,-X---------------------------------
--------------------------------------------------------------------------------,-X-.-.-.-.-.-,-.-.-.-,-.-.-.-.-,-,-,-,-.-,-.-X-----------------------------------
----------------------------------------------------------------------------------,-X-X-.-.-.-,-,-.-.-,-,-.-H-.-,-,-.-,-,-,-,-X-----------------------------------
--------------------------------------------------------------------------------------,-X-.-.-.-,-,-,-,-,-,-,-,-,-,-,-,-,-.-X-------------------------------------
----------------------------------------------------------------------------------------,-X-.-.-.-.-.-.-,-,-,-,-.-.-.-,-,-,-X-------------------------------------
------------------------------------------------------------------------------------------,-X-.-.-.-.-.-.-,-,-,-.-.-.-.-.-X---------------------------------------
--------------------------------------------------------------------------------------------,-X-X-X-X-X-X-X-X-X-X-X-X-X-X-X---------------------------------------
