----------------------------------------------------,-,-X-X-X-,-,-,-,-,-----------------------------------------------------------------------------------------------------------------------------------------------------------------------------------------------------------------------------------
------------------------------------------------,-,-X-X-,-,-.-X-X-X-X-,-,-,---------------------------------------------------------------------------------------------------------------------------------------------------------------------------,-,-,-,-,-,-----------------------------------------
--------------------------------------------,-,-X-X-.-.-.-,-.-.-.-.-.-X-X-X-------------------------------------------------------------------------------------------------------------------------------------------------------------------------,-,-X-X-X-X-X-,-,-------------------------------------
----------------------------------------,-,-X-X-.-.-.-.-.-,-.-.-.-.-.-.-.-X-----------------------------------------------------------------------------------------------------------------------------------------------------------------------,-,-X-.-.-.-.-.-X-X-,-----------------------------------
------------------------------------,-,-X-X-.-.-.-.-.-.-,-,-.-.-.-.-.-.-.-X---------------------------------------------------------------------------------------------------------------------------------------------------------------------,-,-X-.-.-.-.-.-.-.-.-X-----------------------------------
----------------------------------,-,-X-.-.-.-.-.-.-.-.-,-.-.-.-.-.-.-.-.-X---------------------------------------------------------------------------------------------------------------------------------------------------------------------,-X-.-.-.-.-.-.-.-.-.-X-,---------------------------------
----------------------------------,-.-X-.-.-.-.-.-.-.-.-,-.-.-.-.-.-.-.-.-X-------------------------------------------------------------------------------------------------------------------------------------------------------------------,-,-X-.-.-.-.-.-.-.-.-.-.-X---------------------------------
--------------------------------,-,-X-.-.-.-.-.-.-.-.-.-,-.-.-E-.-.-.-.-.-X-------------------------------------------------------------------------------------------------------------------------------------------------------------------,-X-.-.-.-.-.-.-.-.-.-.-.-X-,-------------------------------
--------------------------------,-.-X-.-.-.-.-.-.-.-,-X-X-.-.-.-.-.-.-.-.-X---------------------------------------------------------------------------------------,-,-,-,-,-,---------------------------------------------------------------,-,-X-.-.-.-.-.-.-.-.-.-.-.-.-X-------------------------------
------------------------------,-,-X-,-,-,-.-.-,-,-,-X-,-,-X-.-.-.-.-.-.-,-X-,-----------------------------------------------------------------------------------,-,-X-X-X-X-X-------------------------------------------------------------,-,-X-.-.-.-.-.-.-.-.-.-.-.-.-.-X-------------------------------
----------------,-,-,-,-,-,-,-,-,-X-.-.-,-,-,-,-.-X-----,-X-.-.-.-.-.-,-,-.-X-,-----------------,-,-,-,-,-------------------------------------------------------,-.-X-<-<-<-,-X-----------------------------------------------------------,-X-.-.-.-.-.-,-X-X-.-.-.-.-.-,-X-------------------------------
------------,-,-,-X-X-X-X-X-X-X-X-.-.-.-.-.-.-.-,-X-------,-X-.-.-.-,-,-.-.-.-X-,-----,-,-,-,-,-,-X-X-X-X-,-,-,-------------------------------------------------,-X-<-.-.-.-,-X---------------------------------------------------------,-,-X-.-.-.-.-,-X-,-X-.-E-.-.-.-X---------------------------------
--------,-,-,-X-X-.-.-.-.-.-.-.-.-.-.-.-.-.-.-.-X---------,-X-.-.-.-,-.-.-.-.-.-X---,-,-X-X-X-X-X-.-.-.-.-X-X-X---------------------------------------------------,-X-.-.-.-X---------------------------------------------------------,-,-X-.-.-.-.-.-X---,-X-.-.-.-.-E-X---------------------------------
----,-,-,-X-X-.-,-,-.-.-E-.-.-.-.-.-.-.-.-.-.-.-X---------,-X-.-.-,-,-.-.-.-.-.-X-,-,-X-.-.-.-.-.-.-.-.-.-.-.-X-,-----------------------------------------------,-,-X-.-.-.-,-X-----------------------------------------------------,-,-X-.-.-.-.-.-,-X---,-X-.-.-.-.-,-X---------------------------------
--,-,-X-X-.-.-.-.-,-.-.-.-.-.-.-.-.-.-.-.-.-.-.-X---------,-X-.-,-,-.-.-.-.-.-.-,-X-,-X-.-.-.-.-.-.-.-.-.-.-.-.-X-----------------------------------------------,-X-.-.-.-.-,-X-----------------------------------------------------,-X-.-.-.-.-.-.-X---,-,-X-.-.-.-.-X-----------------,-,-,-,-----------
,-,-X-.-.-.-.-.-.-,-.-.-.-.-.-.-.-.-.-E-.-.-.-,-X-----------,-X-,-.-.-.-.-.-.-,-,-X-X-X-.-.-.-.-.-.-.-.-.-.-.-.-X-,-----------------------------------------------,-X-.-.-.-X-----------------------------------------------------,-,-X-.-.-.-.-.-,-X---,-X-.-.-.-.-,-X-----------,-,-,-,-X-X-X-,-,-------
,-X-.-.-.-.-.-.-.-,-.-.-.-.-.-.-.-,-,-,-.-,-,-,-X-----------,-X-.-.-.-.-.-.-.-,-.-.-.-.-.-.-.-.-.-.-.-.-.-.-.-.-.-X---------------------------------------------,-,-X-.-.-.-,-X-----------------------------------------------,-,-,-X-.-.-.-.-.-,-X-----,-X-.-.-.-,-X-----------,-,-X-X-X-.-.-.-X-X-,-----
X-.-.-.-.-.-.-.-.-,-.-.-.-.-.-.-,-,-.-,-,-,-.-.-X-,-----------,-X-.-.-.-.-.-E-,-.-.-.-.-.-,-,-.-.-.-.-.-.-.-.-.-.-X-,-------------------------------------------,-X-.-.-.-.-,-X-------------------------------------------,-,-,-X-X-,-.-.-.-.-,-X-------,-X-.-.-.-X-----------,-,-X-.-.-.-.-.-.-.-.-X-,---
X-.-.-.-.-.-.-.-.-,-X-X-.-.-.-,-,-.-.-.-.-.-.-.-.-X-----------,-X-.-.-.-.-,-,-.-.-.-E-.-,-,-X-X-.-.-.-.-.-.-.-.-.-.-X-------------------------------------------,-,-X-.-.-.-X-------------------------------------,-,-,---,-X-X-.-.-,-,-,-,-X-X---------,-X-.-E-.-X---------,-,-X-.-E-.-.-.-.-.-.-.-.-X---
X-.-.-.-.-.-.-.-,-X---,-X-X-X-,-.-.-.-.-.-.-.-.-.-X-,-----------,-X-.-.-,-,-.-.-.-.-,-,-,-.-.-X-X-X-X-.-.-.-.-.-.-.-X-,-,---------------------------,-,-,-,-,-,-,-X-X-,-,-,-X-,-,-,-,-,-,-,-------------------,-,-X-X-,-,-,-X-.-.-.-.-.-,-X-------------,-X-.-.-.-X-------,-,-X-.-.-.-.-.-.-.-.-.-.-.-X-,-
X-.-.-.-.-.-.-.-X-----------,-X-.-.-.-.-.-.-.-.-.-.-X-------------,-X-X-,-.-.-.-.-,-,-.-.-.-.-X-,-.-.-X-X-.-.-.-.-.-.-X-X-,-,-,-,-----------------,-,-X-X-X-X-X-X-,-.-.-.-.-.-X-X-X-X-X-X-X-,-----------------,-X-.-.-X-X-X-.-.-.-.-.-.-.-,-X-----------,-X-.-.-.-X---,-,-,-X-.-.-.-.-.-.-.-.-.-.-.-.-.-X-
X-.-.-.-.-.-.-.-X-------------,-X-.-.-.-.-.-.-.-.-.-X-----------------,-X-.-.-.-,-,-.-.-.-.-.-.-X-.-.-.-.-X-.-.-.-.-.-.-.-X-X-X-X-,---------------,-X-.-,-,-,-.-.-,-,-,-,-,-,-,-,-,-,-.-.-.-X---------------,-,-X-.-.-.-X-X-.-.-.-.-.-.-.-.-X-----------,-X-.-.-,-X-,-,-X-X-.-.-.-.-.-.-.-.-.-.-.-.-.-.-X-
X-.-.-.-.-.-.-.-X-------------,-X-.-.-.-.-.-.-.-.-.-X---------------,-,-X-.-.-.-,-.-.-.-.-.-.-.-X-,-.-.-.-X-.-.-.-.-.-.-.-.-.-.-.-X-,-----------,-,-X-.-.-.-,-,-,-.-.-.-.-.-,-,-,-.-.-.-.-.-X-,-----------,-,-X-.-.-.-.-X-X-.-.-.-.-.-.-.-.-X-----------,-,-X-,-,-.-X-X-.-.-.-.-.-.-.-.-.-.-.-.-.-.-.-.-X-
X-.-.-.-.-.-.-.-X---------------,-X-.-.-.-.-.-.-.-,-X---------------,-X-.-.-.-,-,-.-.-.-.-.-.-.-.-X-.-.-.-.-X-.-.-.-.-.-.-.-.-.-.-.-X-,---------,-X-.-.-.-.-.-.-,-,-,-,-,-,-,-.-.-.-.-.-.-.-,-X---------,-,-X-.-.-.-.-.-X-.-.-.-.-.-.-.-.-.-X-,-,-,-,-,-,-X-X-X-.-.-.-.-.-.-.-.-.-.-.-.-.-.-.-.-.-.-.-.-X-
X-.-.-E-.-.-.-.-X---------------,-X-.-.-.-.-.-.-.-X-----------------,-X-.-.-.-,-X-X-X-.-.-.-.-.-.-X-.-.-.-.-X-.-.-.-.-.-.-.-.-.-.-.-.-X-,---------,-X-.-.-.-.-.-.-.-.-.-.-.-.-.-.-.-.-.-.-,-X---------,-,-X-.-.-.-.-.-.-.-.-.-.-.-.-.-.-.-X-X-X-X-X-X-X-X-.-.-.-.-.-.-.-.-.-.-.-.-.-.-.-.-.-.-.-.-.-.-.-X-
X-.-.-.-.-.-.-.-X-----------------,-X-.-.-.-.-.-.-X-,-----------,-,-,-X-.-.-.-.-X-,-X-.-.-.-.-.-X-,-.-.-.-.-X-.-.-.-.-.-.-.-.-.-.-.-.-.-X-,---------X-.-.-.-.-.-.-.-.-.-.-.-.-.-.-.-.-.-.-X---------,-,-X-.-.-.-.-.-.-.-.-.-.-.-.-.-.-.-.-X-.-.-.-.-.-,-,-.-.-.-.-.-.-.-.-.-.-.-.-.-.-.-.-.-.-.-.-.-.-,-X-
,-X-.-.-.-.-.-.-X-----------------,-X-.-.-.-.-.-.-X-X-,-,-,-,-,-,-X-X-.-.-.-.-X-,-,-X-.-.-.-.-,-X-.-.-.-.-,-,-X-.-.-.-.-.-.-.-.-.-.-.-.-.-X---------,-X-.-.-.-.-.-.-.-.-.-.-.-.-.-.-.-.-.-X---------,-X-.-.-.-.-.-.-.-.-.-.-.-.-.-.-.-.-X-.-.-.-.-.-.-.-,-.-.-.-.-.-E-,-X-X-X-X-X-X-.-.-.-.-.-.-.-.-,-X---
,-X-.-.-.-.-.-.-X-,-------------,-,-X-.-.-.-.-.-.-.-.-X-X-X-X-X-X-.-.-.-E-.-.-X-,-X-.-.-.-,-X-X-.-.-,-,-,-X-X-X-.-.-.-.-.-.-.-.-.-.-.-.-.-X---,-,-,-X-X-X-.-.-.-.-.-.-.-.-.-.-.-.-.-.-.-X-X-,-,-,---,-X-.-.-.-.-.-.-.-.-.-.-.-.-.-.-.-.-.-.-.-.-.-.-.-.-,-,-.-,-X-X-X-X-----------,-X-X-,-,-.-E-,-,-X-----
,-X-.-.-.-.-.-.-.-X-------------,-X-.-.-.-.-.-.-.-.-.-.-.-.-.-.-.-.-.-.-.-.-.-X-,-X-.-.-.-X-.-.-,-,-X-X-X-.-,-,-.-.-.-.-.-X-X-X-.-.-.-.-.-X---,-X-X-.-.-.-.-.-.-.-.-.-.-.-.-.-.-.-.-.-.-.-.-X-X-X---,-X-.-.-.-.-.-.-X-X-X-.-.-.-.-.-.-.-.-.-.-.-.-E-.-.-.-,-X-X-----------------------,-X-,-,-,-,-,-X-----
--,-X-.-.-.-.-.-.-X-,-,-,-----,-,-X-.-.-.-.-.-.-.-.-.-.-.-.-.-.-.-.-.-.-.-.-.-X-,-X-.-.-,-,-X-X-X-X-.-.-.-.-,-.-.-.-.-E-.-X-.-X-.-.-.-.-.-X-,-,-X-.-.-.-.-.-.-.-,-,-,-,-,-,-,-,-.-.-.-.-.-.-.-.-X-,-,-X-.-.-.-.-.-.-X-.-X-.-.-.-.-.-.-.-.-.-.-.-.-.-.-.-.-.-X-------------------------,-X-.-.-.-.-X-------
--,-X-.-.-.-.-.-.-.-X-X-X-,-,-,-X-.-.-.-.-.-.-.-.-.-.-.-.-.-.-.-.-.-.-.-.-.-.-X-X-.-.-.-,-.-.-.-,-,-.-E-.-.-,-,-.-.-.-.-.-X-.-X-.-A-.-.-.-.-X-X-.-.-.-.-.-.-.-,-,-,~.-.-.-.-,-,~,-.-.-.-.-.-.-.-.-X-X-.-.-.-.-A-.-.-X-.-X-.-.-.-.-.-.-.-.-.-.-.-.-.-.-.-,-,-X-----------------------,-,-X-.-.-.-,-X-------
----,-X-.-.-.-.-.-.-.-.-.-X-X-X-,-.-.-.-.-.-.-.-.-.-.-.-.-.-.-.-.-.-.-.-.-.-.-X-X-.-.-.-,-.-.-.-.-,-.-.-.-.-.-,-.-.-.-.-.-X-.-.-X-.-.-.-.-.-,-.-.-.-.-.-.-.-.-,-,~.-,-,-,-.-.-,-,~.-.-.-.-.-.-.-.-,-.-.-.-.-.-.-.-X-.-.-X-.-E-.-.-.-.-.-.-.-.-X-X-.-,-X-X-X---------------------,-,-,-X-X-.-.-.-X---------
----,-X-.-.-.-.-.-.-.-.-.-.-.-.-,-.-.-.-.-.-.-.-.-.-.-.-.-.-.-.-.-.-.-.-.-.-.-X-X-.-.-,-,-.-.-.-.-,-,-.-.-.-K-,-.-.-.-.-.-.-X-.-.-X-A-.-.-.-,-.-.-.-.-.-.-.-.-,-.-.-,-.-,-,-.-.-,-.-.-.-.-.-.-.-.-,-.-.-.-A-.-X-X-.-.-X-.-.-.-.-.-.-.-.-.-.-E-.-X-X-X-----------------------,-,-,-X-X-.-.-.-.-,-X---------
------,-X-.-.-.-.-.-.-.-.-.-.-.-,-.-.-.-.-.-.-.-.-.-.-.-.-.-.-.-.-.-.-.-.-.-.-X-X-.-.-,-.-.-.-.-.-.-,-.-.-.-.-,-.-.-.-.-.-.-X-.-.-X-.-W-.-.-,-.-.-.-.-.-.-.-.-,-,-.-,-.-,-,-.-,-,-.-.-.-.-.-.-.-.-,-.-.-W-.-.-X-X-.-.-X-.-.-.-.-.-.-.-.-.-.-.-.-X-,-,-,---------------,-,-,-,-X-X-.-.-.-E-.-.-X-----------
------,-X-.-.-.-.-.-.-.-.-.-.-,-,-.-.-.-E-.-.-.-.-.-.-.-.-.-.-.-.-.-.-.-.-.-.-X-,-X-,-,-.-.-.-.-.-.-,-X-.-.-.-,-.-.-.-.-.-X-.-.-X-.-A-.-.-.-,-.-.-.-.-.-.-.-.-,-,~,-,-,-,-.-,-,-,~.-.-.-.-.-.-.-.-,-.-.-.-A-.-.-.-X-.-.-X-.-.-.-.-.-.-.-.-.-.-.-,-X-X-,-,-,-------,-,-,-X-X-X-.-.-.-.-.-.-.-,-X-----------
--------,-X-.-.-.-.-.-.-.-.-.-,-.-.-.-.-.-.-.-.-,-X-X-X-X-X-.-.-.-.-.-.-.-.-.-.-X-X-,-.-.-.-.-.-.-.-X-,-X-.-.-,-.-.-.-.-.-X-.-X-.-A-.-.-.-,-X-X-.-.-.-.-.-.-.-.-,-,~,-,-,-,-,-,~.-.-.-.-.-.-.-.-,-X-X-.-.-.-.-A-.-.-X-.-X-.-E-.-.-.-.-.-.-.-.-.-,-.-.-X-X-,-,-,-,-,-X-X-.-.-.-E-.-.-.-.-.-.-X-------------
----------,-X-X-X-.-.-.-.-.-,-,-.-.-.-.-.-,-X-X-X---------,-X-X-X-.-.-.-.-.-.-.-X-,-X-X-.-.-.-.-X-X-.-,-X-.-.-,-,-.-.-.-.-X-.-X-.-.-.-.-.-X---,-X-.-.-.-.-.-.-.-.-.-.-.-.-.-.-.-.-.-.-.-.-.-.-.-X---,-X-.-.-.-.-.-.-X-.-X-.-.-.-.-.-X-.-.-.-.-.-,-.-.-.-.-X-X-X-X-X-.-.-.-.-.-.-.-.-.-.-.-,-X-------------
----------------,-X-X-X-X-X-X-X-.-.-.-.-.-X---------------------,-X-.-.-.-E-.-.-X-.-.-.-X-X-X-X-.-.-.-.-,-X-X-X-X-.-.-.-.-X-X-X-.-.-.-.-.-X---,-X-X-X-.-.-.-.-.-.-.-.-.-.-.-.-.-.-.-.-.-.-.-,-X-X---,-X-.-.-.-.-.-.-X-X-X-.-.-.-.-.-X-X-.-.-.-,-,-.-.-.-.-.-.-.-.-.-.-.-.-.-.-.-.-.-.-.-,-X---------------
--------------------------,-,-X-.-.-.-.-,-X-----------------------,-X-.-.-.-.-.-.-X-.-.-.-.-.-.-.-.-.-.-.-.-.-.-X-.-.-.-.-.-.-.-.-.-.-.-.-X-------,-,-X-X-.-.-.-.-.-.-.-.-.-.-.-.-.-.-.-X-X-X-------,-X-.-.-.-.-.-.-.-.-.-.-.-.-.-.-,-X-X-X-X-X-X-.-.-.-.-.-.-.-.-E-.-.-.-.-.-.-.-.-.-.-X-----------------
--------------------------,-X-.-.-.-.-,-X---------------------------,-X-.-.-.-.-.-.-X-X-X-X-X-.-.-.-.-.-.-.-.-X-.-.-.-.-.-.-.-.-.-.-.-.-,-X-------,-,-X-.-.-.-.-.-.-.-,-,-.-.-.-.-.-.-.-.-X-,-------,-X-.-.-.-.-.-.-.-.-.-.-.-.-.-.-,-X---------,-X-X-.-.-.-.-.-.-.-.-.-.-.-.-.-.-.-.-,-X-----------------
------------------------,-,-X-.-.-.-.-X-----------------------------,-X-,-,-.-.-.-.-.-.-.-.-.-X-.-.-.-.-.-.-.-X-.-.-.-.-.-.-.-.-.-.-.-,-X---------,-.-X-.-.-.-.-.-.-.-,-,6.-.-.-.-.-.-.-.-.-X---------,-X-.-.-.-.-.-.-.-X-.-.-.-.-,-,-X-,-----------,-X-X-.-.-.-.-.-.-.-.-.-.-.-.-.-,-X-------------------
------------------------,-X-.-.-.-.-,-X-,-,-,-,-,-,---------------,-,-X-.-,-,-.-.-.-.-.-.-.-.-.-X-X-.-.-.-.-X-.-.-.-.-.-.-.-.-.-.-.-,-X---------,-,-X-.-.-.-.-.-.-.-.-.-.-.-.-.-.-.-.-.-.-.-X-,---------,-X-.-.-.-.-.-.-X-.-.-.-,-,-.-.-X---------------,-X-X-X-.-.-.-.-.-.-.-.-.-,-X---------------------
------------------------,-X-,-.-.-.-X-,-X-X-X-X-X-X-,-------------,-X-.-.-W-,-.-.-.-.-.-.-.-.-.-.-.-X-X-X-X-.-.-.-.-.-.-.-.-.-.-.-,-X-----------,-X-.-.-.-.-.-.-.-,-,-,-,-,-,-.-.-.-.-.-.-.-,-X-----------,-X-.-.-.-.-.-X-X-X-,-,-.-.-.-X-,---------------,-,-X-X-,-,-.-.-.-.-,-X-X-----------------------
------------------------,-X-,-,-,-,-X-X-.-.-,-,-.-.-X-,---------,-,-X-.-.-E-,-,-.-.-E-.-.-.-.-.-.-.-.-.-.-.-.-.-.-.-.-.-.-.-.-.-,-X---------------,-X-.-.-.-.-,-,-,-.-.-.-.-,-,-,-.-.-.-.-.-X---------------,-X-.-.-.-.-X-,-,-X-.-.-K-.-.-X-,-----------,-,-X-.-.-.-,-X-X-X-X-X---------------------------
------------------------,-X-.-.-,-X-.-.-.-.-,-.-.-.-.-X-------,-,-X-.-.-.-.-.-,-,-.-.-.-.-.-.-.-E-.-.-.-.-.-.-.-.-.-.-.-,-X-X-X-X-----------------,-X-.-.-,-,-,-.-,-,-,-,-,-,-.-,-,-,-.-.-,-X-----------------,-X-X-.-,-X-----,-X-.-.-.-.-.-X-,---------,-.-X-.-.-.-.-.-X---------------------------------
------------------------,-X-.-.-.-.-.-.-.-.-,-,-.-.-.-,-X-,-,-X-X-,-,-.-.-.-.-.-,-X-X-.-,-X-.-.-.-.-.-.-.-.-.-.-.-.-.-.-X---------------------------,-X-X-X-X-X-X-X-.-.-.-.-,-,-X-X-X-X-X-X-----------------------,-X-X-------,-X-.-.-.-.-.-.-X---------,-X-.-.-.-.-.-.-,-X-------------------------------
------------------------,-X-.-.-.-.-.-.-.-.-.-,-.-.-.-.-X-X-X-.-.-.-,-,-.-.-,-X-X---,-X-X-,-X-.-.-.-.-.-.-.-.-.-.-.-.-,-X---------------------,-,-,-----------,-,-,-X-.-.-.-X-X-------------------------------------------------,-X-.-.-.-.-.-X-,-------,-X-.-.-.-.-.-.-.-X-------------------------------
--------------------------,-X-.-E-.-.-.-.-.-.-,-.-.-.-.-.-.-.-.-.-.-.-,-.-,-X-------------,-X-.-.-.-.-.-.-.-.-.-.-.-.-X-------------------,-,-,-X-X-,-,-------,-X~X~X-.-.-.-X-X~--------------------------------------------------,-X-.-.-.-.-.-X-------,-X-.-.-.-.-.-.-.-X-------------------------------
--------------------------,-X-.-.-.-.-.-.-.-.-,-.-.-.-.-.-.-.-.-.-.-.-,-.-X-----------------,-X-X-X-.-.-.-,-X-X-X-X-X-X-----------------,-,-X-X-.-.-X-X-------,-X~,~.-.-.-.-,-X~--------------------------------------------------,-X-.-.-.-.-.-,-X-------X-.-.-.-E-,-,-,-X-------------------------------
--------------------------,-X-.-.-.-.-.-.-.-,-,-.-.-.-E-.-.-.-.-.-.-.-,-,-X-----------------------,-X-X-X-X-----------------------------,-X-,-.-A-.-A-X-------,-X~,~.-.-.-.-,-X~----------------------------------------------------,-X-.-.-.-.-.-X-------,-X-.-,-,-.-X-X-,-------------------------------
--------------------------,-X-.-.-.-.-.-.-.-,-.-.-.-.-.-.-.-.-.-.-.-.-.-X-----------------------,-,-----------------------------------,-,-X-,-,-,-.-,-X-,-----,-X~,~.-.-.-.-,-X~------------------------------------------------------X-.-.-.-.-.-X---------,-X-,-.-.-.-X-X-,-,---------------------------
----------------------------,-X-X-.-.-.-.-.-,-X-X-.-.-.-.-.-.-.-.-.-.-,-X-------------------,-,-,-X-,---------------------------------,-.-X-.-.-,-,-X-X-X-,---,-X~,~.-.-.-.-,-X-------------------------------------------------------,-X-.-.-.-.-X---------,-,-X-.-.-.-.-.-X-X-,-------------------------
--------------------------------,-X-X-.-,-X-X---,-X-X-X-X-.-.-.-.-,-X-X-----------------,-,-,-X-X-.-X-,-,-----------------------------,-X-.-.-.-.-X2X-.-.-X-,-,-X~,~.-.-.-.-,-X-----------------------------------------------------,-,-X-.-.-.-.-X---------,-X-.-.-.-.-.-.-.-.-X-------------------------
------------------------------------,-X-X-------------,-,-X-X-X-X-X-----------------,-,-,-X-X-.-.-A-.-X-X-,-------------------------,-,-X-.-.-.-X-,2,-.-t0.-X-,-X~,~,-.-.-.-,-X-----------------------------------------------------,-.-X-.-.-.-,-X---------,-X-.-.-.-.-.-.-.-.-X-------------------------
----------------------------------------------------------------------------------,-,-X-X-.-.-.-.-.-.-A-,-X-----------,-,-----------,-X-.-.-.-.-.-.-,2.-.-.-X-,-X~.~,~.-.-.-,-X~----------------------------------------------------,-X-.-.-.-.-X-----------,-X-.-.-.-.-.-.-.-,-X-------------------------
------------------------------------------------------------------------------,-,-,-X-.-.-.-.-.-.-.-,-,-,-X---------,-,-X-,-------,-,-X-.-.-.-.-.-.-,2,-,-,-X-,-X~.~,~.-.-.-,-X~----------------------------------------------------,-X-.-.-.-.-X-----------,-X-.-.-.-.-.-.-.-X---------------------------
--------------------------------------------------------------------------,-,-,-X-X-.-.-.-.-.-.-.-.-,-,-.-X---------,-X-.-X-,-,-,-X-X-.-.-.-.-.-.-.-.-.2,2X---,-X~,~,~.-.-.-,-X~----------------------------------------------------,-X-.-.-.-.-,-X---------,-X-.-.-.-.-.-.-,-X---------------------------
------------------------------------------------------------------------,-,-X-X-.-.-.-.-.-.-.-.-.-.-.-,-,-X-,-----,-,-X-.-.-X-X-X-.-,-,-.-.-.-.-.-.-.-,-,-X2--,-X~,~.-.-.-.-,-X-----------------------------------------------------,-X-.-.-.-.-.-X-,-,-,-,-,-X-,-,-.-.-.-.-X-----------------------------
------------------------------------------------------------------------,-X-.-.-.-.-.-.-.-.-.-.-.-.-.-.-,-X-X-,-,-,-X-.-.-.-.-.-.-.-,-X-X-X-X-X-X-X-X-X-X-----,-X~,~.-.-.-.-,-X-----------------------------------------------------,-X-.-.-.-.-.-.-X-X-X-X-X-.-.-,-,-,-,-X-X-----------------------------
------------------------------------------------------------------------,-X-A-.-.-.-.-.-.-.-.-.-.-.-.-.-.-X-X-X-,-X-,-,-,-,-,-.-.-,-X-------------------------,-X~,~,-.-.-.-,-X-----------------------------------------------------,-X-.-.-.-.-.-.-.-.-.-.-E-.-.-.-.-X-X---------------------------------
------------------------------------------------------------------------,-X-.-.-.-.-.-.-.-.-.-.-.-.-.-.-.-,-,-.-X-.-,-.~.~.~,~.-.-X---------------------------,-X~.~,~.-.-.-,-X~------------------------------------------------------X-.-.-.-.-.-.-.-.-.-.-.-.-.-.-.-.-X---------------------------------
------------------------------------------------------------------------,-X-.-.-.-.-.-.-.-.-.-.-.-.-.-.-.-,-,-.-,-,-,-.~.~.~,~,-,-X-,-,-----------------------,-X~.~,~.-.-.-,-X~------------------------------------------------------,-X-.-.-.-.-.-.-.-.-.-.-.-.-.-.-.-X---------------------------------
------------------------------------------------------------------------,-X-.-.-.-.-.-.-.-.-.-.-.-.-.-.-.-,-,-,-,~.~.~.~.~.~.~.~,~X~X-X-,-,-,-----------------,-X~,~,~.-.-.-,-X~--------------------------------------------------------X-.-.-.-.-.-.-.-.-.-.-.-.-.-.-.-X---------------------------------
------------------------------------------------------------------------,-X-.-.-.-.-.-.-.-.-.-.-.-.-.-.-.-,-,-.~.~.~.~.~.~.~,~,~,~,~,~.~X~X~X~,-,-------------,-X~,~.-.-.-.-,-X---------------------------------------------------------,-X-.-.-.-.-.-.-.-.-.-.-.-.-.-,-X---------------------------------
------------------------------------------------------------------------,-X-.-.-.-.-.-.-.-.-.-.-.-.-.-.-.-,-,-.~.~.~.~.~.~.~,~.~.~.~,~,~,~,~,~X~X-,-----------,-X~,~.-.-.-.-,-X-----------------------------------------------------------,-X-X-.-.-.-.-.-.-.-.-.-.-,-X-----------------------------------
------------------------------------------------------------------------,-X-.-.-.-.-.-.-.-.-.-.-.-.-.-.-.-,-,-.~.~.~.~.~.~,~,~.~.~.~.~.~,~,~,-.~.~X~----------,-X~,~,-.-.-.-,-X-------------------------------------------------------------,-,-X-X-.-.-.-.-.-,-,-X-X-------------------------------------
------------------------------------------------------------------------,-X-.-.-.-.-.-.-.-.-.-.-.-.-.-.-.-,-,-.~.~.~.~.~.~,~.~:~.~.~,~,~,-.-,~,-.~X~,---------,-X~.~,~.-.-.-,-X~------------------------------------------------------------------,-X-X-X-X-X-X-X-----------------------------------------
----------------------------------------------------------------------,-,-X-A-.-.-.-.-.-.-.-.-.-.-.-.-.-.-,-,-.~.~.~.~.~,~,~.~.~.~,~,~.~.~.~.~,~,~.~X---------,-X~.~,~.-H-.-,-X~--------------------------------------------------------------------------------------------------------------------------
--------------------------------------------------------------------,-,-X-X-.-.-.-X-X-.-.-.-.-.-.-.-.-.-.-,-,-,~,~.~.~.~,~.~.~.~,~,~.~.~.~.~.~.~,-.~X~--------,-X~,~,~.-.-.-,-X~--------------------------------------------------------------------------------------------------------------------------
--------------------------------------------------------------------,-X-.-.-.-.-.-X-X-.-.-.-.-.-.-.-.-.-.-X-,-,~,~.~.~.~,~.~.~.~,~.~.~.~.~.~.~.~,~.~X~,-------,-X~,~.-.-.-.-,-X---------------------------------------------------------------------------------------------------------------------------
--------------------------------------------------------------------,-X-.-.-.-.-.-X.X-.-.-.-.-,-,-,-,-,-X-X-X-,-,~.~.~.~,~.~.~.~,~.~.~.~.~.~.~.~,~.~.~X-------,-X~,~.-.-.-.-,-X---------------------------------------------------------------------------------------------------------------------------
--------------------------------------------------------------------,-X-.-.-.-.-.-X.X-.-.-.-.-,-,-,-,-.-W-.-.-,-,~.~.~.~,~.~.~.~,~.~.~.~.~.~.~.~,~.~.~X~------,-X~,~,-.-.-.-,-X---------------------------------------------------------------------------------------------------------------------------
--------------------------------------------------------------------,-X-.-.-.-.-.-X.X-.-.-.-.-.-.-.-,-,-,-X-,-,-,~.~.~.~,~.~.~.~,~.~.~.~.~.~.~.~,~.~,~X-------,-X~.~,~.-.-.-,-X~--------------------------------------------------------------------------------------------------------------------------
--------------------------------------------------------------------,-X-X-.-.-.-.-X-X-.-.-.-.-.-.-.-.-.-X-X-X-,~,~.~.~.~,~.~.~.~,~.~.~.~.~.~.~,~,~.~X~--------,-X~.~,~.-.-.-,-X~--------------------------------------------------------------------------------------------------------------------------
------------------------------------------------------------------------,-X-.-.-.-X-X-.-.-.-.-.-.-.-.-.-.-,-,-.~.~.~.~.~,~.~.~.~,~,~,~.~.~.~.~,~.-.~X~--------,-X~,~,~.-.-.-,-X~--------------------------------------------------------------------------------------------------------------------------
------------------------------------------------------------------------,-X-A-.-.-.-.-.-.-.-.-.-.-.-.-.-.-,-,-.~.~.~.~.~,~,~.~.~.~.~,~,~,~.~,~,~.~,~X---------,-X~,~.-.-.-.-,-X---------------------------------------------------------------------------------------------------------------------------
------------------------------------------------------------------------,-X-.-.-.-.-.-.-.-.-.-.-.-.-.-.-.-,-,-.~.~.~.~.~.~,~.~.~.~.~.~,~,-,-,~.-.~X~----------,-X~,~.-.-.-.-,-X---------------------------------------------------------------------------------------------------------------------------
------------------------------------------------------------------------,-X-.-.-.-.-.-.-.-.-.-.-.-.-.-.-.-,-,-.~.~.~.~.~.~,~,~.~.~.~.~.~.~,~,-.~,~X~----------,-X~,~,-.-.-.-,-X---------------------------------------------------------------------------------------------------------------------------
------------------------------------------------------------------------,-X-.-.-.-.-.-.-.-.-.-.-.-.-.-.-.-,-,-.~.~.~.~.~.~.~,~,~,~.~.~,~,~,~,~X~X-------------,-X~.~,~.-.-.-,-X~--------------------------------------------------------------------------------------------------------------------------
------------------------------------------------------------------------,-X-.-.-.-.-.-.-.-.-.-.-.-.-.-.-.-,-,-.~.~.~.~.~.~.~.~.~,~,~,~,~X~X~X~----------------,-X~.~,~.-.-.-,-X~--------------------------------------------------------------------------------------------------------------------------
------------------------------------------------------------------------,-X-.-.-.-.-.-.-.-.-.-.-.-.-.-.-,-,-.~.~.~.~.~.~.~.~.~.~,~X~X~X-----------------------,-X~,~,~.-.-.-,-X~--------------------------------------------------------------------------------------------------------------------------
------------------------------------------------------------------------,-X-.-.-.-.-.-.-.-.-:-.-.-.-,-,-,-,-.~,~,~.~.~,~,~,~,~,~,~X~--------------------------,-X~,~.-.-.-.-,-X---------------------------------------------------------------------------------------------------------------------------
------------------------------------------------------------------------,-X-.-.-.-,-X-X-.-.-.-.-.-.-,-,-,-,-,~,~,-,~,~,~.~.-.-,-X-----------------------------,-X~,~.-.-.-.-,-X---------------------------------------------------------------------------------------------------------------------------
------------------------------------------------------------------------,-XR.-A-,-X-,-,-X-X-.-.-.-.-,-,-,-,-X~.-.-,-,~.-.-.-.-X-------------------------------,-X~,~,-.-.-.-,-X---------------------------------------------------------------------------------------------------------------------------
------------------------------------------------------------------------,-XR+R,-X-------,-,-X-X-.-.-,-,-,-X-X-X-.-.-,-.-.-.-,-X-------------------------------,-X~.~,~.-.-.-,-X~--------------------------------------------------------------------------------------------------------------------------
------------------------------------------------------------------------,-XRXRXR------------,-,-X-X-,-X-X-----,-X-.-,-.-,-X-X---------------------------------,-X~.~,~,-,-,-,-X~--------------------------------------------------------------------------------------------------------------------------
------------------------------------------------------------------------------------------------,-,-X---------,-X-.-,-X-X-------------------------------------,-X~.~,~.-.-,-,-X~--------------------------------------------------------------------------------------------------------------------------
----------------------------------------------------------------------------------------------------------------,-X-X-----------------------------------------,-X~,~X~X-,-X-X~X~--------------------------------------------------------------------------------------------------------------------------
--------------------------------------------------------------------------------------------------------------------------------------------------------------,-X~X~X~X0t0X0X~X~--------------------------------------------------------------------------------------------------------------------------
--------------------------------------------------------------------------------------------------------------------------------------------------------------------,-X0.-X0------------------------------------------------------------------------------------------------------------------------------
--------------------------------------------------------------------------------------------------------------------------------------------------------------------,-X0X0X0------------------------------------------------------------------------------------------------------------------------------
