--------------------------,-X-X-X-X-X-X-X-X-X---------------------------------------------------------------------------------------------------------------------------------------------------------------------------------------------------------
--------------------------,-X-H-.-.-.-.-.-.-X---------------------------------------------------------------------------------------------------------------------------------------------------------------------------------------------------------
--------------------------,-X-.-t6A-.-A-.-A-X---------------------------------------------------------------------------------------------------------------------------------------------------------------------------------------------------------
--------------------------,-X-.-A-.-.-.-.-.-X-,-,-,-,-,-,-,-,-,-,-,-,-,-,-,-,-----------------------------------------------------------------------------,-,-,-,-,-,-,-,-,-,-,-,-,-,-,-,-,-,---------------------------------------------------------
--------------------------,-X-.-.-.-.1.1.1.1X1X-X-X-X-X-X-X-X-X-X-X-X-X-X-X-X-----------------------------------------------------------------------------,-X-X-X-X-X-X-X-X-X-X-X-X-X-X-X-X-X---------------------------------------------------------
--------------------------,-X-.-A-.-.1.1.1.1,1.-.-.-.-.-.-<-.-.-.-.-.-.-.-.-X-----------------------------------------------------------------------------,-X-.-.-.-.-.-.-.-.-<-.-.-.-.-.-.-X---------------------------------------------------------
--------------------------,-X-.-.-.-.1.1A1.1,1.-.-.-.-.-.-.-W-.-.-.-.-.-.-.-X-----------------------------------,-,-,-,-----------------------------------,-X-A-.-.-.-.-.-.-W-.-.-.-.-.-.-.-X---------------------------------------------------------
--------------------------,-X-.-A-.-.1.1.1.1,1.-.-.-.-.-.-.-.-.-.-.-.-.-.-.-X-,-,-,-,-,-,-,-,-,-,-,-,-,-,-,-,-,-,->->->-,-,-,-,-,-,-,-,-,-,-,-,-,-,-,-,-,-,-X-.-.-.-.-.-.-.-.-.-.-.-.-.-.-.-X-,-,-,-,-------------------------------------------------
--------------------------,-X-X-X-X-X1,1,1,1,1.-.-.-.-.-.-.-.-.-.-.-.-.-.-.-X-X-X-X-X-X-X-X-X-X-X-X-X-X-X-X-X-X-X-X-,-X-X-X-X-X-X-X-X-X-X-X-X-X-X-X-X-X-X-X-X-.-.-.-.-.-.-.-.-.-.-.-.-.-.-.-X-X-X-X-X-------------------------------------------------
----------------------------------,-X-.-.-.-.-.-.-.-.-.-.-.-.-.-.-.-.-.-.-.-.-.-.-.-.-.-.-.-.-.-.-.-.-.-.-.-.-.-.-.-.-.-.-.-.-.-.-.-.-.-.-.-.-.-.-.-.-.-.-.-.-.-.-.-.-.-.-.-.-.-.-.-.-.-.-.-.-.-.-.-X-------------------------------------------------
----------------------------------,-X-.-.-.-.-.-.-.-.-.-.-.-.-.-.-.-.-.-.-.-.-.-.-.-.-.-.-.-.-.-.-.-.-.-.-.-.-.-.-.-.-.-.-.-.-.-.-.-.-.-.-.-.-.-.-.-.-.-.-.-.-.-.-.-.-.-.-.-.-.-.-.-.-.-.-.-.-.-.-.-X-------------------------------------------------
----------------------------------,-X-.-.-.-.-.-.-.-.-.-.-.-.-.-.-.-.-.-.-.-.-.-.-.-.-.-.-.-.-.-.-.-.-.-.-.-.-.-.-.-.-.-.-.-.-.-.-.-.-.-.-.-.-.-.-.-.-.-.-.-.-.-.-.-.-.-.-.-.-.-.-.-.-.-.-.-.-.-H-.-X-------------------------------------------------
----------------------------------,-X-.-.-.-.-.-.-.-.-.-.-.-.-.-.-.-.-.-.-.-.-.-.-.-.-.-.-.-.-.-.-.-.-.-.-.-.-.-.-.-.-.-.-.-.-.-.-.-.-.-.-.-.-.-.-.-.-.-.-.-.-.-.-.-.-.-.-.-.-.-.-.-.-.-.-.-.-.-.-.-X-------------------------------------------------
----------------------------------,-X-.-.-.-.-.-.-.-.-.-.-.-.-.-.-.-.-.-.-.-.-.-.-.-.-.-.-.-.-.-.-.-.-.-.-.-.-.-.-.-.-.-.-.-.-.-.-.-.-.-.-.-.-.-.-.-.-.-.-.-.-.-.-.-.-.-.-.-.-.-.-.-.-.-.-.-.-.-.-.-X-------------------------------------------------
----------------------------------,-X-.-.-.-.-.-.-.-.-.-.-.-.-.-.-.-.-.-.-.-.-.-.-.-.-.-.-.-.-.-.-.-.-.-.-.-.-.-.-.-.-.-.-.-.-.-.-.-.-.-.-.-.-.-.-.-.-.-.-.-.-.-.-.-.-.-.-.-.-.-.-.-.-.-.-.-.-.-.-.-X-------------------------------------------------
----------------------------------,-X-<-.-.-.-.-.-.-.-.-.-.-.-.-.-.-.-.-.-.-.-.-.-.-.-.-.-.-.-.-.-.-.-.-.-.-.-.-.-.-.-.-.-.-.-.-.-.-.-.-.-.-.-.-.-.-.-.-.-.-.-.-.-.-.-.-.-.-.-.-.-.-.-.-.-.-.-.-.-<-X-------------------------------------------------
----------------------------------,-X-.-W-.-.-.-.-.-.-.-.-.-A-.-.-.-.-.-.-.-.-.-.-.-.-.-.-.-.-.-.-.-.-.-.-.-.-.-.-.-A-.-.-.-.-.-.-.-.-.-.-.-.-.-.-.-.-.-.-.-.-.-.-.-.-.-.-.-A-.-.-.-.-.-.-.-.-.-W-.-X-------------------------------------------------
----------------------------------,-X-.-.-.-.-.-.-.-.-.-.-.-.-.-.-.-.-.-.-.-.-.-.-.-.-.-.-.-.-.-.-.-.-.-.-.-.-.-.-.-.-.-.-.-.-.-.-.-.-.-.-.-.-.-.-.-.-.-.-.-.-.-.-.-.-.-.-.-.-.-.-.-.-.-.-.-.-.-.-.-X-------------------------------------------------
----------------------------------,-X-.-.-.-.-.-.-.-.-.-.-.-.-.-.-.-.-.-.-.-.-.-.-.-.-.-.-.-.-.-.-.-.-.-.-.-.-.-.-.-.-.-.-.-.-.-.-.-.-.-.-.-.-.-.-.-.-.-.-.-.-.-.-.-.-.-.-.-.-.-.-.-.-.-.-.-.-.-.-.-X-------------------------------------------------
----------------------------------,-X-.-.-.-.-.-.-.-.-.-.-.-.-.-.-.-.-.-.-.-.-.-.-.-.-.-.-.-.-.-.-.-.-.-.-.-.-.-.-.-.-.-.-.-.-.-.-.-.-.-.-.-.-.-.-.-.-.-.-.-.-.-.-.-.-.-.-.-.-.-.-.-.-.-.-.-.-.-.-.-X-------------------------------------------------
----------------------------------,-X-.-.-.-.-.-.-.-.-.-.-.-.-.-.-.-.-.-.-.-.-.-.-.-.-.-.-.-.-.-.-.-.-.-.-.-.-.-.-.-.-.-.-.-.-.-.-.-.-.-.-.-.-.-.-.-.-.-.-.-.-.-.-.-.-.-.-.-.-.-.-.-.-.-.-.-.-.-.-.-X-------------------------------------------------
----------------------------------,-X-.-.-.-.-.-.-.-.-.-.-.-.-.-.-.-.-.-.-.-.-.-.-.-.-.-.-.-.-.-.-.-.-.-.-.-.-.-.-.-.-.-.-.-.-.-.-.-.-.-.-.-.-.-.-.-.-.-.-.-.-.-.-.-.-.-.-.-.-.-.-.-.-.-.-.-.-.-.-.-X-------------------------------------------------
----------------------------------,-X-.-.-.-.-.-.-.-.-.-.-.-.-.-.-.-.-.-.-.-.-.-.-.-.-.-.-.-.-.-.-.-.-.-.-,-,-,-,-,-,-,-,-,-,-.-.-.-.-.-.-.-.-.-.-.-.-.-.-.-.-.-.-.-.-.-.-.-.-.-.-.-.-.-.-.-.-.-.-.-X-------------------------------------------------
----------------------------------,-X-.-.-.-.-.-.-.-.-.-.-.-.-.-.-.-.-.-.-X-X-X-X-X-X-X-X-X-X-X-X-X-X-X-X-X-X-.-.-.-.-.-.-.-X-X-X-X-X-X-X-X-X-X-X-X-X-X-X-X-X-.-.-.-.-.-.-.-.-.-.-.-.-.-.-.-.-.-.-.-X-------------------------------------------------
----------------------------------,-X-X-X-X-X-.-.-.-.-.-.-.-.-.-.-.-.-.-.-X-X-X-X-X-X-X-X-X-X-X-X-X-X-X-X-X-X-,-,-,-,-,-,-,-X-X-X-X-X-X-X-X-X-X-X-X-X-X-X-X-X-.-.-.-.-.-.-.-.-.-.-.-.-.-.-.-X-X-X-X-X-------------------------------------------------
------------------------------------------,-X-.-.-.-.-.-.-.-.-.-.-.-.-.-.-X-X-.-.-.-.-.-.-.-.-.-.-.-.-.-.-.-.-.-.-.-.-.-.-.-.-.-.-.-.-.-.-.-.-.-.-.-.-.-.-.-X-.-.-.-.-.-.-.-.-.-.-.-.-.-.-.-X---------------------------------------------------------
------------------------------------------,-X-.-.-.-.-.-.-.-.-.-.-.-.-.-.-X-X-.-.-.-.-.-.-.-.-.-.-.-.-.-.-.-.-.-.-.-.-.-.-.-.-.-.-.-.-.-.-.-.-.-.-.-.-.-A-.-X-.-.-.-.-.-.-.-.-.-.-.-.-.-.-.-X---------------------------------------------------------
------------------------------------------,-X-.-.-.-.-.-.-.-.-.-.-.-.-.-.-X-X-.-.-.-.-.-.-.-.-.-.-.-.-.-.-.-.-.-.-.-.-.-.-.-.-.-.-.-.-.-.-.-.-.-.-.-.-.-.-.-X-.-.-.-.-.-.-.-.-.-.-.-.-.-.-.-X---------------------------------------------------------
------------------------------------------,-X-.-.-.-.-.-.-.-.-.-.-.-.-.-.-X-X-.-.-.-.-.-.-.-.-.-.-.-.-.-.-.-.-.-.-.-.-.-.-.-.-.-.-.-.-.-.-.-.-.-.-.-.-.-.-.-X-.-.-.-.-.-.-.-.-.-.-.-.-.-.-.-X---------------------------------------------------------
------------------------------------------,-X-.-.-.-.-.-.-.-.-.-.-.-.-.-.-X-X-.-.-.-.-.-.-.-.-.-.-.-.-.-.-.-.-.-.-.-.-.-.-.-.-.-.-.-.-.-.-.-.-.-.-.-.-.-.-.-X-.-.-.-.-.-.-.-.-.-.-.-.-.-.-.-X---------------------------------------------------------
------------------------------------------,-X-.-.-.-.-.-.-.-.-.-.-.-.-.-.-X-X-.-.-.-.-.-,-,-,-,-,-,-,-,-,-,-,-,-,-,-,-,-,-,-,-,-,-,-,-,-,-,-,-.-.-.-.-.-.-.-X-.-.-.-.-.-.-.-.-.-.-.-.-.-.-.-X---------------------------------------------------------
------------------------------------------,-X-.-.-.-.-.-.-.-.-.-.-.-.-.-.-X-X-.-.-.-.-.-,-.-.-.-.-.-.-.-.-,-.-.-.-.-.-.-.-.-,-.-.-.-.-.-.-.-,-.-.-.-.-.-.-.-X-.-.-.-.-.-.-.-.-.-.-.-.-.-.-.-X---------------------------------------------------------
------------------------------------------,-X-.-.-.-.-.-.-.-.-.-.-.-.-.-.-X-X-.-.-.-.-.-,-.-,-,-,-,-,-,-,-,-,-,-,-,-,-,-,-,-,-,-,-,-,-,-,-,-,-.-.-.-.-.-.-.-X-.-.-.-.-.-.-.-.-.-.-.-.-.-.-.-X---------------------,-,-,-,-,-,-,-,-,-,-----------------
------------------------------------------,-X-.-.-.-.-.-.-.-.-.-.-.-.-.-.-X-X-.-.-.-.-.-,-.-,-B-B-.-.-.-.-.-.-.-.-.-.-.-.-.-.-.-.-.-.-.-B-B-,-.-.-.-.-.-.-.-X-.-.-.-.-.-.-.-.-.-.-.-.-.-.-.-X-------------,-,-,-,-,-X-X-X-X-X-X-X-X-X-,-,-,-,-,-,-,-,-
------------------------------------------,-X-.-.-.-.-.-.-.-.-.-.-.-.-.-.-X-X-.-.-.-.-.-,-.-,-B-.-.-.-.-.-.-.-.-.-.-.-.-.-.-.-.-.-.-.-.-.-B-,-.-.-.-.-.-.-.-X-.-.-.-.-.-.-.-.-.-.-.-.-.-.-.-X-------------,-X-X-X-X-X-.-.-.-.-.-.-.-X-X-X-X-X-X-X-X-X-
------------------------------------------,-X-.-.-.-.-.-.-.-.-.-.-.-.-.-.-X-X-.-.-.-.-.-,-.-,-.-.-.-.-.-.-.-.-.-.-.-.-.-.-.-.-.-.-.-.-.-.-,-,-.-.-.-.-.-.-.-X-.-.-.-.-.-.-.-.-.-.-.-.-.-.-.-X-------------,-X-.-.-.-.-.-.-.-.-.-.-.-.-,-,-.-.-.-H-.-X-
------------------------------------------,-X-.-.-.-.-.-.-.-.-.-.-.-.-.-.-X-X-.-.-.-.-.-,-.-,-.-.-.-.-.-.-.-.-.-.-.-<-.-.-.-.-.-.-.-.-.-.-,-,-.-.-.-.-.-.-.-X-.-.-.-.-.-.-.-.-.-.-.-.-.-.-.-X-------------,-X-.-A-.-.-.-.-.-.-.-.-.-.-,-,-.-.-.-.-.-X-
------------------------------------------,-X-.-.-.-.-.-.-.-.-.-.-.-.-.-.-X-X-.-.-.-.-.-,-.-,-.-.-.-.-.-.-.-.-.-.-.-.-.-.-.-.-.-.-.-.-.-.-,-,-.-.-.-.-.-.-.-X-.-.-.-.-.-.-.-.-.-.-.-.-.-.-.-X-,-,-,-,-,-,-,-X-.-.-.-.-.-.-.-.-.-.-.-.-,-,-,-.-.-.-.-X-
------------------------------------------,-X-.-.-.-.-.-.-.-.-.-.-.-.-.-.-X-X-.-.-.-.-.-,-.-,-.-.-.-.-.-X-X-X-,-,-,-,-,-,-,-X-X-X-.-.-.-.-,-,-.-.-.-.-.-.-.-X-.-.-.-.-.-.-.-.-.-.-.-.-.-.-.-X0X~X~X~X~X~X~,-X-.-.-.-.-.-.-.-.-.-.-.-.-,-,5,5A-,-,-.-X-
------------------------------------------,-X-.-.-.-.-.-.-.-.-.-.-.-.-.-,-X-X-.-.-.-.-.-,-,-,-.-.-.-.-.-X-,-X-.-.-.-.-.-.-.-X-.-X-.-.-.-.-,-,-.-.-.-.-.-.-,-X-.-.-.-.-.-.-.-.-.-.-.-.-.-.-.-.~.~.~.~.~W~X~,-X-.-.-.-.-.-.-.-.-.-.-.-.-.-,-,-.5.-,-.-X-
------------------------------------------,-X-.-.-.-.-.-.-.-.-.-.-.-.-.-,-X-X-.-.-.-.-.-,-.-,-.-.-.-.-.-X-X-X-,-,-,-,-,-,-,-X-X-X-.-.-.-.-,-,-.-.-.-.-.-.-,-X-.-.-.-.-.-.-.-.-.-.-.-.-.-.-.-X0X~X~X~X~X~X~,-X-.-.-.-.-.-.-.-.-.-.-.-.-.-.-,-,-,-,-.-X-
------------------------------------------,-X-.-.-.-.-.-.-.-.-.-.-.-.-.-,-.-,-.-.-.-.-.-,-.-,-.-.-.-.-.-,-.-,-A-.-.-W-.-.-A-,-.-.-.-.-.-.-,-,-.-.-.-.-.-.-,-,-.-.-.-.-.-.-.-.-.-.-.-.-.-.-.-X-,-,-,-,-,-,-,-X-.-.-.-.-.-.-.-.-.-.-.-.-.-.-.-.-.-.-.-X-
------------------------------------------,-X-.-.-.-.-.-.-.-.-.-.-.-.-.-,-.-,-.-.-.-.-.-,-.-,-.-.-.-.-.-,-.-,-.-,-,-,-,-.-,-,-.-.-.-.-.-.-,-,-.-.-.-.-.-.-,-,-.-.-.-.-.-.-.-.-.-.-.-.-.-.-.-X-X-X-X-X-X-X-X-X-.-.-.-.-.-.-.-.-.-.-.-.-.-.-.-.-.-.-.-X-
------------------------------------------,-X-.-.-.-.-.-A-.-.-.-.-.-.-.-,-.-,-.-.-.-.-.-,-.-,-.-.-.-.-.-,-.-,-.-,-.0.0,0.-,-,-.-.-.-.-.-.-,-,-.-.-.-.-.-.-,-,-.-.-.-.-.-.-.-.-.-.-.-.-.-.-.-+-.-.-.-.-.-.-.-.-.-.-.-.-.-.-.-.-.-.-.-.-.-.-.-.-.-.-.-X-
------------------------------------------,-X-.-.-.-.-.-.-.-.-.-.-.-.-.-,-.-,-.-.-.-.-.-,-.-,-.-.-.-<-.-,-.-,-W-,-.0H0,0.-W-,-.-.-.-<-.-.-,-,-.-.-.-.-.-.-,-,-.-.-.-.-.-.-A-.-.-.-.-.-.-.-.-+-.-A-.-.-.-.-.-.-.-.-.-.-.-.-.-.-.-.-,-,-,-,-,-,-,-,-.-X-
------------------------------------------,-X-.-.-.-.-.-.-.-.-.-.-.-.-.-,-.-,-.-.-.-.-.-,-.-,-.-.-.-.-.-,-.-,-.-,-,0,0,0.-,-,-.-.-.-.-.-.-,-,-.-.-.-.-.-.-,-,-.-.-.-.-.-.-.-.-.-.-.-.-.-.-.-+-.-.-.-.-.-.-.-.-.-.-.-.-.-.-.-.-.-.-X-X5.5.5.5.5.5,5,-X-
------------------------------------------,-X-.-.-.-.-.-.-.-.-.-.-.-.-.-,-.-,-.-.-.-.-.-,-.-,-.-.-.-.-.-,-.-,-.-.-.-.-.-.-,-,-.-.-.-.-.-.-,-,-.-.-.-.-.-.-,-,-.-.-.-.-.-.-.-.-.-.-.-.-.-.-.-X-X-X-X-X-X-X-X-X-.-.-.-.-.-.-.-.-.-.-,-.5.5.5.5.5.5,5.-X-
------------------------------------------,-X-.-.-.-.-.-.-.-.-.-.-.-.-.-,-.-,-.-.-.-.-.-,-.-,-.-.-.-.-.-,-.-,-A-,-,-W-,-,-A-,-.-.-.-.-.-.-,-,-.-.-.-.-.-.-,-,-.-.-.-.-.-.-.-.-.-.-.-.-.-.-.-X-------------,-X-.-.-.-.-.-.-.-.-.-.-,-.5.5H5H5H5.5,5.-X-
------------------------------------------,-X-.-.-.-.-.-.-.-.-.-.-.-.-.-,-X-X-.-.-.-.-.-,-,-,-.-.-.-.-.-X-X-X-,-,-,-,-,-,-,-X-X-X-.-.-.-.-,-,-.-.-.-.-.-.-,-X-.-.-.-.-.-.-.-.-.-.-.-.-.-.-.-X-------------,-X-.-.-.-.-.-.-.-.-.-.-,-.5.5.5.5.5.5,5.-X-
------------------------------------------,-X-.-.-.-.-.-.-.-.-.-.-.-.-.-.-X-X-.-.-.-.-.-,-.-,-.-.-.-.-.-X-.-X-.-.-.-.-.-.-.-X-.-X-.-.-.-.-,-,-.-.-.-.-.-.-.-X-.-.-.-.-.-.-.-.-.-.-.-.-.-.-.-X-------------,-X-.-.-.-.-.-.-.-.-.-.-,-.5.5H5H5H5.5,5.-X-
------------------------------------------,-X-.-.-.-.-.-.-.-.-.-.-.-.-.-.-X-X-.-.-.-.-.-,-.-,-.-.-.-.-.-X-X-X-.-.-.-.-.-.-.-X-X-X-.-.-.-.-,-,-.-.-.-.-.-.-.-X-.-.-.-.-.-.-.-.-.-.-.-.-.-.-.-X-------------,-X-.-.-.-.-.-.-.-.-.-.-,-.5.5.5.5.5.5,5,-X-
------------------------------------------,-X-.-.-.-.-.-.-.-.-.-.-.-.-.-.-X-X-.-.-.-.-.-,-.-,-.-.-.-.-.-.-.-.-.-.-.-.-.-.-.-.-.-.-.-.-.-.-,-,-.-.-.-.-.-.-.-X-.-.-.-.-.-.-.-.-.-.-.-.-.-.-.-X-------------,-X-.-.-.-.-.-.-.-.-.-.-X-X5,5,5,5,5,5,5.-X-
------------------------------------------,-X-.-.-.-.-.-.-.-.-.-.-.-.-.-.-X-X-.-.-.-.-.-,-.-,-.-.-.-.-.-.-.-.-.-.-.-<-.-.-.-.-.-.-.-.-.-.-,-,-.-.-.-.-.-.-.-X-.-.-.-.-.-.-.-.-.-.-.-.-.-.-.-X-------------,-X-.-A-.-.-.-.-.-.-.-.-X-X-.-.-.-.-.-.-.-X-
----------------------------------------,-,-X-.-.-.-.-.-.-.-.-.-.-.-.-.-.-X-X-.-.-.-.-.-,-.-,-.-.-.-.-.-.-.-.-.-.-.-.-.-.-.-.-.-.-.-.-.-.-,-,-.-.-.-.-.-.-.-X-.-.-.-.-.-.-.-.-.-.-.-.-.-.-.-X-------------,-X-.-.-.-.-.-.-.-.-.-.-.-.-.-.-.-.-.-.-.-X-
----------------------------------------,-X-X-.-.-.-.-.-.-.-.-.-.-.-.-.-.-X-X-.-.-.-.-.-,-.-,-B-.-.-.-.-.-.-.-.-.-.-.-.-.-.-.-.-.-.-.-.-.-B-,-.-.-.-.-.-.-.-X-.-.-.-.-.-.-.-.-.-.-.-.-.-.-.-X-------------,-X-X-X-X-X-X-X-+-+-+-X-X-X-X-X-X-X-X-X-X-X-
----------------------------------------,-X-.-.-.-.-.-.-.-.-.-.-.-.-.-.-.-X-X-.-.-.-.-.-,-.-,-B-B-,-,-,-,-,-,-,-,-,-,-,-,-,-,-,-,-,-,-,-B-B-,-.-.-.-.-.-.-.-X-.-.-.-.-.-.-.-.-.-.-.-.-.-.-.-X-------------------------,-X-.-.-.-X-,-,-,-,-------------
----------------------------------------,-X-.-.-.-.-.-.-.-.-.-.-.-.-.-.-.-X-X-.-.-.-.-.-,-,-,-,-,-,-,-,-,-,-,-,-,-,-,-,-,-,-,-,-,-,-,-,-,-,-,-.-.-.-.-.-.-.-X-.-.-.-.-.-.-.-.-.-.-.-.-.-.-.-X-------------------------,-X-.-.-.-X-,-X-X-X-------------
--------------,-,-,-,-,-,-,-,-,-,-,-,-,-,-X-.-.-.-.-.-.-.-.-.-.-.-.-.-.-.-X-X-.-.-.-.-.-.-.-.-.-.-.-.-.-.-.-.-.-.-.-.-.-.-.-.-.-.-.-.-.-.-.-.-.-.-.-.-.-.-.-X-.-.-.-.-.-.-.-.-.-.-.-.-.-.-.-X-------------------------,-X-.-.-.-X-,-X-.-X-,-,-,-,-----
--------------,-X-X-X-X-X-X-X-X-X-X-X-X-X-X3.3.-.-.-.-.-.-.-.-.-.-.-.-.-.-X-X-.-.-.-.-.-.-.-.-.-.-.-.-.-.-.-.-.-.-.-.-.-.-.-.-.-.-.-.-.-.-.-.-.-.-.-.-.-.-.-X-.-.-.-.-.-.-.-.-.-.-.-.-.-.-.-X-------------------------,-X-.-.-.-X-X-X6t6X6X-X-X-X-----
--------------,-X-.-.-.-.-.-.-.-.-.-.-.-.-.3+S.-.-.-.-.-.-.-.-.-.-.-.-.-.-X-X-.-.-.-.-.-.-.-.-.-.-.-.-.-.-.-.-.-.-.-.-.-.-.-.-.-.-.-.-.-.-.-.-.-.-.-.-.-.-.-X-.-.-.-.-.-.-.-.-.-.-.-.-.-.-.-X-------------------------,-X-.-.-.-.-.-.-.-.-.-,-,-X-----
--------------,-X-.-.-.-.-.-.-.-.-.-.-.-.-.3+S.-.-.-.-.-.-.-.-.-.-.-.-.-.-X-X-.-.-.-.-.-.-.-.-.-.-.-.-.-.-.-.-.-.-.-.-.-.-.-.-.-.-.-.-.-.-.-.-.-.-.-.-.-.-.-X-.-.-.-.-.-.-.-.-.-.-.-.-.-.-.-X-------------------------,-X-.-.-.-.-.-.-.-.-.-,-,-X-----
--------------,-X-.-.-.-.-.-.-.-.-.-.-.-.-.3+S.-.-.-.-.-.-.-.-.-.-.-.-.-.-X-X-.-.-.-.-.-.-.-.-.-.-.-.-.-.-.-.-.-.-.-.-.-.-.-.-.-.-.-.-.-.-.-.-.-.-.-.-.-.-.-X-.-.-.-.-.-.-.-.-.-.-.-.-.-.-.-X-------------------------,-X-.-.-.-.-.-.-.-.-.-,-.-X-----
--------------,-X-.-.-.-X-X-X-X-X-X-X-X-X-X3XS.-.-.-.-.-.-.-.-.-.-.-.-.-.-X-X-.-H-.-.-.-.-.-.-.-.-.-.-.-.-.-.-.-.-.-.-.-.-.-.-.-.-.-.-.-.-.-.-.-.-.-.-.-.-.-X-.-.-.-.-.-.-.-.-.-.-.-.-.-.-.-X-------------------------,-X-.-.-.-.-.-.-.-.-.-,-,-X-----
--------------,-X-.-.-.-X---------,-,-,-,-,-X-.-.-.-.-.-.-.-.-.-.-.-.-.-.-X-X-.-.-.-.-.-.-.-.-.-.-.-.-.-.-,-,-,-,-,-,-,-,-,-,-.-.-.-.-.-.-.-.-.-.-.-.-.-.-.-X-.-.-.-.-.-.-.-.-.-.-.-.-.-.-.-X-,-,-,-,-----------------,-X-.-.-.-.-.-.-.-.-.-,-,-X-----
--------------,-X-.-H-.-X---------,-X-X-X-X-X-.-.-.-.-.-.-.-.-.-.-.-.-.-.-X-X-X-X-X-X-X-X-X-X-X-X-X-X-X-X-X-X-,-,-,-,-,-,-,-X-X-X-X-X-X-X-X-X-X-X-X-X-X-X-X-X-.-.-.-.-.-.-.-.-.-.-.-.-.-.-.-X-X-X-X-X-----------------,-X-.-.-.-.-.-.-.-.-.-,-,-X-----
--------------,-X-.-.-.-X---------,-X-.-.-.-.-.-.-.-.-.-.-.-.-.-.-.-.-.-.-.-.-.-.-.-.-.-.-.-.-.-.-.-.-.-.-.-.-.-.-.-.-.-.-.-.-.-.-.-.-.-.-.-.-.-.-.-.-.-.-.-.-.-.-.-.-.-.-.-.-.-.-.-.-.-.-.-.-.-.-.-X-----------------,-X-.-.-.-.-.-.-.-.-.-,-,-X-----
--------------,-X-.-.-.-X---------,-X-.-A-.-.-.-.-.-.-.-.-.-.-.-.-.-.-.-.-.-.-.-.-.-.-.-.-.-.-.-.-.-.-.-.-.-.-.-.-.-.-.-.-.-.-.-.-.-.-.-.-.-.-.-.-.-.-.-.-.-.-.-.-.-.-.-.-.-.-.-.-.-.-.-.-.-.-.-.-.-X-----------------,-X-X-X-X-X-X-X-X-X-X-X-X-X-----
--------------,-X-.-.-.-X---------,-X-.-.-.-.-.-.-.-.-.-.-.-.-.-.-.-.-.-.-.-.-.-.-.-.-.-.-.-.-.-.-.-.-.-.-.-.-.-.-.-.-.-.-.-.-.-.-.-.-.-.-.-.-.-.-.-.-.-.-.-.-.-.-.-.-.-.-.-.-.-.-.-.-.-.-.-.-.-.-.-X-------------------------------------------------
--------------,-X-.-.-.-X---------,-X-.-.-.-.-.-.-.-.-.-.-.-.-.-.-.-.-.-.-.-.-.-.-.-.-.-.-.-.-.-.-.-.-.-.-.-.-.-.-.-.-.-.-.-.-.-.-.-.-.-.-.-.-.-.-.-.-.-.-.-.-.-.-.-.-.-.-.-.-.-.-.-.-.-.-.-.-.-.-.-X-------------------------------------------------
--------------,-X-.-.-.-X---------,-X-.-.-.-.-.-.-.-.-.-.-.-.-.-.-.-.-.-.-.-.-.-.-.-.-.-.-.-.-.-.-.-.-.-.-.-.-.-.-.-.-.-.-.-.-.-.-.-.-.-.-.-.-.-.-.-.-.-.-.-.-.-.-.-.-.-.-.-.-.-.-.-.-.-.-.-.-.-.-.-X-------------------------------------------------
--------------,-X-.-.-.-X---------,-X-.-.-.-.-.-.-.-.-.-.-.-.-.-.-.-.-.-.-.-.-.-.-.-.-.-.-.-.-.-.-.-.-.-.-.-.-.-.-.-.-.-.-.-.-.-.-.-.-.-.-.-.-.-.-.-.-.-.-.-.-.-.-.-.-.-.-.-.-.-.-.-.-.-.-.-.-.-.-.-X-------------------------------------------------
--------------,-X-.-.-.-X---------,-X-.-.-.-.-.-.-.-.-.-.-.-.-.-.-.-.-.-.-.-.-.-.-.-.-.-.-.-.-.-.-.-.-.-.-.-.-.-.-.-.-.-.-.-.-.-.-.-.-.-.-.-.-.-.-.-.-.-.-.-.-.-.-.-.-.-.-.-.-.-.-.-.-.-.-.-.-.-.-.-X-------------------------------------------------
--------------,-X-.-.-.-X---------,-X-.-W-.-.-.-.-.-.-.-.-.-A-.-.-.-.-.-.-.-.-.-.-.-.-.-.-.-.-.-.-.-.-.-.-.-.-.-.-.-A-.-.-.-.-.-.-.-.-.-.-.-.-.-.-.-.-.-.-.-.-.-.-.-.-.-.-.-A-.-.-.-.-.-.-.-.-.-W-.-X-------------------------------------------------
--------------,-X-.-.-.-X---------,-X-<-.-.-.-.-.-.-.-.-.-.-.-.-.-.-.-.-.-.-.-.-.-.-.-.-.-.-.-.-.-.-.-.-.-.-.-.-.-.-.-.-.-.-.-.-.-.-.-.-.-.-.-.-.-.-.-.-.-.-.-.-.-.-.-.-.-.-.-.-.-.-.-.-.-.-.-.-.-<-X-------------------------------------------------
--------------,-X-.-.-.-X---------,-X-.-.-.-.-.-.-.-.-.-.-.-.-.-.-.-.-.-.-.-.-.-.-.-.-.-.-.-.-.-.-.-.-.-.-.-.-.-.-.-.-.-.-.-.-.-.-.-.-.-.-.-.-.-.-.-.-.-.-.-.-.-.-.-.-.-.-.-.-.-.-.-.-.-.-.-.-.-.-.-X-----,-,-,-,-,-,---------------------------------
--------------,-X-.-.-.-X---------,-X-.-.-.-.-.-.-.-.-.-.-.-.-.-.-.-.-.-.-.-.-.-.-.-.-.-.-.-.-.-.-.-.-.-.-.-.-.-.-.-.-.-.-.-.-.-.-.-.-.-.-.-.-.-.-.-.-.-.-.-.-.-.-.-.-.-.-.-.-.-.-.-.-.-.-.-.-.-.-.-X-,-,-,-X-X-X-X-X---------------------------------
--------------,-X-.-.-.-X---------,-X-.-.-.-.-.-.-.-.-.-.-.-.-.-.-.-.-.-.-.-.-.-.-.-.-.-.-.-.-.-.-.-.-.-.-.-.-.-.-.-.-.-.-.-.-.-.-.-.-.-.-.-.-.-.-.-.-.-.-.-.-.-.-.-.-.-.-.-.-.-.-.-.-.-.-.-.-.-.-.-X-X-X-X-X-.-.-.-X---------------------------------
--------------,-X-.-.-.-X---------,-X-.-.-.-.-.-.-.-.-.-.-.-.-.-.-.-.-.-.-.-.-.-.-.-.-.-.-.-.-.-.-.-.-.-.-.-.-.-.-.-.-.-.-.-.-.-.-.-.-.-.-.-.-.-.-.-.-.-.-.-.-.-.-.-.-.-.-.-.-.-.-.-.-.-.-.-.-.-.-.-X-.-.-.-.-.-.-.-X---------------------------------
--------------,-X-.-.-.-X---------,-X-.-A-.-.-.-.-.-.-.-.-.-.-.-.-.-.-.-.-.-.-.-.-.-.-.-.-.-.-.-.-.-.-.-.-.-.-.-.-.-.-.-.-.-.-.-.-.-.-.-.-.-.-.-.-.-.-.-.-.-.-.-.-.-.-.-.-.-.-.-.-.-.-.-.-.-.-.-.-.-X-.-A-.-.-.-A-.-X---------------------------------
--------------,-X-.-.-.-X---------,-X-.-.-.-.-.-.-.-.-.-.-.-.-.-.-.-.-.-.-.-.-.-.-.-.-.-.-.-.-.-.-.-.-.-.-.-.-.-.-.-.-.-.-.-.-.-.-.-.-.-.-.-.-.-.-.-.-.-.-.-.-.-.-.-.-.-.-.-.-.-.-.-.-.-.-,-,-,-,-,-X-.-.-.-.-.-.-.-X---------------------------------
--------------,-X-.-.-.-X---------,-X-X-X-X-X-.-.-.-.-.-.-.-.-.-.-.-.-.-.-.-X-X-X-X-X-X-X-X-X-X-X-X-X-X-X-X-X-X-X2.2.2.2X2X-X-X-X-X-X-X-X-X-X-X-X-X-X-X-X-X-X-.-.-.-.-.-.-.-.-.-.-.-.-.-.-,-......,.X..-.-.-.-.-.-.-X---------------------------------
,-,-,-,-,-,-,-,-X-.-A-.-X-,-,-,-,-,-,-,-,-,-X-.-.-.-.-.-.-.-.-.-.-.-.-.-.-.-X---------------------------------,-X-.-.-.-X---------------------------------,-X-.-.-.-.-.-.-.-.-.-.-.-.-.-.-,-......,....-.-.-.-.-.-.-X---------------------------------
X-X-X-X-X-X-X-X-X-.-.-.-X-X-X-X-X-X-X-X-X-,-X-.-A-.-.-.-.-.-W-.-.-.-.-.-.-.-X---------------------------------,-X-.-.-.-X---------------------------------,-X-.-.-.-.-.-.-.-W-.-.-.-.-.-.-,-....A.,....-.-.-.-.-.-.-X---------------------------------
X-.-.-.-.-.-.-.-.-.-.-.-.-.-.-.-.-.-.-.-X-,-X-.-.-.-.-.-.-<-.-.-.-.-.-.-.-.-X---------------------------------,-X-.-.-.-X---------------------------------,-X-.-.-.-.-.-.-.-.-<-.-.-.-,-,-,-,.,.,.,....-.-.-.-.-.-.-X---------------------------------
X-.-A-.-.-.-X-X-X-.-.-.-X-X-X-.-.-.-H-.-X-,-X-X-X-X-X-X-X-X-X-X-X-X-X-X-X-X-X---------------------------------,-X-.-H-.-X---------------------------------,-X-X-X-X-X-X-X-X-X-X-X-X-X-X-X-X-X..........-.-.-.-.-.-.-X---------------------------------
X-.-.-.-.-.-X-.-X-.-.-.-X-.-X-.-.-.-.-.-X---------------------------------------------------------------------,-X-.-.-.-X---------------------------------------------------------,-X-.-.-.-.-.-.-.-.-H-.-.-.-.-.-.-X---------------------------------
X-.-.-.-.-.-X-X-X-.-.-.-X-X-X-.-.-.-.-.-X---------------------------------------------------------------------,-X-.-.-.-X---------------------------------------------------------,-X-A-.-.-.-.-.-.-.-.-.-.-.-.-.-.-X---------------------------------
X-.-.-.-.-.-.-.-.-.-.-.-.-.-.-.-.-.-.-.-X---------------------------------------------------------------------,-X-.-.-.-X-------------------------------------------------------,-,-X-.-.-.-.-.-.-.-.-.-.-.-.-.-.-.-X---------------------------------
X-.-.-.-X-X-X-.-.-.-.-.-.-.-.-.-X-X-X-.-X---------------------------------------------------------------------,-X-.-.-.-X-------------------------------------------------------,-X-X-.-.-.-.-.-.-.-.-.-.-.-.-.-.-.-X---------------------------------
X-.-.-.-X-.-X-.-.-.-.-.-.-.-.-.-X-.-X-.-X-,-,-,-,-,-,-,-,-,-,-,-,-,-,-,-,-,-,-,-,-,-,-,-,-,-,-,-,-,-,-,-,-,-,-,-X-.-.-.-X-------------------------------------------------------,-X-.-.-.-.-.-.-.-.-.-.-.-.-.-.-.-.-X---------------------------------
X-.-.-.-X-X-X-.-.-.-A-.-.-.-.-.-X-X-X-.-X-X-X-X-X-X-X-X-X-X-X-X-X-X-X-X-X-X-X-X-X-X-X-X-X-X-X-X-X-X-X-X-X-X-X-X-X-.-.-.-X-------------------------------------------------------,-X-.-.-.-.-.-.-.-.-.-.-.-.-.-.-W-.-X---------------------------------
X-.-.-.-.-.-.-.-.-.-.-.-.-.-.-.-.-.-.-.-.-.-.-.-.-.-.-.-.-.-.-.-.-.-.-.-.-.-.-.-.-.-.-.-.-.-.-.-.-.-.-.-.-.-.-.-.-.-.-.-X-------------------------------------------------------,-X-.-A-.-.-.-.-.-.-.-.-.-.-.-.-.-.-X---------------------------------
X-.-A-.-.-.-.-.-.-.-.-.-.-.-.-.-.-.-.-.-.-.-.-A-.-.-.-.-.-.-.-.-.-.-.-.-.-.-.-.-.-.-.-.-.-.-.-.-.-.-.-.-.-.-.-.-.-.-.-.-X-------------------------------------------------------,-X-X-X-X-X-X-X-X-X-X-X-X-X-X-X-X-X-X---------------------------------
X-.-.-,-,-,-,-.-.-.-.-.-.-.-.-.-.-.-.-.-.-.-.-.-.-.-.-.-.-.-.-.-.-.-.-.-.-.-.-.-.-.-.-.-.-.-.-.-.-.-.-.-.-.-.-.-.-.-.-.-X-----------------------------------------------------------------------------------------------------------------------------
X-.-.-,-.4.4,4.-.-.-X-X-X-.-.-.-X-X-X-.-X-X-X-X-X-X-X-X-X-X-X-X-X-X-X-X-X-X-X-X-X-X-X-X-X-X-X-X-X-X-X-X-X-X-X-X-X-X-X-X-X-----------------------------------------------------------------------------------------------------------------------------
X-.-.-,-.4W4,4.-.-.-X-.-X-.-A-.-X-.-X-.-X-------------------------------------------------------------------------------------------------------------------------------------------------------------------------------------------------------------
X-.-.-,-,4,4,4.-.-.-X-X-X-.-.-.-X-X-X-.-X-------------------------------------------------------------------------------------------------------------------------------------------------------------------------------------------------------------
X-.-.-.-.-.-.-.-.-.-.-.-.-.-.-.-.-.-.-.-X-------------------------------------------------------------------------------------------------------------------------------------------------------------------------------------------------------------
X-.-.-.-.-.-.-.-.-.-.-.-.-.-.-.-.-.-.-.-X-------------------------------------------------------------------------------------------------------------------------------------------------------------------------------------------------------------
X-.-.-.-.-.-.-.-.-.-.-.-.-.-.-.-.-.-.-.-X-------------------------------------------------------------------------------------------------------------------------------------------------------------------------------------------------------------
X-.-<-.-.-.-.-.-.-A-.-.-.-.-.-H-.-.-H-.-X-------------------------------------------------------------------------------------------------------------------------------------------------------------------------------------------------------------
X-.-.-.-.-.-.-.-.-.-.-.-.-.-.-.-.-.-.-.-X-------------------------------------------------------------------------------------------------------------------------------------------------------------------------------------------------------------
X-X-X-X-X-X-X-X-X-X-X-X-X-X-X-X-X-X-X-X-X-------------------------------------------------------------------------------------------------------------------------------------------------------------------------------------------------------------
