------------------------------------------------------------------------------------------,-,->->->-,---------------------------------------------------------------------------------------------
------------------------------------------------------------------------------------------,-X6.6.6.6X6--------------------------------------------------------------------------------------------
------------------------------------------------------------------------------------------,-X6.6.6.6X6--------------------------------------------------------------------------------------------
------------------------------------------------------------------------------------------,-X-.-W-.-X---------------------------------------------------------------------------------------------
------------------------------------------------------------------------------------------,-X-.-.-.-X---------------------------------------------------------------------------------------------
------------------------------------------------------------------------------------------,-X-.-A-.-X---------------------------------------------------------------------------------------------
------------------------------------------------------------------------------------------,-X-.-A-.-X---------------------------------------------------------------------------------------------
------------------------------------------------------------------------------------------,-X-.-A-.-X---------------------------------------------------------------------------------------------
------------------------------------------------------------------------------------------,-X-.-A-.-X---------------------------------------------------------------------------------------------
------------------------------------------------------------------------------------------,-X-.-A-.-X---------------------------------------------------------------------------------------------
------------------------------------------------------------------------------------------,-X-.-A-.-X---------------------------------------------------------------------------------------------
------------------------------------------------------------------------------------------,-X-.-H-.-X---------------------------------------------------------------------------------------------
------------------------------------------------------------------------------------------,-X-.-.-.-X---------------------------------------------------------------------------------------------
------------------------------------------------------------------------------------------,-X-.-.-.-X---------------------------------------------------------------------------------------------
------------------------------------------------------------------------------------------,-X-.-.-.-X---------------------------------------------------------------------------------------------
------------------------------------,-,-,-,-,-,-------------------------------------------,-X5.5.5.5X5------------------------------------------,-,-,-,-,-,---------------------------------------
----------------------,-,-,-,-,-,-,-,-X-X-X-X-,-,-,---------------------------------------,-X-.-.-.-X---------------------------------------,-,-,-X-X-X-X-X-,-,-,-,-,-,-,-------------------------
--------------,-,-,-,-,-X-X-X-X-X-X-X-W-.-,-.-X-X-,-,-,-----------------------------------,-X-.-.-.-X-----------------------------------,-,-,-X-X-,-.-.-.-.-X-X-X-X-X-X-X-,-,-,-,-----------------
------------,-,-X-X-X-X-.-.-.-H-.-.-.-.-,-,-.-.-.-X-X-,-,-,-------------------------------,-X-.-.-.-X-------------------,-,---------,-,-,-X-X-.-.-,-,-.-.-.-.-.-.-.-A-H-.-X-X-X-X-,---------------
----------,-,-X-,-.-.-.-A-.-.-.-.-.-.-.-,-.-.-.-.-.-.-X-X-,-,-----,-,-,-------------------,-X-.-.-.-X-------------------,-X-------,-,-X-X-.-.-.-.-.-,-.-.-.-.-.-.-.-.-.-.-.-,-.-.-X-,-------------
--------,-,-X-.-,-,-.-.-.-.-.-.-.-.-.-.-,-.-.-.-.-.-.-.-,-X-X-----,-X-X-------------------,-X-.-.-.-X-------------------,-X-------,-X-.-.-.-.-.-.-.-,-.-.-.-.-.-.-.-.-.-.-,-,-.-A-.-X-,-----------
------,-,-X-.-A-.-,-.-.-.-.-.-.-.-.-.-.-,-.-.-.-.-.-.-.-,-.-,-X---,-X-X-------------------,-X-.-.-.-X-------------------,-X-----,-,-X-.-.-.-.-.-.-.-,-.-.-.-.-.-.-.-.-.-.-,-.-.-.-.-.-X-,---------
----,-,-X-.-.-.-.-,-,-.-.-.-.-.-.-.-.-,-,-.-.-.-.-.-.-,-,-.-.-X---,-X-X-------------------,-X-.-.-.-X-------------------,-X-----,-X-,-,-.-.-.-.-.-.-,-,-.-.-.-.-.-.-.-.-,-,-.-.-.-.-W-.-X-,-------
--,-,-X-.-W-.-.-.-.-,-.-.-.-.-.-.-.-.-,-.-.-.-.-.-.-,-,-.-.-.-,-X-,-X-X-------------------,-X-.-.-.-X-------------------,-X---,-,-X-.-,-,-.-.-.-.-.-.-,-.-.-.-.-.-.-.-.-,-.-.-.-.-.-.-.-.-X-,-----
,-,-X-.-.-.-.-.-.-.-,-,-.-.-.-.-.-.-.-,-.-.-.-.-.-,-,-.-.-.-.-.-X-,-X-X-------------------,-X-.-.-.-X-------------------,-X---,-X-.-.-.-,-,-.-.-.-.-.-,-.-.-.-.-.-.-.-,-,-.-.-.-.-.-.-.-.-A-X-,---
,-X-.-A-.-.-.-.-.-.-.-,-.-.-.-.-.-.-.-,-.-.-.-.-.-,-.-.-.-.-.-.-,-X-X-X-------------------,-X-.-.-.-X-------------------,-X-,-,-X-.-.-.-.-,-.-.-.-.-.-,-.-.-.-.-.-.-.-,-.-.-.-.-.-.-.-.-.-.-.-X-,-
X-.-.-.-.-.-.-.-.-.-.-,-,-.-.-.-.-.-.-,-.-.-.-.-,-,-.-.-.-.-.-.-.-X-X-X-------------------,-X-.-.-.-X-------------------,-X-,-X-.-.-.-.-.-,-,-.-.-.-.-,-.-.-.-.-.-.-,-,-.-.-.-.-.-.-.-.-.-,-,-,-X-
X-,-,-.-.-.-.-.-.-.-.-.-,-.-.-.-.-.-,-,-.-.-.-,-,-.-.-.-.-.-.-.-.-,-X-X-------------------,-X-.-.-.-X-------------------,-X-,-X-.-.-.-.-.-.-,-,-.-.-.-,-,-.-.-.-.-,-,-.-.-.-.-.-.-.-.-,-,-,-.-.-X-
X-.-,-,-,-.-.-.-.-.-.-.-,-,-.-.-.-.-,-.-.-.-,-,-.-.-.-.-.-.-.-,-,-,-X-X-------------------,-X-.-.-.-X-------------------,-X-X-,-,-.-.-.-.-.-.-,-,-.-.-.-,-.-.-.-.-,-.-.-.-.-.-.-.-,-,-,-.-.-.-.-X-
X-W-.-.-,-,-.-.-.-.-.-.-.-,-.-.-.-.-,-.-.-.-,-.-.-.-.-.-.-,-,-,-.-,-X-X-----------,-,-,-,-,-X-.-.-.-X-,-,-,-,-----------,-X-X-.-,-,-,-.-.-.-.-.-,-.-.-.-,-.-.-.-,-,-.-.-.-.-.-,-,-,-.-.-.-.-.-W-X-
X-.-.-.-.-,-,-,-.-.-.-.-.-,-,-.-.-.-,-.-.-,-,-.-.-.-.-.-,-,-.-.-.-,-X-X-----------,-X-X-X-X-X-.-.-.-X-X-X-X-X-----------,-X-X-.-.-.-,-,-.-.-.-.-,-,-.-.-,-.-.-.-,-.-.-.-.-.-,-,-.-.-.-.-.-.-.-.-X-
X-.-.-.-.-.-.-,-,-,-.-.-.-.-,-.-.-,-,-.-,-,-.-.-.-.-,-,-,-.-.-.-.-,-X-X-----------,-X-.-.-.-.-.-.-.-.-.-.-.-X-----------,-X-X-.-.-.-.-,-,-,-.-.-.-,-,-.-,-,-.-,-,-.-.-.-,-,-,-.-.-.-.-.-.-.-.-.-X-
X-A-.-.-.-.-.-.-.-,-,-.-.-.-,-,-.-,-.-,-,-.-.-.-,-,-,-.-.-.-.-.-.-,-X-X-----------,-X-.-.-.-.-<-.-.-.-.-.-.-X-----------,-X-X-.-.-.-.-.-.-,-,-,-.-.-,-,-.-,-.-,-.-.-,-,-,-.-.-.-.-.-.-.-.-.-.-A-X-
X-.-.-.-.-.-.-.-.-.-,-,-,-.-.-,-.-,-.-,-.-.-.-,-,-.-.-.-.-.-.-.-.-,-X-X-,-,-,-,-,-,-X-.-.-.-.-.-.-.-.-.-.-.-X-,-,-,-,-,-,-X-X-.-.-.-.-.-.-.-.-,-,-.-.-,-.-,-,-,-,-,-,-.-.-.-.-.-.-.-.-.-.-.-.-.-X-
X-.-.-.-.-.-.-.-.-.-.-.-,-,-,-,-X-X-X-,-.-,-,-,-.-.-.-.-.-.-.-.-.-,-X-X-X-X-X-X-X-X-X-.-.-.-.-.-.-.-.-.-.-.-X-X-X-X-X-X-X-X-X-.-.-.-.-.-.-.-.-.-,-,-,-,-,-,-X-X-,-.-.-.-.-.-.-.-.-.-.-.-.-.-.-.-X-
X-H-.-.-.-.-.-.-.-.-.-.-.-.-,-X-----,-X-,-,-.-.-.-.-.-.-.-.-.-.-.-,-X-X-X-.-A-.-.-.-.-.-.-.-.-.-.-.-.-.-.-.-.-.-.-.-A-.-X-X-X-.-.-.-.-.-.-.-.-.-.-.-,-,-,-X---,-X-.-.-.-.-.-.-.-.-.-.-.-.-.-.-H-X-
X-.-.-.-.-.-.-.-.-.-.-.-.-.-.-X-----,-X-.-.-.-.-.-.-.-.-.-.-.-.-.-,-X-X-X-W-A-.-H-,-,-,-.-.-.-.-.-.-.-.-,-,-,-,-H-,-A-W-X-X-X-.-.-.-.-.-.-.-.-.-.-.-.-.-,-X---,-X-,-.-.-.-.-.-.-.-.-.-.-.-.-.-.-X-
X-.-.-.-.-.-.-.-.-.-.-.-.-,-,-X-,-,-,-X-,-,-,-,-,-,-,-,-,-,-,-,-,-,-X-X-X3,3X3X-X-X4,4X4X-X-X0.0.0.0X0X-X-X1,1X1X-X2A2X2X-X-X-,-,-,-,-,-,-,-,-,-,-,-,-,-,-X-,-,-X-,-,-,-,-.-.-.-.-.-.-.-.-.-.-.-X-
X-.-.-.-.-.-.-.-.-.-,-,-,-,-.-.-X-X-X-.-.-.-.-.-.-.-.-.-.-.-.-.-.-.-X-X-X-.-X-X-X-X-.-X-X-X-X-.-.-.-X-X-X-X-.-X-X-X-.-X-X-X-X-.-.-.-.-.-.-.-.-.-.-.-.-.-.-.-X-X-,-.-.-.-,-,-,-,-.-.-.-.-.-.-.-W-X-
X-.-.-.-.-.-.-,-,-,-,-.-.-.-.-,-,-,-.-.-.-.-.-.-.-.-.-.-.-.-.-.-.-.-,-.-.-.-.-.-.-.-.-.-.-.-.-.-.-.-.-.-.-.-.-.-.-.-.-.-.-,-.-.-.-.-.-.-.-.-.-.-.-.-.-.-.-.-,-.-,-,-.-.-.-.-.-,-,-,-,-,-.-.-.-.-X-
X-.-.-.-,-,-,-,-.-.-.-.-.-.-.-,-.-,-.-.-.-.-.-.-.-.-.-.-.-.-.-.-.-.-,-.-.-.-.-.-.-.-.-.-.-.-.-.-.-.-.-.-.-.-.-.-.-.-.-.-.-,-.-.-.-.-.-.-.-.-.-.-.-.-.-.-.-.-,-.-.-,-.-.-.-.-.-.-.-.-.-,-,-,-,-.-X-
X-,-,-,-,-.-.-.-.-.-.-.-.-,-,-,-.-,-.-.-.-.-.-.-.-.-.-.-.-.-.-.-.-.-,-.-.-.-.-.-.-.-.-.-.-.-.-.-.-.-.-.-.-.-.-.-.-.-.-.-.-,-.-.-.-.-.-.-.-.-.-.-.-.-.-.-.-.-,-.-.-,-,-.-.-.-.-.-.-.-.-.-.-.-,-,-X-
X-,-.-.-.-.-.-.-.-.-.-.-,-,-.-.-.-,-,-.-.-.-.-.-.-.-.-.-.-.-.-.-.-,-<-,-,-A-,-,-,-,-.-.-.-.-.-.-.-.-.-.-.-,-,-,-,-,-,-,-,-,-,-.-.-.-.-.-.-.-.-,-,-,-.-.-.-,-,-.-.-.-,-,-.-.-.-.-.-.-.-.-.-.-.-,-X-
,-X-.-.-.-.-.-.-.-.-.-,-,-.-.-.-.-.-,-.-.-.-.-.-.-.-.-.-.-.-.-.-.-,-.-.-.-.-A-A-W-,-,-.-.-.-.-.-.-.-.-.-,-,-.-W-A-A-A-A-.-.-,-.-.-.-.-.-.-.-.-,-.-,-,-,-,-,-.-.-.-.-.-,-.-.-.-.-.-.-.-.-.-.-,-X---
--,-X-.-.-.-.-.-.-.-.-,-.-.-.-.-.-.-,-.-.-.-.-.-.-.-.-.-.-.-.-.-,-,-.-W-.-.-.-.-.-.-,-.-.-.-.-.-.-.-.-.-,-.-.-.-.-.-.-.-.-<-,-,-.-.-.-.-.-.-.-,-.-,-,-.-,-,-.-.-.-.-.-,-,-.-.-.-.-.-.-.-.-,-X-----
----,-X-.-.-.-.-.-.-,-,-.-.-.-.-.-.-,-.-.-.-.-.-.-.-.-.-.-.-.-.-,-.-.-.-.-.-.-.-.-.-,-,-.-.-.-.-A-.-.-,-,-.-.-.-.-.-.-.-.-W-.-,-.-.-.-.-.-.-.-,-,-,-,-.-,-,-.-.-.-.-.-.-,-,-.-.-.-.-.-.-,-X-------
------,-X-.-.-.-.-,-,-.-.-.-.-.-.-.-,-.-.-.-.-.-.-.-.-.-.-.-.-,-,-.-.-.-.-.-.-.-.-.-.-H-,-.-.-.-W-,-,-,-H-.-.-.-.-.-.-.-.-.-.-,-,-.-.-.-.-.-.-.-.-.-,-,-,-,-.-.-.-.-.-.-.-,-,-.-.-.-.-,-X---------
--------,-X-.-.-,-,-.-.-.-.-.-.-.-.-,-.-.-.-.-.-.-.-.-.-.-.-.-,-.-.-.-.-.-.-.-.-.-.-.-.-,-,-.-,-H-,-.-.-.-.-.-.-.-.-.-.-.-.-.-.-,-,-.-.-.-.-.-.-.-.-.-.-.-,-.-.-.-.-.-.-.-.-,-.-.-.-,-X-----------
----------,-X-.-,-.-.-.-.-.-.-.-.-.-,-.-.-.-.-.-.-.-.-.-.-.-,-,-H-.-.-.-.-.-.-.-.-.-.-.-.-,-,-,-.-.-.-.-.-.-.-.-.-.-.-.-.-.-.-.-.-,-.-.-.-.-.-.-.-.-.-.-.-,-.-.-.-.-.-.-.-.-,-,-.-,-X-------------
------------,-X-,-.-.-.-.-.-.-.-.-.-,-.-.-.-.-.-.-.-.-.-.-,-,-.-.-.-.-.-.-.-.-.-.-.-.-.-.-.-.-.-.-.-.-.-.-.-.-.-.-.-.-.-.-.-.-.-H-,-,-.-.-.-.-.-.-.-.-.-.-,-.-.-.-.-.-.-.-.-.-,-,-X---------------
--------------,-X-X-.-.-.-.-.-.-.-.-,-.-.-.-.-.-.-.-.-.-.-,-.-W-.-.-.-.-.-.-.-.-.-.-.-.-.-.-.-.-.-.-.-.-.-.-.-.-.-.-.-.-.-.-.-.-.-.-,-.-.-.-.-.-.-.-.-.-.-,-.-.-.-.-.-.-.-.-,-X-X-----------------
----------------,-,-X-X-.-.-.-.-.-.-,-.-.-.-.-.-.-.-.-.-,-,-.-.-.-.-.-.-.-.-.-.-.-.-.-.-.-.-.-.-.-.-.-.-.-.-.-.-.-.-.-.-.-.-.-.-.-.-,-,-.-.-.-.-.-.-.-.-.-,-.-.-.-.-.-,-X-X-X---------------------
----------------------,-X-X-X-X-.-.-,-.-.-.-.-.-.-.-W-.-,-.-W-.-.-.-.-.-.-.-.-.-.-.-.-.-.-.-.-.-.-.-.-.-.-.-.-.-.-.-.-.-.-.-.-.-.-.-.-,-,-W-.-.-.-.-.-.-.-,-.-,-X-X-X-X---------------------------
------------------------------,-X-X-,-.-.-.-.-.-.-.-.-,-,-.-.-.-.-.-.-.-.-.-.-.-.-.-.-.-.-.-.-.-.-.-.-.-.-.-.-.-.-.-.-.-.-.-.-.-.-.-W-.-,-.-.-.-.-.-.-.-.-,-X-X-----------------------------------
----------------------------------,-X-.-.-.-.-.-.-.-.-,-.-A-.-.-.-.-.-.-.-.-.-.-.-.-.-.-.-.-.-.-.-.-.-.-.-.-.-.-.-.-.-.-.-.-.-.-.-.-.-.-,-,-.-.-.-.-.-.-.-,-X-------------------------------------
----------------------------------,-X-.-.-.-.-.-.-.-,-,-.-.-.-.-.-.-.-.-.-.-.-.-.-.-.-.-.-.-.-.-.-.-.-.-.-.-.-.-.-.-.-.-.-.-.-.-.-.-.-.-A-,-.-.-.-H-.-.-.-.-X-------------------------------------
----------------------------------,-X-.-.-.-.-.-.-,-,-A-.-.-.-.-.-.-.-.-.-.-.-.-.-.-.-.-.-.-.-.-.-.-.-.-.-.-.-.-.-.-.-.-.-.-.-.-.-.-.-.-.-,-,-.-.-.-.-.-.-.-X-------------------------------------
----------------------------------,-X-.-.-.-.-.-H-,-.-.-.-.-.-.-.-.-.-.-.-.-.-.-.-.-.-.-.-.-.-.-.-.-.-.-.-.-.-.-.-.-.-.-.-.-.-.-.-.-.-.-.-W-,-.-.-.-.-.-.-.-X-------------------------------------
----------------------------------,-X-.-.-.-.-.-,-,-A-.-.-.-.-.-.-.-.-.-.-.-.-.-.-.-.-.-.-.-.-.-.-.-.-.-.-.-.-.-.-.-.-.-.-.-.-.-.-.-.-.-.-.-,-,-.-.-.-.-.-.-X-------------------------------------
----------------------------------,-X-.-.-.-.-.-,-.-.-.-.-.-.-.-.-.-.-.-.-.-.-.-.-.-.-.-.-.-.-.-.-.-.-.-.-.-.-.-.-.-.-.-.-.-.-.-.-.-.-.-.-.-.-,-.-.-.-.-.-.-X-------------------------------------
----------------------------------,-X-.-H-.-.-,-,-A-.-.-.-.-.-.-.-.-.-.-.-.-.-.-.-.-.-.-.-.-.-.-.-.-.-.-.-.-.-.-.-.-.-.-.-.-.-.-.-.-.-.-.-.-.-A-,-.-.-.-H-.-X-------------------------------------
----------------------------------,-X-.-.-.-.-,-.-.-.-.-.-.-.-.-.-.-.-.-.-.-.-.-.-.-.-.-.-.-.-.-.-.-.-.-.-.-.-.-.-.-.-.-.-.-.-.-.-.-.-.-.-.-.-.-,-.-.-.-.-.-X-------------------------------------
----------------------------------,-X-.-.-.-,-,-<-.-.-.-.-.-.-.-.-.-.-.-.-.-.-.-.-.-.-.-.-.-.-.-.-.-.-.-.-.-.-.-.-.-.-.-.-.-.-.-.-.-.-.-.-.-.-.-A-,-.-.-.-.-X-------------------------------------
--------------------------------,-,-X-,-,-,-,-.-.-.-.-.-.-.-.-.-.-.-.-.-.-.-.-.-.-.-.-.-.-.-.-.-A-.-.-.-.-.-.-.-.-.-.-.-.-.-.-.-.-.-.-.-.-.-.-.-.-,-,-,-,-,-X-,-----------------------------------
----------------------------,-,-,-X-X-,-,-,-.-.-.-.-.-.-.-.-.-.-.-.-.-.-.-.-.-.-.-.-.-.-.-.-.-.-.-.-.-.-.-.-.-.-.-.-.-.-.-.-.-.-.-.-.-.-.-.-W-<-.-A-.-.-.-W-X-X-,-,-------------------------------
----------------------,-,-,-,-X-X-.-,-.-,-,-.-.-.-.-.-.-.-.-.-.-.-.-.-.-.-.-.-.-.-.-.-.-.-.-.-.-W-.-.-.-.-.-.-.-.-.-.-.-.-.-.-.-.-.-.-.-.-.-.-.-.-.-.-.-.-.-,-.-X-X-,-,-,-------------------------
------------------,-,-,-X-X-X-.-W-.-,-,-,-.-.-.-.-.-.-.-.-.-.-.-.-.-.-.-.-.-.-.-.-.-.-.-.-.-.-H-.-H-.-.-.-.-.-.-.-.-.-.-.-.-.-.-.-.-.-.-.-.-.-.-.-.-.-.-.-.-,-.-.-.-X-X-X-,-,---------------------
--------------,-,-,-X-X-.-A-.-.-.-.-,-,-,-,-,-.-.-.-.-.-.-.-.-.-.-.-.-.-.-.-.-.-.-.-.-.-.-.-.-.-W-.-.-.-.-.-.-.-.-.-.-.-.-.-.-.-.-.-.-.-.-.-.-.-.-.-.-.-.-.-,-.-.-.-.-.-.-X-X-,-,-----------------
------------,-,-X-X-H-.-.-.-.-.-.-.-,-,-.-,-,-.-.-.-.-.-.-.-.-.-.-.-.-.-.-.-.-.-.-.-.-.-.-.-.-.-.-.-.-.-.-.-.-.-.-.-.-.-.-.-.-.-.-.-.-.-.-.-.-.-.-.-.-.-.-.-,-.-.-.-.-.-.-.-H-X-X-,---------------
----------,-,-X-,-.-.-.-.-.-.-.-.-.-,-,-,-,-.-.-.-.-.-.-.-.-.-.-.-.-.-.-.-.-.-.-.-.-.-.-.-.-.-.-A-.-.-.-.-.-.-.-.-.-.-.-.-.-.-.-.-.-.-.-.-.-.-.-.-.-.-.-.-.-,-.-.-.-.-.-.-.-,-.-.-X-,-------------
----------,-X-.-,-,-.-.-.-.-.-.-.-.-,-.-,-,-,-,-.-.-.-.-.-.-.-.-.-.-.-.-.-.-.-.-.-.-.-.-.-.-.-.-.-.-.-.-.-.-.-.-.-.-.-.-.-.-.-.-.-.-.-.-.-.-.-.-.-.-.-.-.-.-,-.-.-.-.-.-.-,-,-.-<-.-X-------------
--------,-,-X-A-.-,-.-.-.-.-.-.-.-.-,-.-,-.-,-,-.-.-.-.-.-.-.-.-.-.-.-.-.-.-.-.-.-.-.-.-.-.-.-.-.-.-.-.-.-.-.-.-.-.-.-.-.-.-.-.-.-.-.-.-.-.-.-.-.-.-.-.-.-.-,-.-.-.-.-.-,-,-.-.-.-A-X-,-----------
------,-,-X-.-.-.-,-,-.-.-.-.-.-.-.-,-.-,-,-,-.-.-.-.-.-.-.-.-.-.-.-.-.-.-.-.-.-.-.-.-.-.-.-.-.-.-.-.-.-.-.-.-.-.-.-.-.-.-.-.-.-.-.-.-.-.-.-.-.-.-.-.-.-.-.-,-.-.-.-.-.-,-.-.-.-.-.-A-X-,---------
----,-,-X-A-.-.-.-.-,-.-.-.-.-.-.-.-,-.-.-,-,-,-,-.-.-.-.-.-.-.-.-.-.-.-.-.-.-.-.-.-.-.-.-.-.-.-.-.-.-.-.-.-.-.-.-.-.-.-.-.-.-.-.-.-.-.-.-.-.-.-.-.-.-.-.-.-,-.-.-.-.-,-,-.-.-.-.-.-.-A-X-,-------
--,-,-X-.-.-.-.-.-.-,-,-.-.-.-.-.-.-,-.-.-,-.-,-,-.-.-.-.-.-.-.-.-.-.-.-.-.-.-.-.-.-.-.-.-.-.-.-.-.-.-.-.-.-.-.-.-.-.-.-.-.-.-.-.-.-.-.-.-.-.-.-.-.-.-.-.-.-,-.-.-.-.-,-.-.-.-.-.-.-.-.-.-X-,-----
--,-X-.-.-.-.-.-.-.-.-,-,-.-.-.-.-.-,-.-.-,-,-,-.-.-.-.-.-.-.-.-.-.-.-.-.-.-.-.-.-.-.-.-.-.-.-.-.-.-.-.-.-.-.-.-.-.-.-.-.-.-.-.-.-.-.-.-.-.-.-.-.-.-.-.-.-.-,-.-.-.-,-,-.-.-.-.-.-.-.-.-.-.-X-----
,-,-X-W-.-.-.-.-.-.-.-.-,-.-.-.-.-.-,-.-.-.-,-,-,-,-.-.-.-.-.-.-.-.-.-.-.-.-.-.-.-.-.-.-.-.-.-.-.-.-.-.-.-.-.-.-.-.-.-.-.-.-.-.-.-.-.-.-.-.-.-.-.-.-.-.-.-.-,-.-.-,-,-.-.-.-.-.-.-.-.-.-.-.-X-,---
,-X-<-.-.-.-.-.-.-.-.-.-,-,-.-.-.-.-,-.-.-.-,-.-,-,-.-.-A-W-.-.-.-.-.-.-.-.-.-.-.-.-.-.-.-.-.-.-.-.-.-.-.-.-.-.-.-.-.-.-.-.-.-.-.-.-.-.-.-.-.-.-.-.-.-.-.-.-,-.-.-,-.-.-.-.-.-.-.-.-.-.-.-.-,-X-,-
X-,-.-.-.-.-.-.-.-.-.-.-.-,-.-.-.-.-,-.-.-.-,-,-,-.-.-.-.-A-A-.-.-.-.-.-.-.-.-.-.-.-.-.-.-.-.-.-.-.-.-.-.-.-.-.-.-.-.-.-.-.-.-.-.-.-A-W-A-.-.-.-.-.-.-.-.-.-,-.-,-,-.-.-.-.-.-.-.-.-.-,-,-,-,-.-X-
X-,-,-,-,-.-.-.-.-.-.-.-.-,-,-.-.-.-,-A-W-,-,-,-,-,-,-,-,-,-,-,-.-.-.-.-.-.-.-.-.-.-.-.-.-.-.-.-.-.-.-.-.-.-.-.-.-.-.-.-.-.-.-.-,-,-,-A-,-,-,-,-,-.-.-W-.-A-,-,-,-.-.-.-.-.-.-,-,-,-,-,-.-.-.-.-X-
X-.-.-.-,-,-,-,-.-.-.-.-.-.-,-.-.-.-,-.-.-.-.-.-.-.-.-.-.-.-.-,-,-H-.-A-.-.-.-.-.-.-.-.-.-.-.-.-.-.-.-.-.-.-.-.-.-.-.-.-.-A-.-H-,-.-.-.-.-.-.-.-,-,-,-,-,-,-,-,-.-.-.-.-,-,-,-,-.-.-.-.-.-.-.-.-X-
X-.-.-.-.-.-.-,-,-,-,-.-.-.-,-,-.-.-,-.-.-.-.-.-.-.-.-.-.-.-.-.-,-,-,-.-.-.-.-.-.-.-.-.-.-.-.-.-.-.-.-.-.-.-.-.-.-.-.-.-.-,-,-,-.-.-.-.-.-.-.-.-.-.-.-.-.-.-,-,-.-,-,-,-,-.-.-.-.-.-.-.-.-.-.-.-X-
X-.-.-.-.-.-.-.-.-.-,-,-,-,-.-,-X-X-X-,-,-.-.-.-.-.-.-.-.-.-.-.-.-.-X-X-X-.-.-.-.-.-.-.-.-.-.-.-.-.-.-.-.-.-.-.-.-.-.-.-X-X-X-.-.-.-.-.-.-.-.-.-.-.-.-.-.-,-X-X-,-,-.-.-.-.-.-.-.-.-.-.-.-.-.-.-X-
X-.-.-.-.-.-.-.-.-.-.-.-.-,-,-X-----,-X-,-,-,-.-.-.-.-.-.-.-.-.-.-.-X-,-X-.-.-.-.-.-.-.-.-.-.-.-.-.-.-.-.-.-.-.-.-.-.-.-X-,-X-.-.-.-.-.-.-.-.-.-.-.-.-,-,-X---,-X-.-.-.-.-.-.-.-.-.-.-.-.-.-.-.-X-
X-.-.-.-.-.-.-.-.-.-.-.-.-.-,-X-,-,-,-X-.-.-,-,-.-.-.-.-.-.-.-.-.-.-X-,-X-.-.-.-.-.-.-.-.-.-.-.-.-.-.-.-.-.-.-.-.-.-.-.-X-,-X-.-.-.-.-.-.-.-.-.-.-,-,-,-,-X-,-,-X-W-,-.-.-.-.-.-.-.-.-.-.-.-.-.-X-
X-.-.-.-.-.-.-.-.-.-.-.-,-,-,-,-X-X-X-,-,-.-.-,-,-,-.-.-.-.-.-.-.-.-X-,-X-.-.-.-.-.-.-.-.-.-.-.-.-.-.-.-.-.-.-.-.-.-.-.-X-,-X-.-.-.-.-.-.-.-.-,-,-,-.-,-,-.-X-X-,-.-,-,-,-.-.-.-.-.-.-.-.-.-.-.-X-
X-.-.-.-.-.-.-.-.-.-,-,-,-.-.-,-.-.-,-.-,-.-.-.-.-,-,-,-.-.-.-.-.-.-X-,-X-W-.-.-.-.-.-.-.-.-.-.-.-.-.-.-.-.-.-.-.-.-.-W-X-,-X-.-.-.-.-.-.-,-,-,-.-.-.-,-.-.-,-.-,-.-.-.-,-,-,-.-.-.-.-.-.-.-.-.-X-
X-.-.-.-.-.-.-.-,-,-,-.-.-.-,-,-.-.-,-,-,-,-.-.-.-.-.-,-,-,-.-.-.-.-X-,-X-<-.-.-.-.-.-.-.-.-.-.-.-.-.-.-.-.-.-.-.-.-.-<-X-,-X-.-.-.-.-,-,-,-.-.-.-.-,-,-.-,-,-.-,-,-.-.-.-.-,-,-,-.-.-.-.-.-.-.-X-
X-.-.-.-.-.-,-,-,-.-.-.-.-.-,-.-.-.-.-,-.-,-,-.-.-.-.-.-.-,-,-,-.-.-X-,-X-.-.-.-.-.-.-W-.-.-.-.-.-.-.-.-.-.-W-.-.-.-.-.-X-,-X-.-.-,-,-,-.-.-.-.-.-,-,-.-.-,-.-.-.-,-.-.-.-.-.-.-,-,-,-.-.-.-.-.-X-
X-.-.-.-,-,-,-.-.-.-.-.-.-,-,-.-.-.-.-,-.-.-,-,-.-.-.-.-.-.-.-,-,-.-X-,-X-H-H-A-A-A-A-,-A-A-.-.-W-.-A-A-A-.-.-A-A-A-H-H-X-,-X-,-,-,-.-.-.-.-.-.-,-,-.-.-.-,-.-.-.-,-,-.-.-.-.-.-.-.-,-,-,-.-.-.-X-
X-H-,-,-,-.-.-.-.-.-.-.-.-,-.-.-.-.-.-,-.-.-.-,-.-.-.-.-.-.-.-.-,-,-X-,-X-X-X-X-X-X-X-X-X-X-X-X-X-X-X-X-X-X-X-X-X-X-X-X-X-,-X-,-.-.-.-.-.-.-.-,-,-.-.-.-.-,-.-.-.-.-,-,-.-.-.-.-.-.-.-.-,-,-,-.-X-
X-,-,-.-.-.-.-.-.-.-.-.-,-,-.-.-.-.-.-,-,-.-.-,-,-.-.-.-.-.-.-.-A-X-------------------------------------------------------,-X-.-W-.-.-.-.-.-.-,-.-.-.-.-,-,-.-.-.-.-.-,-.-.-.-.-.-.-.-.-.-.-,-,-X-
X-.-.-.-.-.-.-.-.-.-.-.-,-.-.-.-.-.-.-.-,-.-.-.-,-,-.-.-.-.-.-.-,-X---------------------------------------------------------,-X-.-.-.-.-.-.-,-,-.-.-.-.-,-.-.-.-.-.-.-,-,-.-.-.-.-.-.-.-.-.-.-,-X-
,-X-.-.-.-.-.-.-.-.-.-,-,-.-.-.-.-.-.-.-,-.-.-.-.-,-,-.-.-.-A-.-X-----------------------------------------------------------,-X-.-A-.-.-.-,-,-.-.-.-.-.-,-.-.-.-.-.-.-.-,-.-.-.-.-.-.-.-.-H-,-X---
--,-X-.-.-.-.-.-.-.-.-,-.-.-.-.-.-.-.-.-,-.-.-.-.-.-,-,-.-.-.-,-X-------------------------------------------------------------,-X-.-.-.-,-,-.-.-.-.-.-.-,-.-.-.-.-.-.-.-,-,-.-.-.-.-.-.-.-,-X-----
----,-X-.-.-.-.-.-.-,-,-.-.-.-.-.-.-.-.-,-,-.-.-.-.-.-,-.-.-.-X---------------------------------------------------------------,-X-.-A-.-,-.-.-.-.-.-.-,-,-.-.-.-.-.-.-.-.-,-,-.-.-.-.-.-,-X-------
------,-X-.-.-.-.-.-,-.-.-.-.-.-.-.-.-.-.-,-.-.-.-.-.-,-,-.-A-X-----------------------------------------------------------------,-X-.-,-,-.-.-.-.-.-.-,-.-.-.-.-.-.-.-.-.-.-,-.-.-.-.-,-X---------
--------,-X-.-.-.-,-,-.-.-.-.-.-.-.-.-.-.-,-.-.-.-.-.-.-,-,-X-------------------------------------------------------------------,-X-,-,-.-.-.-.-.-.-.-,-.-.-.-.-.-.-.-.-.-.-,-,-.-.-,-X-----------
----------,-X-.-.-,-.-.-.-.-.-.-.-.-.-.-.-,-.-.-.-.-.-H-,-,-X---------------------------------------------------------------------,-X-X-A-.-.-.-.-.-.-,-.-.-.-.-.-.-.-.-.-.-.-,-.-,-X-------------
------------,-X-,-,-.-.-.-.-.-.-.-.-.-.-.-,-,-.-.-.-,-,-X-X---------------------------------------------------------------------------,-X-X-.-.-.-.-,-,-.-.-.-.-.-.-.-.-.-.-.-,-,-X---------------
--------------,-X-X-X-X-.-.-.-.-.-.-.-.-.-.-,-.-W-,-X-X-----------------------------------------------------------------------------------,-X-X-H-.-,-.-.-.-.-.-.-.-.-.-,-X-X-X-X-----------------
----------------------,-X-X-X-X-X-X-X-.-.-.-,-,-X-X-------------------------------------------------------------------------------------------,-X-X-,-.-.-,-X-X-X-X-X-X-X-------------------------
------------------------------------,-X-X-X-X-X---------------------------------------------------------------------------------------------------,-X-X-X-X---------------------------------------
