--------------------------------------------X-X-X-X-X-X-X-X-X-X-X-X->->->-X-X-X-X-X-X-X-X-X-X-X-X-X-----------------------------------------------
------------------------------------X-X-X-X-------A---------------------------------------------A---X-X-X-X---------------------------------------
--------------------------------X-X---------------A---------------------------------------------A-----------X-X-X---------------------------------
----------------------------X-X-------------------A---------------------------------------------A-----------------X-------------------------------
--------------------------X-----------------------A---------------------W-----------------------A-------------------X-X---------------------------
------------------------X-------------------------A---------------------------------------------A-----------------------X-------------------------
--------------------X-X---------------------------A---------------------------------------------A-------------------------X-----------------------
------------------X-------------------------------A---------------------------------------------A---------------------------X-X-------------------
----------------X-----------------------------X-X-X-X-X-X-X-X-X-X---------------X-X-X-X-X-X-X-X-X-X-----------------------------X-----------------
--------------X-------------------------X-X-X-------------------X-------<-------X-------------------X-X-X---------------------A---X---------------
--------------X---A---------E-------X-X-------------------------X---------------X-------------------------X-X---------------A-------X-------------
------------X-------A-------------X-----------------------------X---------------X-----------------------------X-,---------A---------X-------------
----------X-----------A---------X-------------------------------X-------A-----W-X-----------------------,-,-,-,-X.,-----A-------------X-----------
--------X---------------A-----X---------------------------------X---------------X-----------------------,-X-X-X-X.,.,-A-----------------X---------
--------X-------------------X-----------------------------------X---------------X-----------------------,-X-.-.-,-,.,.,-------------------X-------
------X---------E---------X-------------------------------------X---------------X-----------------------,-X-.-.-.-,-,.,.,---E-------------X-------
----X-------------------X-------------------------------------X-X---------------X-X---------------------,-X-.-.-.-.-,-X.X.------------------X-----
----X-----------------X---------------------------------X-X-X-----------------------X-X-X---------------,-X-.-W-.-.-.-X---X-----------------X-----
----X---------------X-----------------------------X-X-X-----------------------------------X-X-X---------,-X-.-.-.-.-.-X-----X-----------------X---
--X-----------------X-----------------------X-X-X-----------------------------------------------X-X-X---,-X-X-X-X-X-X-X-----X-----------------X---
--X---------------X---------------------X-X-----------------------------H-----------------------------X-X---------------------X---------------X---
--X---------------X---------------------X-W-----------E---------------------------E-------------------W-X---------------------X---------------X---
--X---------------X-------------------X-------------------------------------------------------------------X-------------------X-----------------X-
X---------------X---------------------X---------------------,-,-,-------------,-,-,-----------------------X---------------------X---------------X-
X---------------X---------------------X---------------,-,-,-,-.-,-------------,-.-,-,-,-,-----------------X---------------------X---------------X-
X-A-A-A-A-A-A-A-X-------------------X-------------,-,-,-.-.-.-.-,-----:-------,-.-.-.-.-,-,-,---------------X-------------------X-A-A-A-A-A-A-A-X-
X---------------X-------------------X-------------,-.-.-.-.-W-.-,-------------,-.-W-.-.-.-.-,---------------X-------------------X---------------X-
X---------------X-------------------X-----------,-,-.-<-.-.-.-.-,-------------,-.-.-.-.-.-<-,-,-------------X-------------------X---------------X-
X---------------X-----------------X-------------,-.-.-.-.-.-.-.-,-------------,-.-.-.-.-.-.-.-,---------------X-----------------X---------------X-
X---------------X-----------------X-------------,-.-.-.-.-H-.-.-,-------------,-.-.-H-.-.-.-.-,---------------X-----------------X---------------X-
X---------------X-----------------X-----E-----,-,-W-.-.-.-.-.-.-,-------------,-.-.-.-.-.-.-W-,-,-----E-------X-----------------X---------------X-
X---------------X---------------X-------------,-.-.-.-.-.-.-.-B-,-------------,-.-B-.-.-.-.-.-.-,---------------X---------------X---------------X-
X---------------X-X-X-X-X-X-X-X-X-------------,-,-,-,-,-,-,-,-,-,-------------,-,-,-,-,-,-,-,-,-,---------------X-X-X-X-X-X-X-X-X---------------X-
X-----------------------------------------------------------------------------------------------------------------------------------------------X-
X-----------------------------------------------------------------------E-----------------------------------------------------------------------X-
X-----------------------------------------------------------------------------------------------------------------------------------------------X-
X-------W-----------<---A---------------H---------------------------E---E-------------------------------H---------------A---<-----------W-------X-
X-----------------------------------------------------------------------------------------------------------------------------------------------X-
X-----------------------------------------------------------------------------------------------------------------------------------------------X-
X---------------------------------------------,-,-,-,-,-,-,-,-,-,-------------,-,-,-,-,-,-,-,-,-,-----------------------------------------------X-
X---------------X-X-X-X-X-X-X-X-X-------------,-.-.-.-.-.-.-.-.-,-------------,-.-.-.-.-.-.-.-.-,---------------X-X-X-X-X-X-X-X-X---------------X-
X---------------X---------------X-------------,-,-W-.-.-.-.-.-B-,-------------,-.-B-.-.-.-W-.-,-,---------------X---------------X---------------X-
X---------------X-----------------X-----E-------,-.-.-.-.-H-.-.-,-------------,-.-.-H-.-.-.-.-,---------------X-----------------X---------------X-
X---------------X-----------------X-------------,-.-.-.-.-.-.-.-,-------------,-.-.-.-.-.-.-.-,-------E-------X-----------------X---------------X-
X---------------X-----------------X-------------,-,-.-<-.-.-.-.-,-------------,-.-.-.-.-.-<-,-,---------------X-----------------X---------------X-
X-------E-------X-------------------X-------------,-.-.-.-.-.-.-,-------------,-.-W-.-.-.-.-,---------------X-------------------X---------------X-
X---------------X-------------------X-------------,-,-,-.-.-W-.-,-------------,-.-.-.-.-,-,-,---------------X-------------------X-----E---------X-
X---------------X-------------------X-----------------,-,-,-,-.-,-------------,-.-,-,-,-,-------------------X-------------------X---------------X-
X-A-A-A-A-A-A-A-X---------------------X---------------------,-,-,-------------,-,-,-----------------------X---------------------X---------------X-
X---------------X---------------------X-------------------------------------------------------------------X---------------------X---------------X-
X-----------------X-------------------X-------------------------------------------------------------------X-------------------X---------------X---
--X---------------X---------------------X-W-----------------E-----------------------------------------W-X---------------------X---------------X---
--X---------------X---------------------X-X-----------------------------H---------E-------------------X-X---------------------X---------------X---
--X-----------------X-----------------------X-X-X-----------------------------------------------X-X-X-----------------------X-----------------X---
--X-----------------X-----------------------------X-X-X-----------------------------------X-X-X-----------------------------X---------------X-----
----X---------------,-X---------------------------------X-X-X-----------------------X-X-X---------------------------------X-----------------X-----
----X-------------,-,-,.X-------------------------------------X-X---------------X-X-------------------------------------X-------------------X-----
------X-------,-,-,-...-,.X-------------------------------------X---------------X-------------------------------------X-------------------X-------
------X-----,-,-.....-.-,-,.X-----------------------------------X---------------X-----------------------------------X-------------------X---------
--------X-,-,-...-.-.-,-,.A---X---------------------------------X---------------X---------------------------------X---A-----------------X---------
----------X-,..-.-,-,.,.A-------X-------------------------------X-W-----A-------X-------------------------------X-------A-------------X-----------
------------X-,.,-,.--A-----------X-----------------------------X---------------X-----------------------------X-----------A---------X-------------
------------X-,-,.--A-----E---------X-X-------------------------X-------<-------X-------------------------X-X---------------A-----X---------------
--------------X---A---------------------X-X-X-------------------X---------------X-------------------X-X-X---------------------A---X---------------
----------------X-----------------------------X-X-X-X-X-X-X-X-X-X---------------X-X-X-X-X-X-X-X-X-X-----------------------------X-----------------
------------------X-X---------------------------A-------------------------------------------------------------E---------------X-------------------
----------------------X-------------------------A-------------------------------------------------------------------------X-X---------------------
------------------------X-----------------------A-----------------------------------------------------------------------X-------------------------
--------------------------X-X-------------------A-----------------------W---------------------------------------------X---------------------------
------------------------------X-----------------A-----------------------------------------------------------------X-X-----------------------------
--------------------------------X-X-X-----------A-------------------------------------------------------------X-X---------------------------------
--------------------------------------X-X-X-X---A-----------------------------------------------------X-X-X-X-------------------------------------
----------------------------------------------X-X-X-X-X-X-X-X-X-X-X-X-X-X-X-X-X-X-X-X-X-X-X-X-X-X-X-X---------------------------------------------
