----------------------------------,-,-,-,-,-X-X-,-,---------------------------------------------------------------------------------------------------------------
------------------------------,-,-,-X-X-X-X-.-.-X-X-,-,-----------------------------------------------------------------------------------------------------------
----------------------------,-,-X-X-.-.-.-.-.-.-.-.-X-X-----------------------------------------------------------------------------------------------------------
--------------------------,-,-X-.-H-.-.-.-.-.-.-.-.-A-X-,---------------------------------------------------------------------------------------------------------
--------------------------,-X-.-.-.-.-.-.-.-.-.-.-.-.-.-X---------------------------------------------------------------------------------------------------------
------------------------,-,-X-.-.-.-.-.-.-.-.-.-.-.-.-.-X-,-------------------------------------------------------------------------------------------------------
----------------------,-,-X-,-,-,-.-.-.-.-.-.-.-.-.-.-.-.-X-------------------------------------------------------------------------------------------------------
--------------------,-,-X-.-.-.-,-,-,-,-.-.-.-.-.-.-.-.-.-X-,-----------------------------------------------------------------------------------------------------
--------------------,-X-.-.-.-.-.-.-.-,-,-,-.-.-.-.-.-.-.-.-X-----------------------------------------------------------------------------------------------------
--------------------,-X-.-,-,-,-.-.-.-.-.-,-.-.-.-.-.-.-.-.-X-,---------------------------------------------------------------------------------------------------
------------------,-,-X-,-,-.-,-.-.-.-.-.-,-.-,-,-,-,-.-.-.-.-X---------------------------------------------------------------------------------------------------
------------------,-X-,-.-.-.-,-,-.-.-.-.-,-.-,-.-A-,-,-.-.-.-X---------------------------------------------------------------------------------------------------
----------------,-,-X-.-.-.-.-.-,-.-.-.-.-,-.-,-,-.-.-,-.-W-,-X---------------------------------------------------------------------------------------------------
----------------,-X-.-.-.-.-.-.-,-.-.-.-.-,-.-.-,-.-.-,-,-.-X-----------------------------------------------------------------------------------------------------
--------------,-,-X-.-.-.-.-.-.-,-.-.-.-.-,-.-.-,-,-.-.-,-,-X-----------------------------------------------------------------------------------------------------
------------,-,-X-.-.-.-.-.-.-.-,-.-.-.-.-,-.-A-.-,-,-.-.-,-X-,-,-------------------------------------------------------------------------------------------------
--------,-,-,-X-.-.-.-.-.-.-.-.-,-,-.-.-.-,-.-.-.-.-,-.-,-,-.-X-,-,-----------------------------------------------------------------------------------------------
----,-,-X-X-X-.-.-.-.-.-.-.-.-.-.-,-.-.-,-X-X-X-X-.-,-,-,-.-.-.-X-X-,-,-,-----------------------------------------------------------------------------------------
--,-,-X-.-,-.-.-.-.-.-.-.-.-.-.-.-,-.-.-X-------,-X-X-X-.-.-.-.-.-.-X-X-X-,-,-,-,-,-------------------------------------------------------------------------------
--,-.-X-,-,-.-.-.-.-.-.-.-.-.-.-,-,-,-,-X-------------,-X-X-.-.-.-.-,-.-.-X-X-X-X-X-,-,-,-,-,-,-,-,-,-,-,-,-------------------------------------------------------
,-,-X-H-,-.-.-.-.-.-.-,-,-,-,-,-,-.-,-X-,-----------------,-X-.-.-,-,-.-.-.-.-,-.-.-X-X-X-X-X-X-X-X-X-X-X-X-,-,---------------------------------------------------
,-.-X-.-,-.-.-.-,-,-,-,-.-.-X-,-.-.-.-.-X-,-----------------,-X-X-,-.-.-.-.-,-,-.-.-.-.-,-.-.-,-.-.-.-.-,-,-X-,-,-------------------------------------------------
,-X-.-.-,-.-.-.-,-.-.-.-.-.-.-X-.-.-.-.-.-X-,-------------------,-X-X-X-.-.-,-.-.-.-.-.-,-.-.-,-.-.-.-.-,-.-.-X-X-,-----------------------------------------------
,-X-.-.-,-.-.-.-,-.-.-.-.-.-.-X-X-X-.-.-<-.-X-,-----------------------,-X-X-X-X-X-X-.-,-,-,-,-,-.-.-.-,-,-.-.-.-,-X-----------------------------------------------
,-X-.-,-,-.-.-.-,-,-.-.-.-.-.-A-X-,-X-.-.-W-,-X-------,-,-,-,-,-,-,-,-,-,-,-----,-,-X-X-X-.-.-X-X-X-X-X-.-.-,-,-,-X-----------------------------------------------
.-X-.-,-.-.-.-.-.-,-.-.-.-.-.-.-X---,-X-,-,-,-X-,-----,-X-X-X-X-X-X-X-X-X-X-------------X-,-,-,-X-,---,-X-,-,-.-.-X-----------------------------------------------
X-.-.-,-.-.-.-.-.-,-.-.-.-.-.-.-X-----,-X-.-.-.-X-,-,-,-X-.-.-.-.-.-.-.-,-X-,-,-,-,-,-,-,-X-.-.-.-X-----,-X-.-.-.-X-----------------------------------------------
X-.-.-,-,-.-.-.-.-,-.-.-.-.-.-.-X-,-----X-.-.-,-X-X-X-X-X-.-.-.-.-.-.-.-,-X-X-X-X-X-X-X-X-X-,-.-A-,-X---,-X-.-.-.-X-----------------------------------------------
X-.-.-.-,-,-.-.-,-,-.-.-.-.-.-.-X-,-,---,-X-.-,-.-,-.-.-,-.-.-.-.-.-.-.-A-.-.-.-,-H-,-.-H-.-,-.-,-,-X-----,-X-,-,-X-----------------------------------------------
X-.-.-.-.-,-.-,-,-.-.-.-.-.-.-.-.-X-X-,---X-,-,-.-,-.-.-,-.-.-.-.-.-.-.-,-X-X-X-X-X-X-X-X-X-X-X-X-X-------,-X-,-.-X-----------------------------------------------
,-X-.-.-.-,-,-,-.-.-.-.-.-.-.-.-.-.-.-X---,-X-X-.-,-,-,-,-.-.-.-.-.-.-.-,-X-X-X-X-X-X-X-X-,---------------,-X-.-.-X-----------------------------------------------
,-X-.-.-.-.-,-,-.-.-.-.-.-.-.-.-.-.-.-,-X-----,-X-X-X-.-.-.-.-.-.-.-.-.-,-.-,-.-.-,-.-.-,-X-,-------------,-X-.-.-X-----------------------------------------------
,-X-.-.-.-.-.-.-.-.-.-.-.-.-.-.-.-.-W-<-X---------,-X-.-.-.-.-A-W-.-.-.-,-.-,-.-.-,-.-.-,-.-X-,-----------,-X-.-.-X---------------------------------,-,-,-,-,-,-,-
--,-X-.-.-.-.-.-.-.-.-.-.-.-.-.-.-.-.-.-X-------,-,-X-.-.-.-.-.-.-.-.-.-,-.-,-.-.-,-.-.-,-.-.-X-,---------,-X-.-.-X-----------------------------,-,-,-X-X-X-X-X-X-
--,-X-.-.-.-.-.-.-.-.-.-.-.-.-.-.-.-.-.-X-,-,-,-X-X-X-,-.-.-.-.-.-.-.-.-,-.-,-.-.-,-.-.-,-.-.-.-X-,-------,-X-.-.-X-----------,-,-,-,-,-,-,-,-,-,-X-X-.-.-.-.-.-X-
--,-X-.-.-.-.-.-.-.-.-.-.-.-.-.-.-.-.-,-X-,-X-X-,-.-,-,-,-.-.-.-.-.-.-.-,-X-X-X-X-X-X-X-X-.-.-.-.-X-,-----,-X-.-.-X---------,-,-X-X-X-X-X-X-X-X-X-.-.-.-.-.-.-H-X-
----,-X-.-.-.-.-.-.-.-.-.-.-.-.-.-.-,-X-,-X-,-.-,-,-,-,-,-,-.-.-.-.-.-.-.-X-------------,-X-.-.-A-.-X-,---,-X-.-.-X-----,-,-,-X-.-.-.-.-.-.-.-.-.-.-.-.-.-<-.-<-X-
----,-X-.-.-.-.-.-.-.-.-.-.-.-.-.-.-X-,-,-X-,-,-.-,-,-X-X-X-.-.-.-.-.-.-.-X---------------,-X-.-.-.-.-X-,---,-X-.-X---,-,-X-X-.-.-.-.-.-.-A-.-.-.-.-.-.-X-X-X-X-X-
----,-X-.-.-.-.-.-.-.-.-.-.-.-.-.-X-,-,-X-,-,-,-,-,-X---,-X-.-A-.-.-.-.-.-X-----------------,-X-.-.-.-.-X-,-,-X-.-X-,-,-X-.-.-.-.-.-.-.-.-.-.-.-.-.-.-.-X---------
------,-X-.-.-.-.-.-.-.-.-.-.-,-,-X-,-X-.-.-,-,-X-X-----,-X-X-X-X-X-X-X-X-X-------------------,-X-.-<-.-.-X-,-X-.-,-X-X-.-.-.-.-.-.-.-.-.-.-.-.-.-.-.-.-X---------
------,-X-.-.-.-.-.-.-.-.-.-.-X-X-,-,-X-.-.-.-X-------------------------------------------------,-X-.-.-A-.-X.,.....X..-.-.-.-.-.-,-,-,-,-.-.-,-,-,-,-.-X---------
------,-X-.-.-.-.-.-.-.-.-.-,-X---,-X-,-,-,-X-,---------------------------------------------------,-X-.-.-.-.-,.+N+N.-.-.-.-,-,-,-,-.-.-,-.-.-,-.-.-,-.-X---------
--------,-X-.-.-.-.-.-.-.-.-X---,-,-X-.-.-.-X-----------------------,-,-,---------------------------,-X-.-.-.-.-,-,-.-.-.-,-,-.-.-,-.-.-,-.-.-,-.-.-,-.-X---------
--------,-X-.-.-.-.-.-.-.-.-X---,-X-.-A-.-,-X-------------------,-,-,-X-X-,-,-------------------------,-X-.-.-.-.-,-.-.-,-,-.-.-.-,-,-,-,-.-.-,-,-,-,-.-X---------
--------,-X-.-.-.-.-.-.-.-.-X---,-X-.-.-.-X-----------------,-,-,-X-X-.-.-X-X-,-------------------------,-X-.-.-.-,-.-.-,-.-.-.-.-,-.-.-.-.-.-.-.-.-.-.-X---------
----------,-X-.-.-.-.-.-.-,-X-,-,-X-A-.-,-X-,-,-,-,-,---,-,-,-X-X-.-.-.-.-.-.-X-,-,-----------------------,-X-.-.-,-.-.-,-,-,-,-,-,-.-.-,-,-,-,-.-.-.-.-X---------
----------,-X-.-.-.-.-.-.-X---,-X-.-.-.-X-,-X-X-X-X-,-,-,-X-X-.-.-.-.-.-.-.-.-.-X-X-,-----------------------,-X-,-,-.-.-.-.-.-.-,-,-.-.-,-.-.-,-.-.-.-.-X---------
----------,-X-.-.-.-.-.-.-X-,-,-X-.-.-,-X-X-.-H-.-,-X-X-X-.-.-.-.-.-.-.-.-.-.-.-.-.-X-----------------------,-X-.-.-.-.-.-.-.-.-,-,-.-.-,-.-<-,-.-.-.-.-X---------
------------,-X-.-.-.-.-.-.-X-X-.-.-.-,-.-.-.-.-,-,-.-.-.-.-.-.-.-.-.-.-.-.-.-.-.-.-X-----------------------,-X-,-,-.-.-.-.-W-<-,-,-.-.-,-,-,-,-.-.-.-.-X---------
------------,-X-.-.-.-.-.-.-,-X-.-.-.-,-,-.-.-,-,-.-.-.-.-.-.-.-.-.-.-.-.-.-.-.-.-.-X---------------------,-,-X-.-,-.-.-,-,-,-,-,-,-,-,-,-.-.-,-,-,-,-.-X---------
--------------,-X-.-.-.-.-.-,-,-.-.-.-.-,-.-,-,-.-.-.-.-.-.-.-.-.-.-.-.-.-.-.-.-.-.-X-,-----------------,-,-X-.-.-,-.-.-,-.-.-.-.-,-.-.-,-.-.-,-.-.-,-.-X---------
--------------,-X-.-.-.-.-.-.-,-.-.-.-,-,-,-,-.-.-.-.-.-.-.-.-.-.-.-.-.-.-.-.-.-.-.-.-X---------------,-,-X-.-.-.-,-.-.-,-.-.-.-.-,-.-.-,-.-.-,-.-.-,-.-X---------
--------------,-X-.-.-.-.-.-.-,-,-,-,-,-,-,-.-.-.-.-.-.-.-.-.-.-.-.-.-.-.-.-,-,-,-.-.-X-------------,-,-X-.-.-.-,-,-.-.-,-,-.-.-.-,-,-,-,-.-.-,-,-,-,-.-X---------
----------------,-X-H-.-.-.-.-.-.-.-.-,-,-.-.-.-.-.-.-.-.-.-.-.-.-.-.-,-,-,-,---,-,-.-X-------------,-X-.-.-.-,-,-.-.-.-.-,-,-.-.-,-.-.-.-.-.-.-.-.-.-.-X---------
----------------,-X-.-.-.-.-.-.-.-,-,-,-.-.-.-.-.-.-.-.-.-.-.-.-.-,-,-,-----------,-,-X-----------,-,-X-.-.-,-,/+O+O.-.-.-.-,-,-,-,-.-.-.-.-.-.-.-.-.-.-X---------
------------------,-X-.-.-.-.-.-,-,-.-.-.-.-.-.-.-.-W-.-.-.-.-,-,-,-,-,-,-,-,-----H-,-X---------,-,-X-.-.-.-,/+O+O+O.-.-.-.-.-.-.-.-.-.-.-.-.-.-.-.-.-.-X---------
------------------,-X-.-.-.-.-,-,-.-.-.-.-.-.-.-.-.-.-.-.-.-,-,-.-,-,-.-,-,-,-,-W---X---------,-,-X-.-.-.-,-X/././,/X/.-.-.-.-.-.-.-.-.-.-.-.-.-.-.-.-.-X---------
--------------------,-X-.-.-,-,-.-.-.-.-,-,-.-.-.-.-.-.-.-.-,-,-,-,-.-.-,-.-,-,-,-X---------,-,-X-.-.-.-,-X-,-X-.-X-,-X-X-.-.-.-.-.-.-.-.-.-.-.-.-.-.-.-X-,-,-,-,-
----------------------,-X-.-,-.-.-.-.-,-,-,-,-.-.-.-.-.-.-.-.-.-,-,-.-,-,-.-,-,-X-,-----,-,-,-X-.-.-.-,-X---,-X-H-X-,---,-X-.-.-.-.-.-.-.-.-.-.-.-.-.-.-X-X-X-X-X-
------------------------X-.-,-.-.-.-,-,-.-.-,-,-.-.-.-.-.-.-.-,-,-,-,-,-.-,-,-,-,-X-,-,-,-X-X-,-.-.-,-X-----,-X-<-,-X-----,-X-X-.-.-.-.-.-.-.-.-.-.-.-.-.-<-.-.-X-
------------------------,-X-,-.-.-.-,-.-.-<-.-,-.-.-.-.-.-.-.-,-------,-,-,-,-,-,-X-,-X-X-.-.-,-.-,-X-------,-X-.-.-X---------,-X-X-X-X-X-X-X-X-X-X-.-.-.-.-.-,-X-
--------------------------,-X-,-.-.-,-.-.-.-.-,-,-.-.-.-.-.-,-,-----------,-X-X-,-,-X0,-.-.-.-,-,-X---------,-X-.-.-X---------------------------,-X-.-.-.-.-,-X---
----------------------------,-X-.-.-,-.-.-W-A-.-,-.-.-.-.-,-,---------------X-,-X0+P,0,-.-.-.-,-X---------,-,-X-,-.-X---------------------------,-X-.-.-.-H-X-----
----------------------------,-X-.-.-,-,-.-.-.-,-,-.-.-.-.-,-----------------X-,-,-XP.-.-,-,-,-X-----------,-,-X-,-,-X---------------------------,-X-.-.-,-X-------
------------------------------,-X-.-.-,-,-,-,-,-.-.-.-.-,-,---------------X-,-,-X-.-.-,-,-.-X-,-,-------,-,-X-,-.-.-X---------------------------,-X-A-,-X---------
--------------------------------,-X-.-.-.-,-,-.-.-.-.-,-,-------------A---X-,-X-.-.-.-,-.-.-.-X-X-,-,-,-,-X-.-,-,-X-,---------------------------,-X-X-X-----------
--------------------------------,-X-.-.-.-.-.-.-.-.-.-,-------------------X-X-.-.-.-.-,-X-.-.-,-,-X-X-X-X-.-.-.-,-X-----------------------------------------------
----------------------------------,-X-.-.-.-.-.-.-.-,-,---------X-X-X-X-X-X-X-.-.-.-X-X-,-X-.-,-.-.-.-.-,-.-.-.-,-X-----------------------------------------------
------------------------------------,-X-.-.-.-.-.-.-,-----------X-----,-,-X-.-.-.-,-X-----,-X-,-.-.-.-.-,-,-,-X-X-------------------------------------------------
--------------------------------------,-X-.-.-.-.-,-,-----------X---,-,-X-.-.-.-.-X-,-,-,-,-,-X-X-X-.-.-,-X-X-----------------------------------------------------
--------------------------------------,-X-.-.-.-.-,-------------X---,-X-.-.-.-.-.-X-X-X-X-X-----,-,-X-X-X---------------------------------------------------------
----------------------------------------,-X-.-.-.-,-------------X---,-X-.-.-.-.-.-.-.-W-.-X-----------------------------------------------------------------------
------------------------------------------,-X-.-.-,-----------,-X-,-,-X-A-.-.-.-.-.-.-.-.-X-----------------------------------------------------------------------
--------------------------------------------,-X-.-,-----------,-X-X-X-X-.-.-.-.-.-.-.-.-.-X-----------------------------------------------------------------------
--------------------------------------------,-X-.-,-----------,-.-.-.-,-.-.-.-.-.-.-.-.-.-X-----------------------------------------------------------------------
----------------------------------------------,-X-,-----------,-.-.-.-,-.-.-.-.-.-.-.-.-.-X-----------------------------------------------------------------------
------------------------------------------------,-X-----------,-.-.-.-,-.-.-.-.-.-.-.-.-W-X-----------------------------------------------------------------------
----------------------------------------------------X---------,-X-X-X-X-.-.-.-.-.-.-.-.-.-X-----------------------------------------------------------------------
------------------------------------------------------X---------X---,-X-.-.-.-.-.-.-.-.-.-X-----------------------------------------------------------------------
--------------------------------------------------------X-H---X-X---,-X-.-.-.-.-.-.-.-.-.-X-----------------------------------------------------------------------
----------------------------------------------------------X-X-------,-X-A-.-.-.-.-.-.-.-.-X-----------------------------------------------------------------------
--------------------------------------------------------------------,-X-X-X-X-X-X-X-X-.-.-X-----------------------------------------------------------------------
----------------------------------------------------------------------------------,-X-.-.-X-----------------------------------------------------------------------
----------------------------------------------------------------------------------,-X-.-.-X-----------------------------------------------------------------------
----------------------------------------------------------------------------------,->->->->-----------------------------------------------------------------------
