--------------------------------------------------------------------------------,-X-,-,---------------------------------------------------------------------------------------------------------------------------------------------
--------------------------------------------------------------------------------,-X-X-X-,-,-----------------------------------------------------------------------------------------------------------------------------------------
--------------------------------------------------------------------------------,-X-.-.-X-X-,---------------------------------------------------------------------------------------------------------------------------------------
------------------------------------------------------------------------------,-,-X-.-.-.-,-X---------------------------------------------------------------------------------------------------------------------------------------
------------------------------------------------------------------------------,-X-.-.-.-.-X-----------------------------------------------------------------------------------------------------------------------------------------
------------------------------------------------------------------------------,-X-.-.-.-,-X-----------------------------------------------------------------------------------------------------------------------------------------
------------------------------------------------------------------------------,-X-.-.-.-X-------------------------------------------------------------------------------------------------------------------------------------------
------------------------------------------------------------------------------,-X-.-.-,-X-------------------------------------------------------------------------------------------------------------------------------------------
------------------------------------------------------------------------------,-X-.-.-X---------------------------------------------------------------------------------------------------------------------------------------------
------------------------------------------------------------,-,-,-,---------,-,-X-.-.-X---------------------------------------------------------------------------------------------------------------------------------------------
------------------------------------------------------------,-X-X-X---------,-X-.-.-.-X---------------------------------------------------------------------------------------------------------------------------------------------
------------------------------------------------------------,-X-.-X---------,-X-.-.-.-X---------------------------------------------------------------------------------------------------------------------------------------------
------------------------------------------------------------,-X-.-X---------,-X-.-.-.-X---------------------------------------------------------------------------------------------------------------------------------------------
------------------------------------------------------------,-X-.-X---------,-X-.-.-.-X---------------------------------------------------------------------------------------------------------------------------------------------
------------------------------------------------------------,-X-.-X---------,-X-.-.-.-X---------------------------------------------------------------------------------------------------------------------------------------------
------------------------------------------------------------,-X-.-X---------,-X-.-.-.-X---------------------------------------------------------------------------------------------------------------------------------------------
------------------------------------------------------------,-X-.-X---------,-X-.-.-.-X---------------------------------------------------------------------------------------------------------------------------------------------
------------------------------------------------------------,-X-.-X---------,-X-.-.-.-X---------------------------------------------------------------------------------------------------------------------------------------------
------------------------------------------------------------,-X-.-X---------,-X-.-.-.-X---------------------------------------------------------------------------------------------------------------------------------------------
------------------------------------------------------------,-X-.-X---------,-X-.-.-.-X---------------------------------------------------------------------------------------------------------------------------------------------
------------------------------------------------------------,-X-.-X---------,-X-.-.-.-X---------------------------------------------------------------------------------------------------------------------------------------------
------------------------------------------------------------,-X-.-X---------,-X-.-.-.-X---------------------------------------------------------------------------------------------------------------------------------------------
------------------------------------------------------------,-X-.-X---------,-X-.-.-.-X-----------------,-,-,-,-,-,-,-,-,-,-,-------------------------------------------------------------------------------------------------------
------------------------------------------------------------,-X-.-X---------,-X-.-.-.-X-----------------,-X-X-X-X-X-X-X-X-X-X-------------------------------------------------------------------------------------------------------
------------------------------------------------------------,-X-.-X---------,-X-.-.-.-X-----------------,-X-.-.-.-.-.-.-.-.-X-------------------------------------------------------------------------------------------------------
------------------------------------------------------------,-X-.-X---------,-X-.-.-.-X---------------,-,-X-.-.-.-.-.-.-.-.-X-------------------------------------------------------------------------------------------------------
----------------------------------------------------------,-,-X-.-X---------,-X-.-.-.-X---------------,-X-.-.-.-.-.-.-.-.-.-X-------------------------------------------------------------------------------------------------------
--------------------------------------------------------,-,-X-X-.-X---------,-X-.-.-.-X---------------,-X-.-.-.-.-.-.-.-.-.-X-------------------------------------------------------------------------------------------------------
------------------------------------------------------,-,-X-X-X-.-X---------,-X-.-.-,-X---------------,-X-.-.-.-.-.-.-.-.-.-X-------------------------------------------------------------------------------------------------------
----------------------------------------------------,-,-X-.-X-X-.-X---------,-X-.-.-X---------------,-,-X-.-.-.-.-.-.-.-.-.-X-------------------------------------------------------------------------------------------------------
--------------------------------------------------,-,-X-.-.-X-X-.-X---------,-X-.-.-X---------------,-X-.-.-.-.-.-.-.-.-.-.-X-------------------------------------------------------------------------------------------------------
------------------------------------------------,-,-X-.-.-.-X-X-.-X---------,-X-.-,-X---------------,-X-.-.-.-.-.-.-.-.-.-.-X-------------------------------------------------------------------------------------------------------
----------------------------------------------,-,-X-.-.-.-.-X-X-.-X---------,-X-.-X-,-,-,---------,-,-X-.-.-.-.-.-.-.-.-.-.-X-------------------------------------------------------------------------------------------------------
--------------------------------------------,-,-X-.-.-.-.-.-X-X-.-X---------,-X-.-X-,-X-,-,-,-----,-X-.-.-.-.-.-.-.-.-.-.-,-X-------------------------------------------------------------------------------------------------------
------------------------------------------,-,-X-.-.-.-.-.-.-X-X-.-X---------,-X-.-.-X-,-X-X-,-,-,-,-X-.-.-.-.-.-.-.-.-.-.-X---------------------------------------------------------------------------------------------------------
----------------------------------------,-,-X-.-.-.-.-.-.-,-X-X-.-X-,-----,-,-X-.-.-.-.-.-,-X-X-,-X-.-.-.-.-.-.-.-.-.-.-,-X---------------------------------------------------------------------------------------------------------
--------------------------------------,-,-X-.-.-.-.-.-,-X-X-X-.-.-X-X-,-,-,-X-X-.-.-.-.-.-.-.-X-X-X-.-.-.-.-.-.-.-.-.-.-X-----------------------------------------------------------------------------------------------------------
------------------------------------,-,-X-.-.-.-.-.-.-X-,-X-.-.-.-.-.-X-X-X-.-.-.-.-.-.-.-.-.-.-.-.-.-.-X-X-X-X-X-X-X-X-X-----------------------------------------------------------------------------------------------------------
----------------------------------,-,-X-.-.-.-.-.-,-,-,-X-.-.-.-.-.-.-.-.-.-.-.-.-.-.-.-.-.-.-.-.-.-.-.-X-,-,-,-,-,-,-,-,-,-,-,-,-,-,-,-,-,-,-,-,-,-,-------------------------------------------------------------------------------
--------------------------------,-,-X-.-.-.-.-.-,-,-.-.-.-.-.-.-.-.-.-.-.-.-.-.-.-.-.-.-.-.-.-.-.-.-.-.-X-,-X-X-X-X-X-X-X-X-X-,-X-X-X-,-X-X-X-,-X-X-X-,-----------------------------------------------------------------------------
------------------------------,-,-X-.-.-.-.-.-,-,-X-.-.-.-.-.-.-.-.-.-.-.-.-.-.-.-.-.-.-.-.-.-.-.-.-.-.-X-,-X-<-.-.-.-.-.-.-X-X-X-.-X-X-X-.-X-X-X-.-.-X-,---------------------------------------------------------------------------
----------------------------,-,-X-.-.-.-.-.-.-,-X-.-.-.-.-.-.-.-.-.-.-.-.-.-.-.-.-.-.-.-.-.-.-.-.-.-.-.-X-X-.-.-.-.-.-.-.-.-.-.-.-.-.-.-.-.-.-.-.-.-<-.-X---------------------------------------------------------------------------
,-,-,-,-,-,-,-,-,-,-,-,-,-,-,-X-X-X-X-X-X-X-X-X-X-.-.-.-.-.-.-.-.-.-.-.-.-.-.-.-.-.-.-.-.-.-.-.-.-.-.-.-X-X-.-.-.-.-.-.-.-.-.-.-.-.-.-.-.-.-.-.-.-.-.-.-X---------------------------------------------------------------------------
X-X-X-X-X-X-X-X-X-X-X-X-X-X-X-X-X-X-X-X-X-X-X-X-.-.-.-.-.-.-.-.-.-.-.-.-.-.-.-.-.-.-,-,-,-,-,-,-,-,-,-,-X-,-,-,-,-,-.-.-.-.-.-.-.-.-.-.-.-.-.-.-.-.-.-.-X---------------------------------------------------------------------------
X-.-.-.-.-.-.-.-.-.-.-.-.-.-.-.-.-.-.-.-.-.-.-.-.-.-.-.-.-.-.-.-.-.-.-.-.-.-.-.-.-,-,-.-.-.-.-.-.-.-.-.-X-.-.-,-,-,-,-.-.-.-.-.-.-.-.-.-.-.-.-.-.-.-.-.-X---------------------------------------------------------------------------
X-.-.-.-.-.-.-.-.-.-.-.-.-.-.-.-.-.-.-.-.-.-.-.-.-.-.-.-.-.-.-.-.-.-.-.-.-.-.-.-,-,-.-.-.-.-.-.-.-.-.-.-.-.-,-,-,-,-,-.-.-.-.-.-.-.-.-.-.-.-.-.-.-.-.-.-X---------------------------------------------------------------------------
X-.-.-.-.-.-.-.-.-.-.-.-.-.-.-.-.-.-.-.-.-.-.-.-.-.-.-.-.-.-.-.-.-.-.-.-.-.-,-,-,-.-.-.-.-.-.-.-.-.-.-.-.-.-,-,-,-,-,-.-.-.-.-.-.-.-.-.-.-.-.-.-.-.-.-.-X-------------------------------------,-,-,-,-,-,---------------------------
X-X-X-X-X-X-X-X-X-X-X-X-X-X-X-X-X-X-X-X-.-.-.-.-.-.-.-.-.-.-.-.-.-.-,-,-,-,-,-.-.-.-.-.-.-.-.-.-.-.-.-.-.-,-,-,-,-X-X-X-X-.-.-.-.-.-.-.-.-.-.-.-.-.-,-,-X-------------------------------------,-X-X-X-X-X---------------------------
------------------------------------,-X-.-.-.-.-.-.-.-.-.-.-.-.-.-.-,-.-.-.-.-.-.-.-.-.-.-.-.-.-.-.-.-.-.-,-,-,-X-----,-,-X-.-.-.-.-.-.-.-.-.-.-,-,-,-,-X-------------------------------------,-X-.-.-.-X---------------------------
------------------------------------,-X-.-.-.-.-.-.-.-.-.-.-.-.-.-,-,-.-.-.-.-.-.-.-.-.-.-.-.-.-.-.-.-.-X-X-,-,-X-------,-X-.-.-.-X-X/X/X/X-.-.-,-,-,-.-X-------------------------------------,-X-.-.-.-X---------------------------
------------------------------,-,-,-,-X-.-.-.-.-.-.-.-.-.-.-.-.-,-,-.-.-.-.-.-.-.-.-.-.-.-.-.-.-.-.-.-.-X-X-,-,-X-,-,-,-,-X-.-.-.-X-,-,-,-X-.-.-,-.-,-,-X-,-,-----------------,-,-,-,-,-,-,-,-,-X-.-.-.-X-,-------------------------
------------------------------,-X-X-X-X-.-.-.-.-.-.-.-.-.-.-.-.-,-.-.-.-.-.-.-.-.-.-.-.-.-.-.-.-.-.-,-,-X-X-,-,-X-X-X-X-X-X-,-,-,-X-X-X-X-X-,-,-,-,-,-,-X-X-X-,-,-----------,-,-X-X-X-X-X-X-X-X-X-.-.-.-X-X-------------------------
------------------------------,-X-.-.-.-.-.-.-.-.-.-.-.-.-.-.-,-,-.-.-.-.-.-.-.-.-.-.-.-.-.-.-.-.-,-.-,-.-.-.-.-.-.-,-,-,-.-.-.-.-.-.-.-.-.-.-.-.-,-,-,-.-.-X-,-X3,---------,-X-.-.-.-.-.-.-.-.-.-.-.-.-.-X-------------------------
------------------------------,-X-.-.-.-.-.-.-.-.-.-.-.-.-.-,-,-.-.-.-.-,-,-,-,-,-,-,-,-,-.-.-.-.-,-,-.-.-.-.-.-.-.-,-,-,-.-.-.-.-.-.-.-.-.-.-.-.-.-.-.-.-.-X-X-W-X3------,-,-X-.-.-.-.-.-.-.-.-.-.-.-.-.-X-------------------------
----------------,-,-,-,-,-,-,-,-X-.-.-.-.-.-.-.-.-.-.-.-.-.-,-.-.-.-.-.-,-.-.-.-,-.-,-.-,-,-,-.-.-.-.-.-.-.-.-.-.-.-,-,-,-.-.-.-.-.-.-.-.-.-.-.-.-.-.-.-.-.-.-.-X-,-,---,-,-X-.-.-.-.-.-.-.-.-.-.-.-.-.-.-X---,-,-,-,-,-,-----------
----------------,-X-X-X-X-X-X-X-X-,-,-,-,-.-.-.-.-.-.-.-.-,-,-.-.-.-.-,-,-,-,-,-,-.-,-,-,-.-,-,-.-.-.-.-.-.-.-.-.-.-,-,-X-X-.-.-.-.-.-.-.-.-.-.-.-.-.-.-.-.-.-.-X-X-X-,-,-X-.-.-.-.-.-.-.-.-.-.-.-.-.-.-.-X-,-,-X-X-X-X-X-----------
--------------,-,-X-.-.-.-.-.-X-X-.-.-.-,-,-.-.-.-.-.-.-,-,-.-.-.-.-,-,-.-,-.-,-,-,-,-.-,-,-,-,-X-.-.-.-.-.-.-.-.-.-.-.-X-X-.-.-.-.-.-.-.-.-.-.-.-.-.-.-.-.-.-.-.-.-X.,-X-.-.-.-.-.-.-.-.-.-.-.-.-.-.-.-.-X-X-X-X-,-.-.-X-----------
--------------,-X-X-.-.-.-.-.-X-X-.-.-.-.-,-.-.-.-.-.-.-,-.-.-.-.-.-,-.-,-,-.-.-.-.-.-.-.-.-,-,-X-.-.-.-.-.-.-.-.-.-.-.-X-X-.-.-.-.-.-.-.-.-.-.-.-.-.-.-.-.-.-.-.-.-X.,-X-.-.-.-.-.-.-.-.-.-.-.-.-.-.-.-.-.-.-.-,-,-,-,-X-----------
--------------,-X-.-.-.-.-.-.-X-X-.-.-.-.-,-.-.-.-.-.-,-,-.-.-.-.-,-,-,-,-.-.-.-.-.-.-.-.-<-,-X-X-.-.-.-.-.-.-.-.-.-.-.-X-X-.-.-.-.-.-.-.-.-.-.-.-.-.-.-.-.-.-.-.-.-X.X-.-.-.-.-.-.-.-.-.-.-.-.-.-.-.-.-.-.-.-.-.-,-,-X-X-,-,-------
--------------,-X-.-.-.-.-.-.-.-.-.-.-.-.-,-.-.-.-.-.-,-.-.-.-.-.-,-.-,-.-.-.-.-.-.-.-.-.-,-,-X-X-.-.-.-.-.-.-.-.-.-.-.-X-X-W-.-.-.-.-.-.-.-.-.-.-.-.-.-.-.-.-.-.-.-.-,-.-.-.-.-.-.-.-.-.-.-.-.-.-.-.-.-.-.-.-.-.-.-,-X-X-X-X-------
--------------,-X-.-.-.-.-.-.-X-X-.-.-.-.-,-.-.-.-.-.-,-.-.-.-.-,-,-,-,-.-.-.-.-.-.-.-.-.-,-,-,-,-.-.-.-.-.-.-.-.-.-.-.-.-X-X-X-X-X-.-.-X-X-X-X-X-,-,-.-.-.-.-.-.-.-.-:-.-.-.-.-.-.-.-.-.-.-.-.-.-.-.-.-.-.-.-.-.-.-.-.-.-.-X-------
--------------,-X-.-.-.-.-.-.-X-X-.-.-.-.-,-.-.-.-.-.-,-.-.-.-.-,-.-,-.-.-.-.-.-.-.-.-.-.-,-,-,-,-.-.-.-.-.-.-.-.-.-.-.-.-.-X-X-X-X-,-,-X-X-X-X-X-<-,-.-.-.-.-.-.-.-.-,-.-.-.-.-.-.-.-.-.-.-.-.-.-.-.-.-.-.-.-.-.-.-.-.-.-.-X-------
----------------,-X-.-.-,-,-,-X-X-.-.-.-.-,-.-.-.-.-.-,-.-.-.-.-,-.-,-.-.-.-.-.-.-.-.-.-.-,-,-,-,-.-.-.-.-.-.-.-.-.-.-.-.-.-.-.-.-.-.-.-.-.-.-.-.-.-,-.-.-.-.-.-.-.-.-,-.-.-.-.-.-.-.-.-.-.-.-.-.-.-.-.-.-X-X-X-X-X-X-X-X-X-X-------
----------------,-X->->->-X-X-X-X-.-.-.-.-,-.-.-.-.-.-,-.-.-.-.-,-.-,-.-<-.-.-.-.-.-.-.-.-.-X-X-X-.-.-.-.-.-.-.-.-.-.-.-.-.-.-.-.-.-.-.-.-.-.-.-.-.-X-X-.-.-.-.-.-.-.-,-.-.-.-.-.-.-.-.-.-.-.-.-.-.-.-.-.-X-------------------------
------------------,-X-.-X-X-X-,-X-.-.-.-.-,-.-.-.-.-.-,-.-.-.-.-,-.-,-.-.-.-.-.-.-.-.-.-.-.-X-,-X-.-.-.-.-.-.-.-.-.-.-.-.-.-.-.-.-.-.-.-.-.-.-.-.-.-X-X-.-.-.-.-.-.-.-,-.-.-.-.-.-.-.-.-.-.-.-.-.-.-.-.-,-X-------------------------
------------------,-X-.-X-X-X-,-X-.-.-.-.-,-.-.-.-.-.-,-.-.-.-.-,-.-,-.-<-.-.-.-.-.-.-.-.-.-X-,-X-.-.-.-.-.-.-.-.-.-.-.-.-.-.-.-.-.-.-.-.-.-.-.-.-.-X-X-.-.-.-.-.-.-.-,-.-.-.-.-.-.-.-.-.-.-.-.-.-.-.-,-X---------------------------
------------------,-X-X-X-X-X-,-X-.-.-.-.-,-.-.-.-.-.-,-.-.-.-.-,-.-,-.-.-.-.-.-.-.-.-.-.-.-X-,-X-.-.-.-.-.-.-.-.-.-.-.-.-.-.-.-.-.-.-.-.-.-.-.-.-.-X-X-.-.-.-.-.-.-.-,-.-.-.-.-.-.-.-.-.-.-.-.-.-.-.-X-----------------------------
------------------------,-X-X---,-X-.-.-,-,-.-.-.-.-.-,-.-.-.-.-,-.-,-.-<-.-.-.-.-.-.-.-.-.-X-,-X-.-.-.-.-.-.-,-,-,-,-,-.-.-.-.-.-.-.-.-.-.-.-.-.-.-X-X-.-.-.-.-.-.-.-,-.-.-.-.-.-.-.-.-.-.-.-.-.-.-.-X-----------------------------
------------------------,-X-X-----,-X-t1,-.-.-.-.-.-.-,-.-.-.-.-,-.-,-.-.-.-.-.-.-.-.-.-.-.-X-,-X-.-.-.-.-.-.-,-:-X-X-X-.-.-.-.-.-.-.-.-.-.-.-.-.-.-X-X-.-.-.-.-.-.-.-,-.-.-.-.-.-.-.-.-.-.-.-.-.-.-.-X-----------------------------
------------------------------------,-X-,-.-.-.-.-.-.-,-.-.-.-.-,-.-,-.-<-.-.-.-.-.-.-.-.-.-X-,-X-.-.-.-.-.-.-,-.-X-.-X-.-.-.-.-.-.-.-.-.-.-.-.-.-,-X-X-.-.-.-.-.-.-.-,-.-.-.-.-.-.-.-.-.-.-.-.-.-.-.-X-----------------------------
--------------------------------------,-X-X-.-.-.-.-.-,-.-.-.-.-,-.-,-.-.-.-.-.-.-.-.-.-.-.-X-,-X-.-.-.-.-.-.-,-:-X-X-X-.-.-.-.-.-.-.-.-.-.-.-.-,-X-X-.-.-.-.-.-.-.-.-,-.-.-.-.-.-.-.-.-.-.-.-.-.-.-.-X-,---------------------------
------------------------------------------,-X-X-X-.-,-,-,-.-.-,-,-,-,-.-.-.-.-.-.-.-.-.-.-.-XOX-X-.-.-.-.-.-.-.-,-,-,-,-.-.-.-.-.-.-.-.-.-.-.-,-X-X-.-.-.-.-.-.-.-.-,-:-.-.-.-.-.-.-.-.-.-.-.-.-.-.-.-.-X-,-------------------------
------------------------------------------------,-X-X-X-,-.-.-,-,-.-,-.-.-.-.-.-.-.-.-.-.-.-.-X-X-.-.-.-.-.-.-.-.-.-.-.-.-.-.-.-.-.-.-.-.-.-.-,-X-X-.-.-.-.-.-.-.-,-X-.-.-.-.-.-.-.-.-.-.-.-.-.-.-.-.-.-.-X-------------------------
----------------------------------------------------,-X-,-.-.-.-,-,-,-.-.-.-.-.-.-.-.-.-.-.-XOX-X-.-.-.-.-.-.-.-.-.-.-.-.-.-.-.-.-.-.-.-.-.-,-X-X-.-.-.-.-.-.-.-,-X-X-.-.-.-.-.-.-.-.-.-.-.-.-.-.-.-.-.-.-X-------------------------
----------------------------------------------------,-X-,-.-.-.-,-.-,-.-.-.-.-.-.-.-.-.-.-.-X-,-X-.-.-.-.-.-.-.-.-.-.-.-.-.-.-.-.-.-X-X-X-X-X-.-X-.-.-.-.-.-.-.-X-,-X-.-.-.-.-.-.-.-.-.-.-.-.-.-.-.-.-.-.-X-,-----------------------
----------------------------------------------------,-X-,-.-.-.-,-.-,-.-.-.-.-.-.-.-.-.-.-.-X-,-X-.-.-.-.-.-.-.-.-.-.-.-.-.-.-.-,-,-X-X-X-X-X-X-.-.-.-.-.-.-.-.-X-,-X-.-.-.-.-.-.-.-.-.-.-.-.-.-.-.-.-.-.-.-X-,-,-------------------
----------------------------------------------------,-X-,-.-.-.-,-.-,-.-.-.-.-.-.-.-.-.-.-.-X-,-X-.-.-.-.-.-.-.-.-.-.-.-.-.-.-.-,-,-,-.-.-.-.-.-.-.-.-.-.-.-.-.-X-,-X-.-.-.-.-.-.-.-.-.-.-.-.-.-.-.-.-.-.-.-.-X-X-,-----------------
----------------------------------------------------,-X-,-.-.-.-,-.-,-.-.-.-.-.-.-.-.-.-.-.-X-,-X-.-.-.-.-.-.-.-.-.-.-.-.-.-.-.-,-,-,-.-.-.-.-.-.-.-,-,-,-,-.-,-X-.-X-.-.-.-.-.-.-.-.-.-.-.-.-.-.-.-.-.-.-.-.-.-.-X-,---------------
----------------------------------------------------,-X-,-.-.-.-,-.-,-.-.-.-.-.-.-.-.-.-.-.-X---,-X-.-.-.-.-.-.-.-.-.-.-.-.-.-.-,-,-,-.-.-.-.-.-.-.-,-.-.-,-.-X-,-X-.-.-.-.-.-.-.-.-.-.-.-.-.-.-.-.-.-X-.-.-.-.-.-.-X-,-------------
----------------------------------------------------,-X-,-.-.-.-,-.-,-.-.-.-.-.-.-.-.-.-.-.-X-,-,-X-X-,-,-.-.-.-.-.-.-.-.-,-X-X-X-X-X-X-X-X-X-X-X-X-X-,-,-,-X-X-X-X-.-.-.-.-.-.-.-.-.-.-.-.-.-.-.-,-X-,-X-X-.-.-.-.-.-X-,-,---------
----------------------------------------------------,-X-,-.-.-.-,-.-,-.-.-.-.-.-.-.-.-.-.-.-,-X-X-.-.-.-,-,-.-.-.-.-.-.-,-X-X-X-X-X-X-X1t1X1X-X-X-X-X-.-.-,-X-X-,-,-,-.-.-.-.-.-.-.-.-.-.-.-.-.-,-,-X---,-,-X-.-.-.-.-.-X-X-,-------
----------------------------------------------------,-X-,-.-.-.-,-.-,-.-.-.-.-.-.-.-.-.-.-.-,-X-.-.-.-.-.-,-.-.-.-.-.-,-X-X-.-.-.-.-.-.-.-.-.-.-.-,-,-,-,-,-.-.-,-.-,-.-.-.-.-.-.-.-.-.-.-.-.-.-,-X---------,-X-.-.-.-.-.-.-X-,-----
----------------------------------------------------,-X-,-.-.-.-,-.-,-<-.-.-.-.-.-.-.-.-.-.-,-.-.-.-W-W-.-,-.-.-.-.-,-,-X-.-.-.-.-.-.-.-.-.-.-.-.-.-.-.-.-.-.-.-,-,-,-,-.-.-.-.-.-.-.-.-.-.-.-,-,-X-----------,-X-X-.-.-.-.-.-X-----
----------------------------------------------------,-X-,-.-.-.-,-.-,-,-.-,-X-.-.-.-.-.-.-.-,-.-.-.-.-.-.-,-X-.-<-,-X-,-.-.-.-.-.-.-.-.-.-.-.-.-.-.-.-.-.-.-.-.-.-,-.-,-.-.-.-.-.-.-.-.-.-.-.-,-X---------------,-,-X-.-.-.-.-X-----
----------------------------------------------------,-X-,-.-.-.-,-,-.-,-,-X-,-X-.-.-.-.-.-.-,-,-.-.-.-,-,-,-X-X-,-X-X-.-.-.-.-.-.-.-.-.-.-.-.-.-.-.-.-.-.-.-.-.-.-,-.-,-.-.-.-.-.-.-.-.-.-.-.-X-,-------------------,-X-.-.-.-X-----
----------------------------------------------------,-X-,-.-.-.-.-,-,-.-X---,-,-X-.-.-.-.-.-.-,-,-.-,-,-X-X---,-X-X-.-.-.-.-.-.-.-.-.-.-.-.-.-.-.-.-.-.-.-.-.-.-.-,-.-,-.-.-.-.-.-.-.-.-.-.-.-.-X-,-,---------------,-X-.-.-.-,-X---
----------------------------------------------------,-X-,-.-.-.-,-,-,-X-,-,-,-X-.-.-.-.-.-.-.-.-,-,-,-.-.-X-,-,-X-.-.-.-.-.-.-.-.-.-.-.-.-.-.-.-.-.-.-.-.-.-.-.-.-,-.-,-.-.-.-.-.-.-.-.-.-.-.-.-.-X-X-,-------------,-X-.-.-.-.-X---
----------------------------------------------------,-X-,-,-.-,-,-,-,-X-X-X-X-,-,-,-X-.-.-.-.-.-.-.-.-.-.-.-X-X-.-.-.-.-.-.-.-.-.-.-.-.-.-.-.-.-.-.-.-.-.-.-.-.-,-,-,-,-.-.-.-.-.-.-.-.-.-.-.-.-.-.-.-X-,-------------X-.-.-.-.-X---
----------------------------------------------------,-X-.-,-,-,-,-,-.-.-.-.-,-,-,-X-,-X-,-.-.-.-.-.-.-.-.-.-.-.-.-.-.-.-.-.-.-.-.-.-.-.-.-.-.-.-.-.-.-.-.-.-.-.-,-.-.-,-.-.-.-.-.-.-.-.-.-.-.-.-.-.-.-.-X-,-----------,-X-.-.-.-X---
------------------------------------------------------,-X-X-,-,-,-.-.-.-.-.-.-,-X-,-X-.-,-,-.-.-.-.-.-.-.-.-.-.-.-.-.-.-.-.-.-.-.-.-.-.-.-.-.-.-.-.-.-.-.-.-.-.-,-.-.-,-.-.-.-.-.-.-.-.-.-.-.-.-.-.-.-.-.-X-,-,-------,-X-.-.-.-X---
--------------------------------------------------------,-,-X-,-.-.-.-.-.-.-,-X-,-X-,-,-.-,-.-.-.-.-.-.-.-.-.-.-.-.-.-.-.-.-.-.-.-.-.-.-.-.-.-.-.-.-.-.-.-.-.-.-,-,-,-,-.-.-.-.-.-.-.-.-.-.-.-.-.-.-.-.-.-.-X-X-,-----,-X-.-.-.-X---
------------------------------------------------------------,-X-.-.-.-.-.-.-X-,-X-,-,-,-,-,-X-.-.-.-.-.-.-.-.-.-.-.-.-.-.-.-.-.-.-.-.-.-.-.-.-.-.-.-.-.-.-.-.-.-.-,-.-,-.-.-.-.-.-.-.-.-.-.-.-.-.-.-.-.-.-.-.-.-X-,---,-X-.-.-.-,-X-
--------------------------------------------------------------,-X-.-.-.-.-.-X-X-,-,-,-,-,-X-,-X-.-.-.-.-.-.-.-.-.-.-.-.-.-.-.-.-.-.-.-.-.-.-.-.-.-.-.-.-.-.-.-.-.-,-.-,-.-.-.-.-.-.-.-.-.-X-X-X-X-X-X-X-.-.-.-.-.-X---,-X-.-.-.-.-X-
----------------------------------------------------------------,-X-.-.-.-.-.-.-,-,-,-,-X-,-X-.-.-.-.-.-.-.-.-.-.-.-.-.-.-.-.-.-.-.-.-.-.-.-.-.-.-.-.-.-.-.-.-.-.-,-.-,-.-.-.-.-.-.-.-.-,-X---------,-X-.-.-.-.-.-X-----X-.-.-.-.-X-
------------------------------------------------------------------,-X-.-.-.-.-.-.-,-,-X-,-X-,-,-,-X-.-.-.-.-.-.-.-.-.-.-.-.-.-.-.-.-.-.-.-.-.-.-.-.-.-.-.-.-.-.-,-,-,-,-.-.-.-.-.-.-.-.-X-----------,-X-.-.-.-.-.-X-----,-X-.-,-,-X-
--------------------------------------------------------------------,-X-.-.-.-.-.-.-X-,-X-,-,-,-X-,-X-.-.-.-.-.-.-.-.-.-.-.-.-.-.-.-.-.-.-.-.-.-.-.-.-.-.-.-.-.-,-.-,-.-.-.-.-.-.-.-.-,-X-----------,-X-.-.-.-.-.-X-----,-X-,-X-X---
----------------------------------------------------------------------,-X-.-.-.-.-.-X-X-.-.-.-X---,-,-X-.-.-.-.-.-.-.-.-.-.-.-.-.-.-.-.-.-.-.-.-.-.-.-.-.-.-W-,-,-,-,-.-.-.-.-.-.-.-.-X-------------,-X-.-.-.-.-.-X-----,-X-X-------
------------------------------------------------------------------------,-X-.-.-.-.-.-.-.-.-.-X-,-,-X-,-W-,-,-,-,-,-,-,-,-,-,-,-,-,-,-,-,-,-,-,-,-,-,-,-,-,-,-<-.-,-.-.-.-.-.-.-.-.-.-X-------------,-X-.-.-.-.-.-X-----------------
--------------------------------------------------------------------------,-X-.-.-.-.-.-.-.-.-X-,-X-.-.-.-.-.-,-.-,-.-.-.-.-.-.-.-.-.-.-.-.-.-.-,-.-,-.-.-.-.-.-,-,-.-.-.-.-.-.-.-.-,-X-------------,-X-.-.-.-.-.-X-----------------
----------------------------------------------------------------------------,-X-.-.-.-.-.-.-,-X-X-,-,-,-,-,-,-,-,-,-,-,-,-,-,-,-,-,-,-,-,-,-,-,-,-,-,-,-,-,-,-,-,-.-.-.-.-.-.-.-.-.-X---------------,-X-.-.-.-.-.-X-----------------
------------------------------------------------------------------------------,-X-.-.-.-.-.-,-X-.-.-.-.-.-.-.-.-,-,-.-.-.-.-.-.-.-.-.-.-.-.-.-.-,-,-.-.-.-.-.-.-.-.-.-.-.-.-.-.-.-,-X---------------,-X-.-.-.-.-.-X-----------------
--------------------------------------------------------------------------------,-X-X-.-.-W-,-:-.-.-.-.-.-.-.-.-.-.-.-.-.-.-.-.-.-.-.-.-.-.-.-.-.-.-.-.-.-.-.-.-.-.-.-.-.-.-.-.-.-X-----------------,-X-.-.-.-.-.-X-----------------
------------------------------------------------------------------,-,-,-,-,-,-,-,-,-,-X-,-<-,-.-.-.-.-.-.-.-.-.-.-.-.-.-.-.-.-.-.-.-.-.-.-.-.-.-.-.-.-.-.-.-.-.-.-.-.-.-.-.-.-.-.-X-,---------------,-X-.-.-.-.-.-X-----------------
----------------------------------------------------------------,-,-X-X-X-X-X-X-X-X-X-X-X-,-.-.-.-.-.-.-.-.-.-.-.-.-.-.-.-.-.-.-.-.-.-.-.-.-.-.-.-.-.-.-.-.-.-.-.-.-.-.-.-.-.-.-.-.-X---------------,-X-.-.-.-.-.-X-----------------
----------------------------------------------------------------,-.-X-.-.-.-.-.-.-.-.-.-.-.-.-.-.-.-.-.-.-.-.-.-.-.-.-.-.-.-.-.-.-.-.-.-.-.-.-.-.-.-.-.-.-.-.-.-.-.-.-.-.-.-.-.-.-.-X-,-------------,-X-.-.-.-.-.-X-----------------
--------------------------------------------------------------,-,-X-.-.-.-.-.-.-.-.-.-.-.-.-.-.-.-.-.-.-.-.-.-.-.-.-.-.-.-.-.-.-.-.-.-.-.-.-.-.-.-.-.-.-.-.-.-.-.-.-.-.-.-.-.-.-.-.-.-X-------------,-X-.-.-.-.-.-X-----------------
--------------------------------------------------------------,-.-X-.-.-.-.-.-.-.-.-.-.-.-.-.-.-.-.-.-.-.-.-.-.-.-.-.-.-.-.-.-.-.-.-.-.-.-.-.-.-.-.-.-.-.-.-.-.-.-.-.-.-.-.-.-.-.-.-.-X-,-----------,-X-.-.-.-.-.-X-----------------
------------------------------------------------------------,-,-X-.-.-.-.-.-.-.-.-.-.-.-.-.-.-.-.-.-.-.-.-.-.-.-.-.-.-.-.-.-.-.-.-.-.-.-.-.-.-.-.-.-.-.-.-.-.-.-.-.-.-.-.-.-.-.-.-.-.-.-X-----------,-X-.-.-.-.-.-X-----------------
------------------------------------------------------------,-.-X-.-.-.-.-.-.-.-.-.-.-.-.-.-.-.-.-.-.-.-.-.-.-.-.-.-.-.-.-.-.-.-.-.-.-.-.-.-.-.-.-.-X-X-X-X-X-X-X-X-X-X-X-X-X-X-.-.-.-.-X-,---------,-X-.-.-.-.-.-X-----------------
----------------------------------------------------------,-,-X-.-.-.-.-.-.-.-.-.-.-.-.-.-.-.-.-.-.-.-.-.-.-.-.-.-.-.-.-.-.-.-.-.-.-.-.-.-.-.-.-.-,-X-------------------------X-.-.-.-.-.-X---------,-X-.-.-.-.-.-X-----------------
----------------------------------------------------------,-.-X-.-.-.-.-.-.-.-.-.-.-.-.-.-.-.-.-.-.-.-.-.-.-.-.-.-.-.-.-.-.-.-.-.-.-.-.-.-.-.-.-.-X---------------------------,-X-.-.-.-.-X-,-------,-X-X-X-X-X-X-X-----------------
----------------------------------------------------------,-X-X-X-X-X-X-X-X-X-X-X-X-X-X-X-X-X-X-.-.-.-.-.-.-.-.-.-.-.-.-.-.-,-,-X-X-X-X-X-.-.-.-,-X-----------------------------X-.-.-.-.-,-X---------------------------------------
--------------------------------------------------------------------------------------------,-,-X-X-,-,-,-,-.-.-,-,-,-.-,-,-X-X-------,-X-.-.-.-X-------------------------------,-X-.-,-,-X-----------------------------------------
------------------------------------------------------------------------------------------------,-,-X-X-.-X-X-X-X-X-X-X-X-X-----------,-X-.-.-,-X---------------------------------X-,-X-X-------------------------------------------
----------------------------------------------------------------------------------------------------,-X-X-X-----,-X-X-----------------,-X-.-.-X-----------------------------------,-X-----------------------------------------------
------------------------------------------------------------------------------------------------------------------------------------,-,-X-.-,-X-------------------------------------------------------------------------------------
------------------------------------------------------------------------------------------------------------------------------------,-X-.-.-X---------------------------------------------------------------------------------------
----------------------------------------------------------------------------------------------------------------------------------,-,-X-.-.-X---------------------------------------------------------------------------------------
----------------------------------------------------------------------------------------------------------------------------------,-X-.-.-,-X---------------------------------------------------------------------------------------
--------------------------------------------------------------------------------------------------------------------------------,-,-X-.-.-X-----------------------------------------------------------------------------------------
--------------------------------------------------------------------------------------------------------------------------------,-X-.-.-,-X-----------------------------------------------------------------------------------------
------------------------------------------------------------------------------------------------------------------------------,-,-X-.-.-X-------------------------------------------------------------------------------------------
------------------------------------------------------------------------------------------------------------------------------,-X-.-.-,-X-------------------------------------------------------------------------------------------
----------------------------------------------------------------------------------------------------------------------------,-,-X-.-.-X---------------------------------------------------------------------------------------------
----------------------------------------------------------------------------------------------------------------------------,-X-.-.-,-X---------------------------------------------------------------------------------------------
--------------------------------------------------------------------------------------------------------------------------,-,-X-.-.-X-----------------------------------------------------------------------------------------------
--------------------------------------------------------------------------------------------------------------------------,-X-X-X-X-X-----------------------------------------------------------------------------------------------
