----------------------------------------------------------------------------------------------,-X-X-X-X-X-X-X-X-X-X-X-X-X-------------------------------------------------------------------------------------------------
----------------------------------------------------------------------------------------------,-X-.-.-.-.-.-<-.-.-.-.-.-X-------------------------------------------------------------------------------------------------
----------------------------------------------------------------------------------------------,-X-.-.-.-.-.-.-.-.-.-.-.-X-------------------------------------------------------------------------------------------------
----------------------------------------------------------------------------------------------,-X-.-.-.-W-.-H-.-W-.-.-.-X-------------------------------------------------------------------------------------------------
----------------------------------------------------------------------------------------------,-X-.-.-.-.-.-H-.-.-.-.-.-X-------------------------------------------------------------------------------------------------
----------------------------------------------------------------------------------------------,-X-.-.-.-.-.-H-.-.-.-.-.-X-------------------------------------------------------------------------------------------------
----------------------------------------------------------------------------------------------,-X-.-.-.-.-.-H-.-.-.-.-.-X-------------------------------------------------------------------------------------------------
----------------------------------------------------------------------------------------------,-X-.-.-.-.-.-H-.-.-.-.-.-X-------------------------------------------------------------------------------------------------
----------------------------------------------------------------------------------------------,-X-.-.-.-.-.-H-.-.-.-.-.-X-------------------------------------------------------------------------------------------------
----------------------------------------------------------------------------------------------,-X-.-.-.-.-.-H-.-.-.-.-.-X-------------------------------------------------------------------------------------------------
----------------------------------------------------------------------------------------------,-X-.-.-.-.-.-H-.-.-.-.-.-X-------------------------------------------------------------------------------------------------
----------------------------------------------------------------------------------------------,-X-.-.-.-.-.-H-.-.-.-.-.-X-------------------------------------------------------------------------------------------------
----------------------------------------------------------------------------------------------,-X-.-.-.-.-.-H-.-.-.-.-.-X-------------------------------------------------------------------------------------------------
----------------------------------------------------------------------------------------------,-X-.-.-.-.-.-H-.-.-.-.-.-X-------------------------------------------------------------------------------------------------
----------------------------------------------------------------------------------------------,-X-.-.-.-.-.-H-.-.-.-.-.-X-------------------------------------------------------------------------------------------------
----------------------------------------------------------------------------------------------,-X-.-.-.-.-.-H-.-.-.-.-.-X-------------------------------------------------------------------------------------------------
----------------------------------------------------------------------------------------------,-X-.-.-.-.-.-H-.-.-.-.-.-X-------------------------------------------------------------------------------------------------
----------------------------------------------------------------------------------------------,-X-.-.-.-.-.-H-.-.-.-.-.-X-------------------------------------------------------------------------------------------------
----------------------------------------------------------------------------------------------,-X-.-.-.-.-.-H-.-.-.-.-.-X-------------------------------------------------------------------------------------------------
----------------------------------------------------------------------------------------------,-X-.-.-.-.-.-H-.-.-.-.-.-X-------------------------------------------------------------------------------------------------
--------------------------------------------------------------------------------------------,-,-X-.-.-.-.-.-H-.-.-.-.-.-X-,-----------------------------------------------------------------------------------------------
------------------------------------------------------------------------------------------,-,-X-.-.-.-.-.-.-.-.-.-.-.-.-.-X-,---------------------------------------------------------------------------------------------
----------------------------------------------------------------------------------------,-,-X-.-.-.-.-.-.-.-.-.-.-.-.-.-.-.-X-,-------------------------------------------------------------------------------------------
--------------------------------------------------------------------------------------,-,-X-.-.-.-.-.-.-.-.-.-.-.-.-.-.-.-.-.-X-,-----------------------------------------------------------------------------------------
------------------------------------------------------------------------------------,-,-X-.-.-.-.-.-.-.-.-.-.-.-.-.-.-.-.-.-.-.-X-,---------------------------------------------------------------------------------------
----------------------------------------------------------------------------------,-,-X-.-.-.-.-.-.-.-.-.-.-.-.-.-.-.-.-.-.-.-.-.-X-,-------------------------------------------------------------------------------------
--------------------------------------------------------------------------------,-,-X-.-.-.-.-.-.-.-.-.-.-.-.-.-.-.-.-.-.-.-.-.-.-.-X-,-----------------------------------------------------------------------------------
------------------------------------------------------------------------------,-,-X-.-.-.-.-.-.-.-.-.-.-.-.-.-.-.-.-.-.-.-.-.-.-.-.-.-X-,---------------------------------------------------------------------------------
----------------------------------------------------------------------------,-,-X-.-.-.-.-.-.-.-.-.-.-.-.-.-.-.-.-.-.-.-.-.-.-.-.-.-.-.-X-,-------------------------------------------------------------------------------
--------------------------------------------------------------------------,-,-X-.-.-.-.-.-.-.-.-.-.-.-.-.-.-.-.-.-.-.-.-.-.-.-.-.-.-.-.-.-X-,-----------------------------------------------------------------------------
------------------------------------------------------------------------,-,-X-.-.-.-.-.-.-.-.-.-.-.-.-.-.-.-.-.-.-.-.-.-.-.-.-.-.-.-.-.-.-.-X-,---------------------------------------------------------------------------
----------------------------------------------------------------------,-,-X-.-.-.-.-.-.-.-.-.-.-.-.-.-.-.-.-.-.-.-.-.-.-.-.-.-.-.-.-.-.-.-.-.-X-,-------------------------------------------------------------------------
--------------------------------------------------------------------,-,-X-.-.-.-.-.-<-.-.-.-.-.-X-.-.-.-.-.-.-.-.-.-.-.-X-.-.-.-.-.-.-.-.-.-.-.-X-,-----------------------------------------------------------------------
------------------------------------------------------------------,-,-X-.-.-.-.-.-.-.-.-.-.-.-X-X-.-.-.-.-.-.-.-.-.-.-.-X-X-.-.-.-.-.-.-.-.-.-.-.-X-,---------------------------------------------------------------------
----------------------------------------------------------------,-,-X-.-.-.-.-.-.-.-.-.-.-.-X-.-X-.-.-.-.-.-.-.-.-.-.-.-X-.-X-.-.-.-.-.-.-.-.-.-.-.-X-,-------------------------------------------------------------------
--------------------------------------------------------------,-,-X-.-.-.-.-.-A-.-.-.-.-.-X-.-.-X-.-.-.-.-.-.-.-.-.-.-.-X-.-.-X-.-.-.-.-.-A-.-.-.-.-.-X-,-----------------------------------------------------------------
------------------------------------------------------------,-,-X-.-.-.-.-.-.-.-.-.-.-.-X-.-.-.-X-.-.-.-.-.-.-.-.-.-.-.-X-.-.-.-X-.-.-.-.-.-.-.-.-.-.-.-X-,---------------------------------------------------------------
----------------------------------------------------------,-,-X-.-.-.-.-.-W-.-.-.-.-.-X-.-.-.-.-X-.-.-.-.-.-.-.-.-.-.-.-X-.-.-.-.-X-.-.-.-.-.-W-.-.-.-.-.-X-,-------------------------------------------------------------
--------------------------------------------------------,-,-X-.-.-.-.-.-.-.-.-.-.-.-X-.-.-.-.-.-X-.-.-.-.-.-.-.-.-.-.-.-X-.-.-.-.-.-X-.-.-.-.-.-.-.-.-.-.-.-X-,-----------------------------------------------------------
------------------------------------------------------,-,-X-.-.-.-.-.-A-.-.-.-.-.-X-.-.-.-.-.-.-X-.-.-.-.-.-.-.-.-.-.-.-X-.-.-.-.-.-.-X-.-.-.-.-.-A-.-.-.-.-.-X-,---------------------------------------------------------
----------------------------------------------------,-,-X-.-.-.-.-.-.-.-.-.-.-.-X-.-.-.-.-.-.-.-X-.-.-.-.-.-.-.-.-.-.-.-X-.-.-.-.-.-.-.-X-.-.-.-.-.-.-.-.-.-.-.-X-,-------------------------------------------------------
--------------------------------------------------,-,-X-.-.-.-.-.-.-.-.-.-.-.-X-.-.-.-.-.-.-.-.-X-.-.-.-.-.-.-.-.-.-.-.-X-.-.-.-.-.-.-.-.-X-.-.-.-.-.-.-.-.-.-.-.-X-,-----------------------------------------------------
------------------------------------------------,-,-X-.-.-.-.-.-.-.-.-.-.-.-X-.-.-.-.-.-.-.-.-.-X-.-.-.-.-.-.-.-.-.-.-.-X-.-.-.-.-.-.-.-.-.-X-.-.-.-.-.-<-.-.-.-.-.-X-,---------------------------------------------------
----------------------------------------------,-,-X-.-.-.-.-.-.-.-.-.-.-.-X-.-.-.-.-.-.-.-.-.-.-X-.-.-.-.-.-.-.-.-.-.-.-X-.-.-.-.-.-.-.-.-.-.-X-.-.-.-.-.-.-.-.-.-.-.-X-,-------------------------------------------------
--------------------------------------------,-,-X-.-.-.-.-.-.-.-.-.-.-.-X-.-.-.-.-.-.-.-.-.-.-.-X-.-.-.-.-.-.-.-.-.-.-.-X-.-.-.-.-.-.-.-.-.-.-.-X-.-.-.-.-.-.-.-.-.-.-.-X-,-----------------------------------------------
------------------------------------------,-,-X-.-.-.-.-.-.-.-.-.-.-.-X-.-.-.-.-.-.-.-.-.-.-.-.-X-.-.-.-.-.-.-.-.-.-.-.-X-.-.-.-.-.-.-.-.-.-.-.-.-X-.-.-.-.-.-.-.-.-.-.-.-X-,---------------------------------------------
----------------------------------------,-,-X-.-.-.-.-.-.-.-.-.-.-.-X-.-.-.-.-.-.-.-.-.-.-.-.-.-X-.-.-.-.-.-.-.-.-.-.-.-X-.-.-.-.-.-.-.-.-.-.-.-.-.-X-.-.-.-.-.-.-.-.-.-.-.-X-,-------------------------------------------
,-,-,-,-,-,-,-,-,-,-,-,-,-,-,-,-,-,-,-,-,-X-.-.-.-.-.-.-.-.-.-.-.-X-.-.-.-.-.-.-.-.-.-.-.-.-.-.-X-.-.-.-.-.-.-.-.-.-.-.-X-.-.-.-.-.-.-.-.-.-.-.-.-.-.-X-.-.-.-.-.-.-.-.-.-.-.-X-,-,-,-,-,-,-,-,-,-,-,-,-,-,-,-,-,-,-,-,-,-
X-X-X-X-X-X-X-X-X-X-X-X-X-X-X-X-X-X-X-X-X-.-.-.-.-.-.-.-.-.-.-.-X-X-X-X-X-X-X-X-X-X-X-X-X-X-X-X-X-.-.-.-.-.-.-.-.-.-.-.-X-X-X-X-X-X-X-X-X-X-X-X-X-X-X-X-X-.-.-.-.-.-.-.-.-.-.-.-X-X-X-X-X-X-X-X-X-X-X-X-X-X-X-X-X-X-X-X-X-
X-.-.-.-.-.-.-.-.-.-.-.-.-.-.-.-.-.-.-.-.-.-.-.-.-.-.-.-.-.-.-.-.-.-.-.-.-.-.-.-.-.-.-.-.-.-.-.-.-.-.-.-.-.-.-.-.-.-.-.-.-.-.-.-.-.-.-.-.-.-.-.-.-.-.-.-.-.-.-.-.-.-.-.-.-.-.-.-.-.-.-.-.-.-.-.-.-.-.-.-.-.-.-.-.-.-.-.-X-
X-.-.-.-.-.-.-.-.-.-.-.-.-.-.-.-.-.-.-.-.-.-.-.-.-.-.-.-.-.-.-.-.-.-.-.-.-.-.-.-.-.-.-.-.-.-.-.-.-.-.-.-.-.-<-.-.-.-.-.-.-.-.-.-.-.-.-.-.-.-.-.-.-.-.-.-.-.-.-.-.-.-.-.-.-.-.-.-.-.-.-.-.-.-.-.-.-.-.-.-.-.-.-.-.-.-.-.-X-
X-.-.-.-.-.-.-.-.-.-.-.-.-.-.-.-.-.-.-.-.-.-.-.-.-.-.-.-.-.-.-.-.-.-.-.-.-.-.-.-.-.-.-.-.-.-.-.-.-.-.-.-.-.-.-.-.-.-.-.-.-.-.-.-.-.-.-.-.-.-.-.-.-.-.-.-.-.-.-.-.-.-.-.-.-.-.-.-.-.-.-.-.-.-.-.-.-.-.-.-.-.-.-.-.-.-.-.-X-
X-.-.-W-.-.-.-.-.-.-.-.-.-.-.-.-.-.-.-.-.-.-.-.-.-.-.-.-.-.-.-.-.-.-.-.-.-.-.-.-.-.-.-.-.-.-.-.-.-.-.-.-.-.-.-.-.-.-.-.-.-.-.-.-.-.-.-.-.-.-.-.-.-.-.-.-.-.-.-.-.-.-.-.-.-.-.-.-.-.-.-.-.-.-.-.-.-.-.-.-.-.-.-.-.-W-.-.-X-
X-.-.-.-.-.-.-.-.-.-.-.-.-.-.-.-.-.-.-.-.-.-.-.-.-.-.-.-.-.-.-.-.-.-.-.-.-.-.-.-.-.-.-.-.-.-.-.-.-.-.-.-.-.-.-.-.-.-.-.-.-.-.-.-.-.-.-.-.-.-.-.-.-.-.-.-.-.-.-.-.-.-.-.-.-.-.-.-.-.-.-.-.-.-.-.-.-.-.-.-.-.-.-.-.-.-.-.-X-
X-<-.-H-H-H-H-H-H-H-H-H-H-H-H-H-H-H-H-H-H-.-.-.-.-.-.-.-.-.-.-.-.-.-.-.-.-.-.-.-.-.-.-.-.-.-.-.-.-.-<-.-.-.-.-.-.-.-<-.-.-.-.-.-.-.-.-.-.-.-.-.-.-.-.-.-.-.-.-.-.-.-.-.-.-.-.-.-H-H-H-H-H-H-H-H-H-H-H-H-H-H-H-H-H-H-<-<-X-
X-.-.-.-.-.-.-.-.-.-.-.-.-.-.-.-.-.-.-.-.-.-.-.-.-.-.-.-.-.-.-.-.-.-.-.-.-.-.-.-.-.-.-.-.-.-.-.-.-.-.-.-.-.-.-.-.-.-.-.-.-.-.-.-.-.-.-.-.-.-.-.-.-.-.-.-.-.-.-.-.-.-.-.-.-.-.-.-.-.-.-.-.-.-.-.-.-.-.-.-.-.-.-.-.-.-.-.-X-
X-.-.-W-.-.-.-.-.-.-.-.-.-.-.-.-.-.-.-.-.-.-.-.-.-.-.-.-.-.-.-.-.-.-.-.-.-.-.-.-.-.-.-.-.-.-.-.-.-.-.-.-.-.-.-.-.-.-.-.-.-.-.-.-.-.-.-.-.-.-.-.-.-.-.-.-.-.-.-.-.-.-.-.-.-.-.-.-.-.-.-.-.-.-.-.-.-.-.-.-.-.-.-.-.-W-.-.-X-
X-.-.-.-.-.-.-.-.-.-.-.-.-.-.-.-.-.-.-.-.-.-.-.-.-.-.-.-.-.-.-.-.-.-.-.-.-.-.-.-.-.-.-.-.-.-.-.-.-.-.-.-.-.-.-.-.-.-.-.-.-.-.-.-.-.-.-.-.-.-.-.-.-.-.-.-.-.-.-.-.-.-.-.-.-.-.-.-.-.-.-.-.-.-.-.-.-.-.-.-.-.-.-.-.-.-.-.-X-
X-.-.-.-.-.-.-.-.-.-.-.-.-.-.-.-.-.-.-.-.-.-.-.-.-.-.-.-.-.-.-.-.-.-.-.-.-.-.-.-.-.-.-.-.-.-.-.-.-.-.-.-.-.-<-.-.-.-.-.-.-.-.-.-.-.-.-.-.-.-.-.-.-.-.-.-.-.-.-.-.-.-.-.-.-.-.-.-.-.-.-.-.-.-.-.-.-.-.-.-.-.-.-.-.-.-.-.-X-
X-.-.-.-.-.-.-.-.-.-.-.-.-.-.-.-.-.-.-.-.-.-.-.-.-.-.-.-.-.-.-.-.-.-.-.-.-.-.-.-.-.-.-.-.-.-.-.-.-.-.-.-.-.-.-.-.-.-.-.-.-.-.-.-.-.-.-.-.-.-.-.-.-.-.-.-.-.-.-.-.-.-.-.-.-.-.-.-.-.-.-.-.-.-.-.-.-.-.-.-.-.-.-.-.-.-.-.-X-
X-X-X-X-X-X-X-X-X-X-X-X-X-X-X-X-X-X-X-X-X-.-.-.-.-.-.-.-.-.-.-.-X-X-X-X-X-X-X-X-X-X-X-X-X-X-X-X-X-.-.-.-.-.-.-.-.-.-.-.-X-X-X-X-X-X-X-X-X-X-X-X-X-X-X-X-X-.-.-.-.-.-.-.-.-.-.-,-X-X-X-X-X-X-X-X-X-X-X-X-X-X-X-X-X-X-X-X-X-
----------------------------------------,-X-.-.-.-.-.-.-.-.-.-.-.-X-.-.-.-.-.-.-.-.-.-.-.-.-.-.-X-.-.-.-.-.-.-.-.-.-.-.-X-.-.-.-.-.-.-.-.-.-.-.-.-.-.-X-.-.-.-.-.-.-.-.-.-.-,-X-------------------------------------------
------------------------------------------,-X-.-.-.-.-.-.-.-.-.-.-.-X-.-.-.-.-.-.-.-.-.-.-.-.-.-X-.-.-.-.-.-.-.-.-.-.-.-X-.-.-.-.-.-.-.-.-.-.-.-.-.-X-.-.-.-.-.-.-.-.-.-.-,-X---------------------------------------------
--------------------------------------------,-X-.-.-.-.-.-.-.-.-.-.-.-X-.-.-.-.-.-.-.-.-.-.-.-.-X-.-.-.-.-.-.-.-.-.-.-.-X-.-.-.-.-.-.-.-.-.-.-.-.-X-.-.-.-.-.-.-.-.-.-.-,-X-----------------------------------------------
----------------------------------------------,-X-.-.-.-.-.-.-.-.-.-.-.-X-.-.-.-.-.-.-.-.-.-.-.-X-.-.-.-.-.-.-.-.-.-.-.-X-.-.-.-.-.-.-.-.-.-.-.-X-.-.-.-.-.-.-.-.-.-.-,-X-------------------------------------------------
------------------------------------------------,-X-.-.-.-.-.-.-.-.-.-.-.-X-.-.-.-.-.-.-.-.-.-.-X-.-.-.-.-.-.-.-.-.-.-.-X-.-.-.-.-.-.-.-.-.-.-X-.-.-.-.-.-.-.-.-.-.-,-X---------------------------------------------------
--------------------------------------------------,-X-.-.-.-.-.-<-.-.-.-.-.-X-.-.-.-.-.-.-.-.-.-X-.-.-.-.-.-.-.-.-.-.-.-X-.-.-.-.-.-.-.-.-.-X-.-.-.-.-.-.-.-.-.-.-,-X-----------------------------------------------------
----------------------------------------------------,-X-.-.-.-.-.-.-.-.-.-.-.-X-.-.-.-.-.-.-.-.-X-.-.-.-.-.-.-.-.-.-.-.-X-.-.-.-.-.-.-.-.-X-.-.-.-.-.-.-.-.-.-.-,-X-------------------------------------------------------
------------------------------------------------------,-X-.-.-.-.-.-.-.-.-.-.-.-X-.-.-.-.-.-.-.-X-.-.-.-.-.-.-.-.-.-.-.-X-.-.-.-.-.-.-.-X-.-.-.-.-.-.-.-.-.-.-,-X---------------------------------------------------------
--------------------------------------------------------,-X-.-.-.-.-.-A-.-.-.-.-.-X-.-.-.-.-.-.-X-.-.-.-.-.-.-.-.-.-.-.-X-.-.-.-.-.-.-X-.-.-.-.-.-A-.-.-.-.-,-X-----------------------------------------------------------
----------------------------------------------------------,-X-.-.-.-.-.-.-.-.-.-.-.-X-.-.-.-.-.-X-.-.-.-.-.-.-.-.-.-.-.-X-.-.-.-.-.-X-.-.-.-.-.-.-.-.-.-.-,-X-------------------------------------------------------------
------------------------------------------------------------,-X-.-.-.-.-.-W-.-.-.-.-.-X-.-.-.-.-X-.-.-.-.-.-.-.-.-.-.-.-X-.-.-.-.-X-.-.-.-.-.-W-.-.-.-.-,-X---------------------------------------------------------------
--------------------------------------------------------------,-X-.-.-.-.-.-.-.-.-.-.-.-X-.-.-.-X-.-.-.-.-.-.-.-.-.-.-.-X-.-.-.-X-.-.-.-.-.-.-.-.-.-.-,-X-----------------------------------------------------------------
----------------------------------------------------------------,-X-.-.-.-.-.-A-.-.-.-.-.-X-.-.-X-.-.-.-.-.-.-.-.-.-.-.-X-.-.-X-.-.-.-.-.-A-.-.-.-.-,-X-------------------------------------------------------------------
------------------------------------------------------------------,-X-.-.-.-.-.-.-.-.-.-.-.-X-.-X-.-.-.-.-.-.-.-.-.-.-.-X-.-X-.-.-.-.-.-.-.-.-.-.-,-X---------------------------------------------------------------------
--------------------------------------------------------------------,-X-.-.-.-.-.-.-.-.-.-.-.-X-X-.-.-.-.-.-.-.-.-.-.-.-X-X-.-.-.-.-.-.-.-.-.-.-,-X-----------------------------------------------------------------------
----------------------------------------------------------------------,-X-.-.-.-.-.-.-.-.-.-.-.-X-.-.-.-.-.-.-.-.-.-.-.-X-.-.-.-.-.-<-.-.-.-.-,-X-------------------------------------------------------------------------
------------------------------------------------------------------------,-X-.-.-.-.-.-.-.-.-.-.-.-.-.-.-.-.-.-.-.-.-.-.-.-.-.-.-.-.-.-.-.-.-,-X---------------------------------------------------------------------------
--------------------------------------------------------------------------,-X-.-.-.-.-.-.-.-.-.-.-.-.-.-.-.-.-.-.-.-.-.-.-.-.-.-.-.-.-.-.-,-X-----------------------------------------------------------------------------
----------------------------------------------------------------------------,-X-.-.-.-.-.-.-.-.-.-.-.-.-.-.-.-.-.-.-.-.-.-.-.-.-.-.-.-.-,-X-------------------------------------------------------------------------------
------------------------------------------------------------------------------,-X-.-.-.-.-.-.-.-.-.-.-.-.-.-.-.-.-.-.-.-.-.-.-.-.-.-.-,-X---------------------------------------------------------------------------------
--------------------------------------------------------------------------------,-X-.-.-.-.-.-.-.-.-.-.-.-.-.-.-.-.-.-.-.-.-.-.-.-.-,-X-----------------------------------------------------------------------------------
----------------------------------------------------------------------------------,-X-.-.-.-.-.-.-.-.-.-.-.-.-.-.-.-.-.-.-.-.-.-.-,-X-------------------------------------------------------------------------------------
------------------------------------------------------------------------------------,-X-.-.-.-.-.-.-.-.-.-.-.-.-.-.-.-.-.-.-.-.-,-X---------------------------------------------------------------------------------------
--------------------------------------------------------------------------------------,-X-.-.-.-.-.-.-.-.-.-.-.-.-.-.-.-.-.-.-,-X-----------------------------------------------------------------------------------------
----------------------------------------------------------------------------------------,-X-.-.-.-.-.-.-.-.-.-.-.-.-.-.-.-.-,-X-------------------------------------------------------------------------------------------
------------------------------------------------------------------------------------------,-X-.-.-.-.-.-.-.-.-.-.-.-.-.-.-,-X---------------------------------------------------------------------------------------------
--------------------------------------------------------------------------------------------,-X-.-.-.-.-.-.-.-.-.-.-.-.-,-X-----------------------------------------------------------------------------------------------
----------------------------------------------------------------------------------------------,-X-.-.-.-.-.-H-.-.-.-.-.-X-------------------------------------------------------------------------------------------------
----------------------------------------------------------------------------------------------,-X-.-.-.-.-.-H-.-.-.-.-.-X-------------------------------------------------------------------------------------------------
----------------------------------------------------------------------------------------------,-X-.-.-.-.-.-H-.-.-.-.-.-X-------------------------------------------------------------------------------------------------
----------------------------------------------------------------------------------------------,-X-.-.-.-.-.-H-.-.-.-.-.-X-------------------------------------------------------------------------------------------------
----------------------------------------------------------------------------------------------,-X-.-.-.-.-.-H-.-.-.-.-.-X-------------------------------------------------------------------------------------------------
----------------------------------------------------------------------------------------------,-X-.-.-.-.-.-H-.-.-.-.-.-X-------------------------------------------------------------------------------------------------
----------------------------------------------------------------------------------------------,-X-.-.-.-.-.-H-.-.-.-.-.-X-------------------------------------------------------------------------------------------------
----------------------------------------------------------------------------------------------,-X-.-.-.-.-.-H-.-.-.-.-.-X-------------------------------------------------------------------------------------------------
----------------------------------------------------------------------------------------------,-X-.-.-.-.-.-H-.-.-.-.-.-X-------------------------------------------------------------------------------------------------
----------------------------------------------------------------------------------------------,-X-.-.-.-.-.-H-.-.-.-.-.-X-------------------------------------------------------------------------------------------------
----------------------------------------------------------------------------------------------,-X-.-.-.-.-.-H-.-.-.-.-.-X-------------------------------------------------------------------------------------------------
----------------------------------------------------------------------------------------------,-X-.-.-.-.-.-H-.-.-.-.-.-X-------------------------------------------------------------------------------------------------
----------------------------------------------------------------------------------------------,-X-.-.-.-.-.-H-.-.-.-.-.-X-------------------------------------------------------------------------------------------------
----------------------------------------------------------------------------------------------,-X-.-.-.-.-.-H-.-.-.-.-.-X-------------------------------------------------------------------------------------------------
----------------------------------------------------------------------------------------------,-X-.-.-.-.-.-H-.-.-.-.-.-X-------------------------------------------------------------------------------------------------
----------------------------------------------------------------------------------------------,-X-.-.-.-.-.-H-.-.-.-.-.-X-------------------------------------------------------------------------------------------------
----------------------------------------------------------------------------------------------,-X-.-.-.-.-.-H-.-.-.-.-.-X-------------------------------------------------------------------------------------------------
----------------------------------------------------------------------------------------------,-X-.-.-.-W-.-H-.-W-.-.-.-X-------------------------------------------------------------------------------------------------
----------------------------------------------------------------------------------------------,-X-.-.-.-.-.-<-.-.-.-.-.-X-------------------------------------------------------------------------------------------------
----------------------------------------------------------------------------------------------,-X-.-.-.-.-.-<-.-.-,-,-,-X-------------------------------------------------------------------------------------------------
----------------------------------------------------------------------------------------------,-X-X-X-X-X-X-X-X-X-X-X-.-X-------------------------------------------------------------------------------------------------
------------------------------------------------------------------------------------------------------------------,-X-.-X-------------------------------------------------------------------------------------------------
------------------------------------------------------------------------------------------------------------------,->->->-------------------------------------------------------------------------------------------------
