----------------------------------------------------------------------------,-,-X-,---------------------------------------------------------------------------
------------------------------------------------------------------------,-,-,-X-.-X-,-,-----------------------------------------------------------------------
----------------------------------------------------------------------,-,-X-X-.-H-.-X-X-,---------------------------------------------------------------------
--------------------------------------------------------------------,-,-X-.-.-.-.-.-.-.-X-,-------------------------------------------------------------------
------------------------------------------------------------------,-,-X-.-.-.-.-.-.-.-.-.-X-,-----------------------------------------------------------------
--------------------------------------------------------------,-,-,-X-.-.-.-.-.-.-.-.-.-.-.-X-,-,-------------------------------------------------------------
------------------------------------------------------------,-,-X-X-.-.-.-.-.-.-.-.-.-.-.-.-.-X-X-,-----------------------------------------------------------
----------------------------------------------------------,-,-X-.-.-.-.-.-.-.-,-,-.-.-.-.-.-.-.-.-X-,---------------------------------------------------------
--------------------------------------------------------,-,-X-.-.-.-.-.-.-.-,-,-,-,-.-.-.-.-.-.-.-.-X-,-------------------------------------------------------
----------------------------------------------------,-,-,-X-.-.-.-.-.-.-.-,-,-,-,-,-,-.-.-.-.-.-.-.-.-X-,-,---------------------------------------------------
--------------------------------------------------,-,-X-X-.-.-.-A-.-.-,-,-,-,-,-,-,-,-,-.-.-.-.-.-.-.-.-X-X-,-------------------------------------------------
------------------------------------------------,-,-X-.-.-.-.-.-.-.-,-,-,-,-,-,-,-,-,-,-,-.-.-.-.-.-.-.-.-.-X-,-----------------------------------------------
----------------------------------------------,-,-X-.-.-.-.-.-.-.-,-,-,-,-.-,-,-,-,-,-,-,-,-.-.-A-.-.-.-.-.-.-X-,---------------------------------------------
------------------------------------------,-,-,-X-.-.-.-.-.-.-.-,-,-,-,-.-,-,-,-,-,-,-,-,-,-,-.-.-.-.-.-.-.-.-.-X-,-,-----------------------------------------
----------------------------------------,-,-X-X-.-.-.-.-.-.-.-,-,-,-,-.-,-,-,-,-,-,-,-,-,-,-,-,-.-.-.-.-.-.-.-.-.-X-X-,---------------------------------------
--------------------------------------,-,-X-.-.-.-.-.-.-.-,-,-,-,-,-,-,-,-,-,-,-,-,-,-,-,-,-,-,-,-.-.-.-.-.-.-.-.-.-.-X-,-------------------------------------
--------------------------------------,-X-.-H-.-.-.-.-.-,-,-,-,-.-,-,-,-,-,-,-,-,-,-,-,-,-,-,-,-,-,-.-.-.-.-.-.-.-.-H-.-X-------------------------------------
--------------------------------------,-X-.-.-.-.-.-.-,-,-,-,-.-,-,-,-,-,-,-,-,-,-,-,-,-,-,-,-,-,-,-,-.-.-.-.-.-.-.-.-,-X-------------------------------------
----------------------------------------,-X-.-.-.-.-.-,-.-,-.-,-,-,-,-,-,-,-.-,-,-,-,-,-,-,-,-,-,-,-,-,-.-.-.-.-.-.-.-X---------------------------------------
----------------------------------------,-X-.-.-.-.-.-,-,-,-,-,-,-,-,-,-,-,-,-,-.-,-,-,-,-,-,-,-,-,-,-,-,-.-.-.-.-.-,-X---------------------------------------
----------------------------------------,-X-.-.-.-.-.-.-,-.-,-,-,-,-,-,-,-,-,-.-W-,-,-,-,-,-,-,-,-.-,-.-,-.-.-.-.-.-X-----------------------------------------
------------------------------------------,-X-.-.-.-.-.-,-,-,-.-,-,-,-,-,-,-,-,-,-.-,-,-,-,-,-,-,-,-,-,-,-.-.-.-.-.-X-----------------------------------------
------------------------------------------,-X-.-.-.-.-.-.-,-,-,-,-,-,-,-,-,-.-.-.-,-,-,-,-,-,-,-.-,-.-,-.-.-.-.-A-,-X-----------------------------------------
------------------------------------------,-X-.-.-.-.-.-.-,-.-,-,-,-,-,-,-,-,-,-,-,-,-,-,-,-,-,-,-,-,-,-.-.-.-.-.-X-------------------------------------------
--------------------------------------------,-X-.-.-.-.-.-,-,-,-,-,-,-,-,-,-,-.-.-,-,-,-,-,-,-.-,-.-,-.-.-.-.-.-,-X-------------------------------------------
--------------------------------------------,-X-.-.-.-.-.-.-,-.-,-,-,-.-,-.-,-,-,-,-,-,-,-,-,-,-,-,-,-.-.-.-.-.-X---------------------------------------------
----------------------------------------------,-X-.-.-.-.-.-,-.-,-.-,-,-,-,-,-,-,-,-,-,-,-,-.-,-.-,-.-.-.-.-A-,-X---------------------------------------------
----------------------------------------------,-X-.-.-.-.-.-,-,-,-,-,-,-.-.-.-,-,-,-,-,-,-,-,-,-,-,-.-.-.-.-.-X-----------------------------------------------
----------------------------------------------,-X-.-.-.-.-.-.-,-.-,-,-,-,-,-,-,-.-,-,-,-,-.-,-.-,-.-.-.-.-.-.-X-----------------------------------------------
------------------------------------------------,-X-.-.-.-.-.-,-,-,-.-,-.-,-,-,-,-,-.-.-.-,-,-,-,-.-.-.-.-.-,-X-----------------------------------------,-,-,-
------------------------------------------------,-X-.-.-.-.-.-.-,-,-,-,-,-,-.-.-.-.-,-,-,-,-.-,-.-.-.-.-A-.-X-----------------------------------,-,-,-,-,-X-X-
,-,-,-,-,---------------------------------------,-X-.-.-.-.-.-.-,-.-,-.-.-,-,-,-,-,-,-.-.-.-,-,-.-.-.-.-.-,-X-----------------------------,-,-,-,-X-X-X-X-,-X-
X-X-X-X-X-,-,-,-,-,-,-,-,-------------------------,-X-.-.-.-.-.-,-,-,-,-,-,-.-.-.-.-,-,-,-,-,-.-.-.-.-.-.-X-------------------------,-,-,-,-X-X-X-.-.-.-.-X---
X-.-.-.-.-X-X-X-X-X-X-X-X-,-,-,-,-,---------------,-X-.-.-.-.-.-.-,-.-.-,-,-,-,-,-,-,-.-.-.-.-.-.-.-.-.-.-X-----------------,-,-,-,-,-X-X-X-.-.-.-.-.-.-.-X---
,-X-.-.-.-.-.-.-.-.-.-.-.-X-X-X-X-X-,-------------,-X-.-.-.-.-.-.-,-,-,-,-.-.-.-.-.-.-.-.-.-.-.-.-.-A-.-,-X-------------,-,-,-X-X-X-X-.-.-.-.-.-A-.-.-.-.-X---
,-X-.-.-.-.-.-.-.-.-.-.-.-.-.-.-.-,-X-,-------------,-X-.-.-.-.-.-.-.-.-.-.-.-.-.-.-.-.-.-.-.-.-.-.-.-.-X-------------,-,-X-X-.-.-.-.-.-.-.-.-.-.-.-.-.-,-X---
,-X-.-.-.-.-A-.-.-.-.-.-.-.-.-.-.-,-.-X-------------,-X-.-.-.-.-.-.-.-.-.-.-.-.-.-.-.-.-.-.-.-.-.-.-.-,-X-----------,-,-X-.-,-.-.-.-.-.-.-.-.-.-<-.-A-.-X-----
--,-X-.-.-.-.-.-.-.-.-.-.-.-.-.-,-,-,-X-,-----------,-X-.-.-.-.-.-.-.-.-.-.-.-.-.-.-.-.-.-.-.-.-.-.-.-X-----------,-,-X-,-,-,-,-.-.-.-.-.-.-.-.-.-.-.-.-X-----
--,-X-.-A-.-<-.-.-.-.-.-.-.-X-,-,-,-,-,-X-------------,-X-.-.-.-.-.-.-.-.-.-.-.-.-.-.-.-.-.-.-.-A-.-.-X-----------,-.-X-.-,-.-,-,-.-.-.-.-.-.-.-.-.-.-.-X-----
--,-X-.-.-.-.-.-.-.-.-.-.-.-X-X-.-,-.-,-,-X-----------,-X-.-.-.-.-.-.-.-.-.-.-.-.-.-.-.-.-.-.-.-.-.-,-X---------,-,-X-,-,-,-,-,-X-.-.-.-.-.-.-.-.-.-.-,-X-----
--,-X-.-.-.-.-.-.-.-.-.-.-.-X-X-,-,-,-,-,-X-,---------,-X-.-.-.-.-.-.-.-.-.-.-.-.-.-.-.-.-.-.-.-.-.-X---------,-,-X-,-,-,-,-,-X-X-.-.-.-.-.-.-.-.-.-.-X-------
----,-X-.-.-.-.-.-.-.-.-.-.-X-,-X-,-,-.-,-,-X-----------,-X-.-.-.-.-.-.-.-.-.-.-.-.-.-.-.-.-.-.-.-,-X---------,-.-X-,-,-.-,-X-,-X-.-.-.-.-.-.-.-.-.-.-X-------
----,-X-.-.-.-.-.-.-.-.-.-.-X---,-X-.-,-,-,-,-X---------,-X-.-.-.-.-.-.-.-.-.-.-.-.-.-.-.-.-A-.-.-X---------,-,-X-.-,-,-,-X-,-,-X-.-.-.-.-.-.-.-.-.-,-X-------
----,-X-.-.-.-.-.-.-.-.-.-.-X-----X-,-,-,-,-,-X-,---------,-X-,-,-,-,-.-.-.-.-.-.-.-.-.-.-.-.-.-,-X-------,-,-X-,-,-,-,-,-X---,-X-.-.-.-.-.-.-.-.-.-X---------
------,-X-.-.-.-.-.-.-.-.-.-X-----,-X-,-,-.-,-,-X---------,-X-,-t.t.t..-.-.-.-.-.-.-.-.-.-.-.-.-X-------,-,-X-,-,-,-,-,-X-----,-X-.-.-.-.-.-.-.-.-.-X---------
------,-X-.-.-.-.-.-.-.-.-.-X-------,-X-.-,-,-,-,-X-------,-X-,-t.t/t..-.-.-.-.-.-.-.-.-.-.-.-.-X-------,-.-X-,-,-.-,-X-------,-X-.-.-.-.-.-.-.-.-.-X---------
------,-X-.-.-.-.-.-A-.-.-.-X---------X-,-,-,-,-,-X-,-------,-X-t.t.t..-.-.-.-.-.-.-.-.-.-.-.-,-X-----,-,-X-.-,-,-,-X-,-------,-X-.-.-.-A-.-.-.-.-,-X---------
--------,-X-.-.-.-.-.-.-.-.-X---------,-X-,-,-.-,-,-X-------,-X-.-.-.-.-.-.-.-.-.-.-.-.-.-.-.-X-----,-,-X-,-,-,-,-,-X---------,-X-.-.-.-.-.-.-.-.-X-----------
--------,-X-.-.-.-.-.-.-W-.-X-----------,-X-.-,-,-,-,-X-----,-X-.-.-.-.-.-.-.-.-.-.-.-.-.-.-,-X-----,-.-X-,-,-,-,-X-----------,-X-.-W-.-.-.-.-.-.-X-----------
--------,-X-.-.-.-.-.-.-.-.-X-------------X-,-,-,-,-,-X-,-----,-X-.-.-.-.-.-.-.-.-.-.-.-.-.-X-,-,-,-,-X-.-,-.-,-X-------------,-X-.-.-.-.-.-.-.-,-X-----------
----------,-X-.-.-.-.-.-.-.-X-------------,-X-,-,-.-,-,-X-,-,-,-X-.-.-.-.-.-.-.-.-.-.-.-.-.-X-,-X-X-X-,-,-,-,-X-,-------------,-X-.-.-.-.-.-.-.-X-------------
----------,-X-.-.-.-.-.-.-,-X---------------,-X-.-,-,-,-.-X-,-X-.-.-.-.-.-.-.-.-.-.-.-.-.-.-.-X-X-,-,-,-,-,-,-X---------------,-X-.-.-.-.-.-.-.-X-------------
----------,-X-.-.-.-.-.-,-,-X-,---------------X-,-,-,-,-.-,-X-.-.-W-.-.-.-.-.-.-.-.-.-.-.-.-A-.-,-X-.-,-,-,-X-----------------,-X-.-.-.-.-.-.-.-X-------------
------------,-X-.-.-.-.-,-.-.-X-,-,-----------,-X-,-,-.-.-,-.-.-.-.-.-.-.-.-.-.-.-.-.-.-.-.-.-.-.-,-,-.-.-X-X-,-,-,-,-----,-,-X-X-,-.-.-.-.-.-,-X-------------
------------,-X-.-.-.-,-,-.-.-.-X-X-,-----------,-X-.-.-,-,-.-.-.-.-.-.-.-.-.-.-.-.-.-.-.-.-.-.-.-.-,-,-,-.-.-X-X.X-X-,-,-X-X-.-.-,-,-.-.-.-.-X---------------
------------,-X-.-.-.-,-.-.-.-.-.-.-X-,-----------,-X-,-,-.-.-.-.-.-.-.-.-.-.-.-.-.-.-.-.-.-.-.-.-.-.-.-,-X-.-.-t..-X-X-X-.-.-.-.-.-,-,-.-.-.-X---------------
------------,-X-.-.-,-,-.-.-.-.-.-.-.-X-,---------,-,-X-.-.-.-.-.-.-.-.-.-.-.-.-.-.-.-.-.-.-.-.-.-.-.-.-.-,-X-X-X.X-X-.-.-.-.-.-.-.-.-,-,-.-.-X---------------
--------------,-X-.-,-.-.-.-.-.-.-.-.-.-X-,-,-----,-X-.-.-.-.-.-.-.-.-.-.-.-.-.-.-.-.-.-.-.-.-.-.-.-.-.-.-.-.-X-,-X-.-.-.-.-.-.-.-.-.-.-,-,-,-X---------------
--------------,-X-,-,-.-.-.-.-.-.-.-.-.-.-X-X-,-,-,-X-.-.-.-.-.-.-.-.-.-.-.-.-.-.-.-.-.-.-.-.-.-.-.-.-.-.-.-.-,-X-.-.-.-.-.-.-.-.-.-.-.-.-,-X-----------------
--------------,-X-,-.-.-.-.-.-.-.-.-.-.-.-.-.-X-,-X-.-.-.-.-.-.-.-.-.-.-.-.-.-.-.-.-.-.-.-.-.-.-.-.-.-.-.-.-W-,-.-.-.-.-.-.-.-.-.-.-.-.-,-,-X-----------------
----------------,-X-.-.-.-.-.-.-.-.-.-.-.-.-.-.-X-.-.-.-.-.-.-.-.-.-.-.-.-.-.-.-.-.-.-.-.-.-.-.-.-.-.-.-.-.-.-,-.-.-.-.-A-.-.-.-.-.-,-,-,-.-X-----------------
----------------,-X-.-.-.-.-.-.-.-.-.-.-.-.-.-.-,-.-A-.-.-.-.-.-.-.-.-.-.-,-,-,-,-,-,-.-.-.-.-.-.-.-.-.-.-.-.-,-.-W-.-.-.-.-.-,-,-,-,-.-.-.-X-----------------
----------------,-X-.-.-.-.-.-.-.-.-.-.-A-.-.-.-,-.-.-.-.-.-.-.-.-.-.-.-.-,-,-,-.-,-,-,-,-.-.-.-.-.-.-.-.-.-.-,-.-.-.-.-,-,-,-,-,-.-.-.-.-.-X-,---------------
----------------,-X-.-.-.-.-,-,-.-.-.-.-.-.-.-W-,-.-.-.-.-.-.-.-.-.-.-.-.-,-,-,-,-,-,-,-,-.-.-.-.-.-.-.-.-.-.-,-.-.-,-,-,-,-,-.-.-.-.-W-,-,-,-X---------------
----------------,-X-.-.-.-.-,-,-.-,-,-.-.-.-.-.-,-.-.-.-.-.-.-.-.-.-.-.-.-,-.-,-,-,-,-,-,-.-.-.-.-.-.-.-.-.-.-,-X-X-X-,-,-.-.-.-.-.-.-,-t/t/t/X---------------
----------------,-X-,-,-,-A-.-.-.-,-,-,-,-.-.-.-,-.-.-.-.-.-.-.-.-.-.-.-.-,-,-,-,-,-.-.-,-.-.-.-.-.-.-.-.-.-.-,-X-X-X-X-,-.-.-<-.-.-.-,-t/H-t/X---------------
----------------,-X-t.t.t..-.-.-.-.-.-,-,-.-X-.-,-.-.-.-.-.-.-.-.-.-.-.-.-,-,-,-,-,-,-.-,-.-.-.-.-.-.-.-.-.-.-,-.-.-.-.-,-,-,-,-.-.-.-,-t/t/t/X---------------
----------------,-X-t.H-t..-.-.-.-.-<-.-.-X-X-X-,-.-.-.-.-.-.-.-.-.-.-.-.-,-,-W-,-.-,-,-,-.-.-.-.-.-.-.-.-.-.-,-.-.-.-.-.-.-,-,-,-,-.-A-.-.-X-,---------------
----------------,-X-t.t.t..-.-.-.-.-.-.-.-.-.-.-,-.-.-.-.-.-.-.-.-.-.-.-.-.-.-.-,-,-,-.-.-.-.-.-.-.-.-.-.-.-.-,-.-.-.-.-.-.-.-.-,-,-,-,-,-.-X-----------------
----------------,-X-.-.-.-W-,-.-.-.-.-.-.-.-.-.-,-.-.-.-.-.-.-.-.-.-.-.-.-.-.-.-.-.-.-.-.-.-.-.-.-.-.-.-.-.-.-,-.-W-.-.-.-.-.-.-.-.-,-,-,-,-X-----------------
----------------,-X-,-,-,-,-,-.-.-.-.-.-.-.-.-.-,-.-.-.-.-.-.-.-.-.-.-.-.-.-.-.-.-.-.-.-.-.-.-.-.-.-.-.-.-.-.-,-.-.-.-.-A-.-.-.-.-.-.-.-,-,-X-----------------
----------------,-X-.-,-,-.-.-.-.-.-.-.-.-.-.-W-,-.-.-.-.-.-.-.-.-.-.-.-.-.-.-.-.-.-.-.-.-.-.-.-.-.-.-.-.-.-A-,-.-.-.-.-.-.-.-.-.-.-.-.-,-,-X-----------------
----------------,-X-,-.-.-.-.-.-.-.-.-.-A-.-.-.-,-.-.-.-.-.-.-.-.-.-.-.-.-.-.-.-.-.-.-.-.-.-.-.-.-.-.-.-.-.-.-,-X-.-.-.-.-.-.-.-.-.-.-,-,-.-X-,---------------
----------------,-X-.-.-.-.-.-.-.-.-.-.-.-.-.-.-,-.-W-.-.-.-.-.-.-.-.-.-.-.-.-.-.-.-.-.-.-.-.-.-.-.-.-.-.-.-,-X-,-X-X-.-.-.-.-.-.-.-,-,-.-.-.-X---------------
--------------,-,-X-.-.-.-.-.-.-.-.-.-.-.-.-.-,-X-.-.-.-.-.-.-.-.-.-.-.-.-.-.-.-.-.-.-.-.-.-.-.-.-.-.-.-,-,-X-------,-X-X-.-.-.-.-,-,-.-.-.-.-X---------------
--------------,-X-,-,-.-.-.-.-.-.-.-.-.-.-,-X-X-,-X-.-.-.-.-.-.-.-.-.-.-.-.-.-.-.-.-.-.-.-.-.-.-.-.-.-,-,-X-----------,-,-X-.-.-,-,-.-.-.-.-.-X---------------
--------------,-X-.-,-,-.-.-.-.-.-.-.-.-,-X-X-X-X/X-X-,-,-.-.-.-.-.-.-.-.-.-.-.-.-.-.-.-.-.-.-.-.-.-,-,-,-X-,-------------,-X-X-,-.-.-.-.-.-.-X-,-------------
------------,-,-X-.-.-,-.-.-.-.-.-.-,-,-X-,-X-,-t/.-X-X-,-,-,-.-.-.-.-.-.-.-.-.-.-.-.-.-.-.-.-.-.-.-,-,-.-,-X-----------------,-X-.-.-.-.-.-.-.-X-------------
------------,-X-.-.-.-,-,-.-.-.-.-,-X-X---,-X-X-X/X-,-,-.-.-,-,-.-.-.-.-.-.-.-.-.-.-.-.-.-.-.-.-.-,-,-,-,-,-X-,---------------,-X-.-.-.-.-.-.-.-X-------------
------------,-X-.-.-.-.-,-.-.-.-,-X-----------,-,-X-.-,-,-.-,-,-.-.-.-.-.-.-.-.-.-.-.-.-.-.-.-.-.-,-X-.-,-,-,-X-,-------------,-X-.-.-.-.-.-.-.-X-------------
----------,-,-X-.-.-.-.-,-,-,-X-X-----------,-,-X-,-,-.-,-,-,-X-.-.-.-A-.-.-.-.-.-.-.-.-.-.-.-W-.-X-X-,-,-,-.-,-X-------------,-X-.-.-.-.-.-.-.-X-,-----------
----------,-X-.-.-.-.-.-.-,-X-------------,-,-X-,-,-,-,-,-X-X-X-X-X-.-.-.-.-.-.-.-.-.-.-.-.-.-.-,-X-X-,-,-,-,-,-X-,-----------,-X-.-.-.-.-.-.-.-.-X-----------
----------,-X-.-.-.-.-.-.-.-X-------------,-,-X-.-,-,-,-X-,-------,-X-.-.-.-.-.-.-.-.-.-.-.-.-.-X---,-X-,-.-,-,-,-X-,---------,-X-.-W-.-.-.-.-.-.-X-----------
--------,-,-X-.-.-.-.-.-.-.-X-----------,-,-X-,-,-.-,-,-X-------,-,-X-.-.-.-.-.-.-.-.-.-.-.-.-.-X-,---,-X-,-,-,-.-,-X---------,-X-.-.-.-.-.-.-.-.-X-,---------
--------,-X-.-.-.-.-.-.-.-.-X---------,-,-X-,-,-,-,-.-X---------,-X-.-.-.-.-.-.-.-.-.-.-.-.-.-.-.-X---,-X-,-,-,-,-,-X-,-------,-X-.-.-.-A-.-.-.-.-.-X---------
--------,-X-.-.-.-.-.-.-.-.-X---------,-,-X-.-,-,-,-X-,-------,-,-X-.-.-.-.-.-.-.-.-.-.-.-,-,-,-,-X-----,-X-,-.-,-.-,-X-------,-X-.-.-.-.-.-.-.-.-.-X---------
------,-,-X-.-.-.-.-.-.-W-.-X-------,-,-X-,-,-.-,-,-X---------,-X-.-.-.-.-.-.-.-.-.-.-.-.-,-t/t/t/X-,-----,-X-,-,-,-,-X-,-----,-X-.-.-.-.-.-.-.-.-.-X---------
------,-X-.-.-.-.-.-.-.-.-.-X-----,-,-X-,-.-,-,-.-X-----------,-X-.-.-.-.-.-.-.-.-.-.-.-.-,-t/t.t/.-X-----,-X-,-.-,-,-,-X-,---,-X-.-.-.-.-.-.-.-.-.-X-,-------
------,-X-.-.-.-.-.-A-.-.-.-X-----,-,-X-,-.-.-,-X-,---------,-,-X-.-.-.-.-.-.-.-.-.-.-.-.-,-t/t/t/.-X-------,-X-,-,-,-.-,-X---,-X-.-.-.-.-.-.-.-.-.-.-X-------
----,-,-X-.-.-.-.-.-.-.-.-.-X---,-,-X-,-,-,-.-,-X-----------,-X-.-.-.-.-.-.-.-.-.-.-.-.-.-.-.-.-.-.-X-,-----,-X-,-,-,-,-,-X-,-,-X-.-.-.-.-.-.-.-.-.-.-X-------
----,-X-.-.-.-.-.-.-.-.-.-.-X-,-,-X-,-,-,-,-,-X-----------,-,-X-.-.-A-.-.-.-.-.-.-.-.-.-.-.-.-.-.-.-.-X-------,-X-,-.-,-,-,-X-,-X-.-.-.-.-.-.-.-.-.-.-X-,-----
----,-X-.-.-.-.-.-.-.-.-.-.-X-,-,-X-,-.-,-,-X-------------,-X-.-.-.-.-.-.-.-.-.-.-.-.-.-.-.-.-.-.-.-.-X-,-------,-X-,-,-,-.-,-X-X-.-.-.-.-.-.-.-.-.-.-.-X-----
--,-,-X-.-.-.-.-.-.-.-.-.-.-X-,-X-,-,-,-.-X-------------,-,-X-.-.-.-.-.-.-.-.-.-.-.-.-.-.-.-.-.-.-.-.-.-X-------,-X-,-,-.-.-,-X-X-.-.-.-.-.-.-.-.-.-.-.-X-----
--,-X-.-.-.-.-.-.-.-.-.-.-.-X-X-,-,-,-,-X-,-------------,-X-.-.-.-.-.-.-.-.-.-.-,-,-.-.-.-.-.-.-.-.-.-.-X---------,-X-,-.-.-,-.-X-.-.-.-.-.-.-.-.-.-.-.-X-----
--,-X-.-A-.-<-.-.-.-.-.-.-.-X-X-,-.-,-,-X---------------,-X-.-.-A-.-.-.-.-.-.-,-,-,-,-.-.-.-.-.-.-.-.-.-X-,---------,-X-.-,-,-.-X-.-.-.-.-.-.-.-<-.-.-.-X-,---
,-,-X-.-.-.-.-.-.-.-.-.-.-.-X-,-,-,-,-X---------------,-,-X-.-.-.-.-.-.-.-.-,-,-,-,-,-,-.-.-.-.-.-.-.-.-.-X-----------X-,-,-.-.-.-.-.-.-.-.-.-.-.-.-A-.-.-X---
,-X-.-.-.-.-A-.-.-.-.-.-.-.-.-,-,-,-X-----------------,-X-.-.-.-.-.-.-.-,-,-,-,-,-,-,-,-,-.-.-.-.-.-.-.-.-X-----------,-X-.-.-.-.-.-.-.-.-.-.-.-.-.-.-.-.-X---
,-X-.-.-.-.-.-.-.-.-.-.-.-.-.-.-,-.-X---------------,-,-X-.-.-.-.-.-.-,-,-,-,-,-,-,-,-,-,-,-.-.-.-.-.-.-.-X-,---------,-X-.-.-.-.-.-.-.-.-.-.-.-A-.-.-.-.-X---
,-X-.-.-.-.-.-.-.-.-.-.-.-.-.-.-,-X-,---------------,-X-.-.-A-.-.-.-,-,-,-,-.-,-,-,-,-,-,-,-,-.-.-.-.-.-.-.-X-----------,-X-X-X-X-X-.-.-.-.-.-.-.-.-.-.-.-X-,-
X-.-.-.-.-.-.-.-,-X-X-X-X-X-X-X-X-X-----------------,-X-.-.-.-.-.-,-,-,-,-.-,-,-,-,-,-,-,-,-,-,-.-.-.-.-.-.-X---------------------,-X-X-X-X-X-X-X-X-.-.-.-.-X-
X-X-X-X-X-X-X-X-X---------------------------------,-,-X-.-.-.-.-,-,-,-,-.-,-,-,-,-,-,-,-,-,-,-,-,-.-.-.-.-.-X-,-----------------------------------,-X-X-X-X-X-
--------------------------------------------------,-X-.-.-.-,-,-,-,-,-,-,-,-,-,-,-,-,-,-,-,-,-,-,-,-.-.-.-.-.-X-----------------------------------------------
------------------------------------------------,-,-X-.-A-,-,-,-,-.-,-,-,-,-,-,-,-,-,-,-,-,-,-,-,-,-,-.-.-.-.-X-----------------------------------------------
------------------------------------------------,-X-.-.-,-,-,-,-.-,-,-,-,-,-,-,-,-,-,-,-,-,-,-,-,-,-,-,-.-.-.-X-,---------------------------------------------
------------------------------------------------,-X-.-.-,-.-,-.-,-,-,-,-,-,-,-.-,-,-,-,-,-,-,-,-,-,-,-,-,-.-.-.-X---------------------------------------------
----------------------------------------------,-,-X-.-.-,-,-,-,-,-,-,-,-,-,-,-,-,-.-,-,-,-,-,-,-,-,-,-,-,-,-.-.-X---------------------------------------------
----------------------------------------------,-X-.-A-.-.-,-.-,-,-,-,-,-,-,-,-,-.-W-,-,-,-,-,-,-,-,-.-,-.-,-.-.-X-,-------------------------------------------
--------------------------------------------,-,-X-.-.-.-.-,-,-,-.-,-,-,-,-,-,-,-,-,-.-,-,-,-,-,-,-,-,-,-,-,-.-.-.-X-------------------------------------------
--------------------------------------------,-X-.-.-.-.-.-.-,-,-,-,-,-,-,-,-,-.-.-.-,-,-,-,-,-,-,-.-,-.-,-.-.-.-.-X-,-----------------------------------------
------------------------------------------,-,-X-.-.-.-.-.-.-,-.-,-,-,-,-,-,-,-,-,-,-,-,-,-,-,-,-,-,-,-,-,-.-.-.-.-.-X-----------------------------------------
------------------------------------------,-X-.-A-.-.-.-.-.-,-,-,-,-,-,-,-,-,-,-.-.-,-,-,-,-,-,-.-,-.-,-.-.-.-.-.-.-X-----------------------------------------
------------------------------------------,-X-.-.-.-.-.-.-.-.-,-.-,-,-,-.-,-.-,-,-,-,-,-,-,-,-,-,-,-,-,-.-.-.-.-.-.-X-,---------------------------------------
----------------------------------------,-,-X-.-.-.-.-.-.-.-.-,-.-,-.-,-,-,-,-,-,-,-,-,-,-,-,-.-,-.-,-.-.-.-.-.-.-.-.-X---------------------------------------
----------------------------------------,-X-.-.-.-.-.-.-.-.-.-,-,-,-,-,-,-.-.-.-,-,-,-,-,-,-,-,-,-,-,-.-.-.-.-.-.-.-.-X---------------------------------------
--------------------------------------,-,-X-.-.-.-.-.-.-.-.-.-.-,-.-,-,-,-,-,-,-,-.-,-,-,-,-.-,-.-,-.-.-.-.-.-.-.-.-.-X-,-------------------------------------
--------------------------------------,-X-.-H-.-.-.-.-.-.-.-.-.-,-,-,-.-,-.-,-,-,-,-,-.-.-.-,-,-,-,-.-.-.-.-.-.-.-.-H-.-X-------------------------------------
--------------------------------------,-X-.-.-.-.-.-.-.-.-.-A-.-.-,-,-,-,-,-,-.-.-.-.-,-,-,-,-.-,-.-.-.-.-.-.-.-.-.-.-,-X-------------------------------------
----------------------------------------,-X-X-.-.-.-.-.-.-.-.-.-.-,-.-,-.-.-,-,-,-,-,-,-.-.-.-,-,-.-.-.-.-.-.-.-.-,-X-X---------------------------------------
--------------------------------------------,-X-X-.-.-.-.-.-.-.-.-,-,-,-,-,-,-.-.-.-.-,-,-,-,-,-.-.-.-.-.-.-.-,-X-X-------------------------------------------
------------------------------------------------,-X-.-.-.-.-.-.-.-.-,-.-.-,-,-,-,-,-,-,-.-.-.-.-.-.-.-.-.-.-,-X-----------------------------------------------
--------------------------------------------------,-X-X-.-.-.-.-.-.-,-,-,-,-.-.-.-.-.-.-.-.-.-.-.-.-.-.-,-X-X-------------------------------------------------
------------------------------------------------------,-X-X-.-.-.-.-.-.-.-.-.-.-.-.-.-.-.-.-.-.-.-.-,-X-X-----------------------------------------------------
----------------------------------------------------------,-X-.-.-.-.-.-.-.-.-.-.-.-.-.-.-.-.-.-.-,-X---------------------------------------------------------
------------------------------------------------------------,-X-X-.-.-.-.-.-.-.-.-.-.-.-.-.-.-,-X-X-----------------------------------------------------------
----------------------------------------------------------------,-X-X-.-.-.-.-.-H-.-.-.-.-,-X-X---------------------------------------------------------------
--------------------------------------------------------------------,-X-.-.-.-.-.-.-.-.-,-X-------------------------------------------------------------------
----------------------------------------------------------------------,-X-X-,-,-,-.-,-X-X---------------------------------------------------------------------
--------------------------------------------------------------------------,-X->->-X-X-------------------------------------------------------------------------
------------------------------------------------------------------------------,-X-----------------------------------------------------------------------------
