----------------,-X/X/X/------------------------------------------------------------------------------------------------------------------------
--,-,-----------,-X/t/X/------------------------------------------------------------------------------------------------------------------------
,-,-X-,---------,-X-.-X-------------------------------------------------------------------------------------------------------------------------
,-X-.-X-------,-,-X5W-X-------------------------------------------------------------------------------------------------------------------------
X-.-.-X-,-,-,-,-X-.-.5X-------------------------------------------------------------------------------------------------------------------------
,-X-.-.-X-X-X-X-.-+-,-X5------------------------------------------------------------------------------------------------------------------------
--,-X-+-.-.-.-.-+-,-X---------------------------------------------------------------------------------------------------------------------------
--,-X-.-.-W-A-.-A-X-----------------------------------------------------------------------------------------------------------------------------
--,-X-.-.-.-.-.-.-X-----------------------------------------------------------------------------------------------------------------------------
--,-X-.-A-.-A-.-A-X-----------------------------------------------------------------------------------------------------------------------------
--,-X-.-.-.-.-.-A-X-----------------------------------------------------------------------------------------------------------------------------
--,-X-.-.-.-A-.-.-X-----------------------------------------------------------------------------------------------------------------------------
--,-X-.-.-.-.-.-,-X-----------------------------------------------------------------------------------------------------------------------------
--,-,-X-X-.-.-.-X-,-----------------------------------------------------------------------------------------------------------------------------
--,-X-X-X-X-.-X-X-X-X-X-X-X-X-X-X-X-X-X-X-X-X-X-X-X-X-X-X-X-X-X-X-X-X-X-X-X-X-X-X-X-X-X-X-X-X-X-X-X---------------------------------------------
----,-X-.-.-.-.-,-,-.-.-.-.-.-.-,-------------------------------------------------------------H---X---------------------------------------------
------,-X-.-.-,-,-,-.-.-.-.-W-.-,-----------------------------------------------------------------X---------------------------------------------
--------,-X-.-,---,-.-,-,-,-,-.-,-----------------------------------------------------------------X---------------------------------------------
--------,-X-A-,---,-.-,-.~.~,~.-,-------------------------------------------,-,-,-,-,-,-,-,-,-,-,-X-,-,-,-,-,-,-,-,-,-,-,-,-,-------------------
--------,-X-.-,-,-,-.-,-.~.~,~.-,-,-------------------------------------,-,-,-.-.-.-.-.-.-.-.-.-.-X-X-X-X-X-X-X-X-X-X-X-X-X-X-------------------
--------,-X-.-.-.-.-.-,-.~.~,~.-.-,-------------,-,-,-,-------------,-,-,-.-.-.-.-.-<-.-.-.-.-.-.-+-+-.-.-.-.-.-.-.-<-.-.-.-X-------------------
--------,-X-.-.-.-.-.-,-.~.~,~.-.-,-------------,-t3t3t3----------,-,-.-.-.-,-,-,-,-,-,-,-,-,-,-,-X-X-X-X-X-X-X-X-X-X-X-X-.-X-------------------
--------,-X-.-.-.-.-,-,-.~.~,~.-.-,-------------,-t3.-t3----------,-.-.-.-,-,-.~.~.~.~.~.~.~.~.~.~X~,-X-X-------------,-X-.-X-------------------
--------,-X-X-X-X-X-X-X~.~.~,~.-.-,-------------,-t3t3t3--------,-,-.-.-,-,-.~.~.~.~.~.~.~.~.~.~.~X-X.X.X.------------,-X-.-X-------------------
--------------------,-X~.~.~,~.-.-,-----------------------------,-.-.-,-,-.~.~.~.~.~.~.~.~.~.~.~.~+-,...X.------------,-X-.-X-------------------
--------------------,-X~.~.~,~.-.-,---------------------------,-,-.-.-,-.~.~.~.~.~.~.~.~.~.~.~.~.~X-X.X.X.------------,-X-.-X-------------------
--------------------,-X~.~.~,~,-.-,-,-------------------------,-.-.-,-,~.~.~.~.~.~.~.~.~.~.~.~.~.~X~------------------,-X-.-X-------------------
--------------------,-X~.~.~.~,-<-.-,-----------------------,-,-.-,-,-.~.~.~.~.~.~.~.~.~.~.~.~.~,~X~------------------,-X-.-X-------------------
----------,-,-,-,-,-,-X~.~.~.~,-.-.-,-----------------------,-.-A-,-.~.~.~.~.~.~.~.~.~.~.~.~.~.~X~--------------------,-X-.-X-------------------
----------,-X-X-X-X-X-X~.~.~.~,~.-.-,---------------------,-,-.-,-,~.~.~.~.~.~.~.~.~.~.~.~.~.~,~X---------------------,-X-.-X-------------------
----------,-X-.-.-.-X-X~.~.~.~,~.-.-,---------------------,-.-.-,-.~.~.~.~.~.~.~.~.~.~.~.~.~.~X~----------------------,-X-A-X-------------------
----------,-X-.-.-.-.-X~.~.~.~,~.-.-,-------------------,-,-.-,-,~.~.~.~.~.~.~.~.~.~.~.~.~,~,~X-,-,-,-,-,-,-,-,-,-,-,-,-X-.-X-------------------
----------,-X-.-.-.-.-X-.~.~.~,~.-.-,-------------------,-.-.-,-.~.~.~.~.~.~.~.~.~.~.~.~,~,~X-X-X-X-X-X-X-X-X-X-X-X-X-X-X-.-X-------------------
----------,-X-.-.-H-.-.-.~.~.~,~.-.-,-----------------,-,-.-.-,-.~.~.~.~.~H~.~.~.~.~.~.~,~.~.-.-.-.-.-.-.-.-.-.-.-.-.-,-X-.-X-------------------
----------,-X-,-.-.-.-X-.~.~.~,~.-.-,-----------------,-.-.-.-,-.~.~.~.~.~.~.~.~.~.~.~,~,~.-.-t0.-.-.-.-.-.-.-.-.-.-.-,-X-.-X-------------------
----------,-X3t3.-.-.-X~.~.~.~,~.-.-,-----------------,-.-.-.-,-.~.~.~.~.~.~.~.~.~.~.~,~.~.-.-.-.-.-.-.-.-.-.-.-.-.-.-,-X-.-X-------------------
----------,-X3t3.-.-X-X~.~.~.~,~.-.-,-----------------,-.-.-.-,-.~.~.~.~.~.~.~.~.~.~,~,~.-.-.-.-.-.-.-.-.-.-.-.-.-.-.-,-X-.-X-------------------
----------,-X-X-X-X-X-X~.~.~.~,~W-.-,-----------------,-.-.-.-,-.~.~.~.~.~.~.~.~.~.~,~.-.-.-.-.-.-.-.-.-.-.-.-.-.-.-.-,-X-.-X-------------------
--------------------,-X~.~.~.~,~.-.-,-----------------,-.-W-.-,-.~.~.~.~.~.~.~.~.~.~,~.-.-.-.-.-.-.-.-.-.-.-.-.-.-.-.-,-X-.-X-------------------
--------------------,-X~.~.~.~,~.-.-,-----------------,-.-.-.-,-.~.~.~.~.~.~.~.~.~.~,~.-.-.-.-.-.-.-.-.-.-.-.-.-.-.-.-,-X-.-X-------------------
--------------------,-X~.~.~.~,~.-.-,-----------------,-.-.-.-,-.~.~.~.~.~.~.~.~.~.~,~.-.-.-.-.-.-.-.-.-.-.-.-.-.-.-.-,-X-.-X-------------------
--------------------,-X~.~.~.~,~.-.-,-,-------------,-,-.-.-.-,-,~.~.~.~.~.~.~.~.~.~,~.-.-.-.-.-.-.-.-.-.-.-.-.-.-.-.-,-X-.-X-------------------
--------------------,-X~X~X~,~,~.-.-.-,-----------,-,-.-.-.-.-.-,-,~.~.~.~.~.~.~.~.~,~.-.-.-.-.-.-.-.-.-.-.-.-.-.-.-.-,-X-.-X-------------------
--------,-,-,-,-,-,-,-,-,-X-.-.-.-.-.-,-,-,-,-,-,-,-.-.-.-.-.-.-.-,-,~.~.~.~.~.~.~.~,~.-.-.-,-,-,-,-,-,-.-.-.-.-.-.-.-,-X-.-X-------------------
--------,->-X-X-X-X-X-X-X-X-.-.-.-.-.-.-.-.-.-.-.-.-.-.-.-.-.-.-.-.-,-,~,~,~,~,~,~,~,~,-,-,-,-,-,-,-.-,-.-.-.-.-.-.-.-,-X-.-X-------------------
--------,->-.-.-.-.-.-.-.-.-.-.-.-.-.-.-.-.-.-.-.-.-.-.-.-.-.-.-.-.-.-.-.-.-.-.-.-.-.-,-,-,-,-,-,-,-.-,-.-.-.-.-.-.-.-,-X-.-X-------------------
--------,->-.-.-.-.-.-.-.-.-.-.-.-.-<-.-.-.-.-.-.-.-.-.-.-W-.-.-.-.-,-,-,-,-,-,-,-,-,-,-,-,-,-,-,-,-.-,-<-.-.-.-.-.-.-,-X-.-X-------------------
--------,->-.-.-.-.-.-.-.-.-.-t3.-.-.-X-X-X-X-X-X-X-.-.-.-.-.-.-.-,-,-.~.~.~.~.~.~.~,~.-.-.-,-,-,-,-,-,-.-.-.-.-.-.-.-,-X-.-X-------------------
--------,->-X-X-X-X-X-X-X-X-.-.-.-.-.-X-----------,-X-.-.-.-.-<-,-,-.~.~.~.~.~.~.~.~,~.-.-.-.-.-.-.-.-.-.-.-.-.-.-.-.-,-X-.-X-------------------
------------------------,-X-.-.-.-.-.-X-------------,-X-.-.-.-,-,-.~.~.~.~.~.~.~.~.~,~.-.-.-.-.-.-.-.-.-.-.-.-.-.-.-.-,-X-<-X-------------------
------------------------,-X-.-.-.-.-.-X---------------,-X-.-.-,-.~.~.~.~.~.~.~.~.~.~,~.-.-.-.-.-.-.-.-.-.-.-.-.-.-.-.-,-X-.-X-------------------
----------------,-,-,-,-,-X-.-.-.-.-.-X-,-,-,-,-,-,---,-X-.-.-,-.~.~.~.~.~.~.~.~.~.~,~.-.-.-.-.-.-.-.-.-.-.-.-.-.-.-.-,-X-.-X-------------------
----------------,-X~X~X~X~X-,-,-,-,-,-X-X~X~X-X-X-X~--,-X-W-.-,-.~.~.~.~.~.~.~.~.~.~,~.-.-.-.-.-.-.-.-.-.-.-.-.-.-.-.-,-X-.-X-------------------
----------------,-X~.~.~.~.~.~.~.~.~.~,~,~,~,6,6,6X~--,-X-.-.-,-.~.~.~.~.~.~.~.~.~.~,~.-.-.-.-.-.-.-.-.-.-.-.-.-.-.-.-,-X-.-X-------------------
----------------,-X~.~.~.~.~.~.~.~.~.~,~.-,-.~.~.~X~--,-X-.-.-,-.~.~.~.~.~.~.~.~.~.~,~.-.-.-.-.-.-.-.-.-.-.-.-.-.-.-.-,-X-.-X-------------------
----------------,-X~.~.~.~.~.~.~.~.~.~,~t/,-.~.~.~X~--,-X-.-.-,-.~.~.~.~.~.~.~.~.~,~,~.-.-.-.-.-.-.-.-.-.-.-.-.-.-.-.-,-X-.-X-------------------
----------------,-X~.~.~.~.~.~.~.~.~.~,~.1,1.~.~.~X~--,-X-.-.-,-.~.~.~.~.~.~.~.~.~,~.~.-.-.-.-.-.-.-.-.-.-.-.-.-.-.-.-,-X-.-X-,-,-,-,-,-,-,-,-,-
----------------,-X~.~.~.~.~.~.~.~.~.~,~.1,1.~.~.~X~,-,-X-.-.-,-,~.~.~.~.~.~.~.~.~,~,-,-,-,-,-,-,-,-,-,-.-.-.-.-.-.-.-,-X-+-X-X-X-X-X-X-X-X-X-X-
----------------,-X~.~.~.~.~.~.~.~.~,~,~,1,1,~.~.~.~X---,-X-.-.-,~.~.~.~.~.~.~.~.~X-X-X-X-X-X-X-X-X-.-X-X-X-X-X-X-X-X-X-X-.-.-W-.-.-.-.-.-.-.-X-
----------------,-X~.~.~.~.~.~.~.~.~,~.-.1.1,-.~.~.~X-,-,-X-.-.-,~,~,~,~,~,~,~,~+~,-+-,-,-,-,-,-,-,-W-X-,-,-,-,-,-,-,-,-X-.-.-.-.-.-A-.-.-.-.-X-
----------------,-X~.~.~.~.~.~.~.~.~,~.-.-.-,-.~.~.~XVX0X-X-.-.-.-.-.-.-.-.-.-.-X-X-X-X-X-X-X-X-X-X-X-X-X-X-X-X-X-X-X-X-X-.-.-.-.-.-.-.-.-A-.-X-
----------------,-X~.~.~.~.~.~.~.~.~,~.-.-.-,-.~.~.~+Vt0X-X-.-.-.-.-.-.-.-.-.-.-.-+-.-.-.-.-.-.-.-.-A-.-.-.-.-.-.-.-.-.-.-.-.-.-A-.-.-.-.-.-.-X-
----------------,-X~.~.~.~.~.~.~.~.~,~.-.-.-,-.~.~.~XVX0X-X-X-X-X-,-,-,-,-,-,-,-X-X-X-X-X-X-X-X-X-X-X-X-X-X-X-X-X-X-X-X-X-.-.-.-.-.-A-.-.-.-.-X-
----------------,-X~.~.~.~.~.~.~.~.~,~,-,-,-,-.~.~.~X~,-,-,-,-,-,-X---------------X-----,-,-,-,-,-,-,-,-,-,-,-,-,-,-,-,-X-.-.-.-.-.-.-.-.-.-.-X-
----------------,-X~.~.~.~.~.~.~.~.~.~.~.~.~.~.~.~.~X~X~X~X~X~X~X~,-X---------------X---,-X-X-X-X-X-X-X-X-X-X-X-X-X-X-X-X-.-A-.-.-.-.-A-.-.-.-X-
----------------,-X~.~.~.~.~.~.~.~.~.~.~.~.~.~.~.~.~.~.~.~.~.~.~.~X---X---,-,-,-,-----X-,-X-.-.-.-.-.-.-.-.-.-.-.-.-.-X-X-.-.-.-.-,-,-,-.-A-.-X-
----------------,-X~.~.~.~.~.~.~.~.~.~.~.~.~.~.~.~.~.~.~.~.~.~.~.~X~,---X-X-X3t3X3X-X-X-X-X-.-.-.-.-.-.-.-.-.-.-.-.-.-X-X-.-.-.-A-,-t4t4.-.-.-X-
----------------,-X~.~.~.~.~.~.~.~.~.~.~.~.~.~.~.~.~.~.~.~.~.~.~.~.~X-----,-X-X-X-------,-X-.-H-.-.-.-.-.-A-.-.-.-A-.-X-X-X-X-X-X-X-X4X4X-X-X-X-
----------------,-X~.~.~.~.~.~.~.~.~.~.~.~.~.~.~.~.~.~.~.~.~.~.~.~.~X~,-,-,-,-,-,-,-,-,-,-X-.-.-.-.-.-.-.-.-.-.-.-.-.-X-------------------------
----------------,-X~.~.~.~.~.~.~.~.~.~.~.~H~.~.~.~.~.~.~.~.~.~.~.~.~.~X~X~X~X~X~X~X~X~X~X~X-.-.-.-.-H-.-.-.-.-.-.-.-.-X-------------------------
----------------,-X~.~.~.~.~.~.~.~.~.~.~.~.~.~.~.~.~.~.~.~.~.~.~.~.~.~.~.~.~.~.~.~.~.~.~X~X-.-.-.-.-.-.-.-.-.-.-.-.-.-X-------------------------
----------------,-X~.~.~.~.~.~.~.~.~.~.~.~.~.~.~.~.~.~.~.~.~.~.~.~.~.~.~.~.~.~.~.~.~.~.~X~X-.-.-.-.-.-.-.-.-.-A-.-.-.-X-------------------------
----------------,-X~.~.~.~.~.~.~.~.~.~.~.~.~.~.~.~.~.~.~.~.~.~.~.~.~.~.~,~,~,~,~,~,~,~,~X~X-.-.-.-.-.-.-.-.-.-.-.-.-.-X-------------------------
----------------,-X~.~.~.~.~.~.~.~.~.~.~.~.~.~.~.~.~.~.~.~.~.~.~.~.~.~.~,~,-,-,-,-,-,-.-X-X-.-A-.-.-A-.-.-.-.-.-.-.-.-X-------------------------
----------------,-X~.~.~.~.~.~.~.~.~.~.~.~.~.~.~.~.~.~.~.~.~.~.~.~.~.~.~,~,-,-,-,-,-,-.-.-.-.-.-.-.-.-.-.-.-.-.-.-.-.-X-------------------------
----------------,-X~.~.~.~.~.~.~.~.~.~.~.~.~.~.~.~.~.~.~.~.~.~.~.~.~.~.~,~,-,-,-,-,-,-.-.-.-.-.-.-.-.-.-.-.-.-.-.-.-.-X-------------------------
----------------,-X~.~.~.~.~.~.~.~.~.~.~.~.~.~.~.~.~.~.~.~.~.~.~.~.~.~.~,~,-,-,-,-,-,-,-X-X-.-A-.-.-.-.-.-.-.-.-.-.-.-X-------------------------
----------------,-X~.~.~W~.~.~.~.~.~.~.~.~.~.~.~.~.~.~.~.~.~.~.~.~.~.~.~.~.~.~.~.~.~.~.~X~X-.-.-.-.-.-.-.-A-.-.-.-<-.-X-------------------------
----------------,-X~.~.~.~.~.~.~.~.~.~.~.~.~.~.~.~.~.~.~.~.~.~.~.~.~.~.~.~.~.~.~.~.~H~.~X~X-.-.-.-.-.-.-.-.-.-.-.-.-.-X-------------------------
----------------,-X~X~X~X~X~X~X~X~X~X~X~X~X~X~X~X~X~X~X~X~X~X~X~X~X~X~X~X~X~X~X~X~X~X~X~X~X-.-.-.-.-.-.-.-.-.-.-A-.-.-X-------------------------
----------------------------------------------------------------------------------------,-X-.-.-.-A-.-.-.-.-.-.-.-.-.-X-------------------------
----------------------------------------------------------------------------------------,-X-.-.-.-.-.-.-.-.-.-.-.-.-.-X-------------------------
----------------------------------------------------------------------------------------,-X-,-,-,-.-.-.-A-.-.-.-.-t4.-X-------------------------
----------------------------------------------------------------------------------------,-X-t0t0t0.-.-.-.-.-.-.-.-.-.-X-------------------------
----------------------------------------------------------------------------------------,-X-t0.-t0.-.-.-.-.-.-W-.-.-W-X-------------------------
----------------------------------------------------------------------------------------,-X-t0t0t0.-.-.-.-.-.-.-.-.-.-X-------------------------
----------------------------------------------------------------------------------------,-X-X-X-X-X-X-X-X-X-X-X-X-X-X-X-------------------------
