------------------------------------------------------------------,-X-X-X-X-X-X-X-X-X-X-X-X-X-X-X-X-X-X-X-X-X-X-X-X-X-X-X-X-X-X-X-X-X-X-X-X-X-X-X-----------------------------------------------------------------------------------------------
------------------------------------------------------------------,-X-.-.-.-.-.-.-.-.-.-.-.-.-.-.-.-.-.-.-.-.-.-.-.-.-.-.-.-.-.-.-.-.-.-.-.-.-.-X-----------------------------------------------------------------------------------------------
------------------------------------------------------------------,-X-.-.-.-W-.-.-.-.-.-.-.-.-.-.-.-,-,-,-.-.-.-.-.-.-.-.-.-.-.-.-.-.-.-.-.-.-.-X-----------------------------------------------------------------------------------------------
------------------------------------------------------------------,-X-.-.-.-.-.-W-.-.-.-.-.-.-.-,-,-,-.-,-,-,-.-.-.-.-.-.-.-.-.-.-.-.-.-.-.-.-.-X-----------------------------------------------------------------------------------------------
------------------------------------------------------------------,-X-.-.-.-.-.-.-.-.-.-.-,-,-,-,-.-.-.-.-.-,-,-,-.-.-.-.-.-.-.-.-.-.-.-.-.-.-.-X-----------------------------------------------------------------------------------------------
------------------------------------------------------------------,-X-.-.-.-.-.-.-.-,-,-,-,-.-.-.-.-,-,-,-.-.-.-,-,-,-.-.-.-.-.-.-.-.-.-.-.-.-.-X-----------------------------------------------------------------------------------------------
------------------------------------------------------------------,-X-.-.-.-.-.-,-,-,-.-.-.-.-,-,-,-,-.-,-,-,-.-.-.-,-,-,-.-.-.-.-.-.-.-.-.-.-.-X-----------------------------------------------------------------------------------------------
------------------------------------------------------------------,-X-.-.-,-,-,-,-.-.-.-.-,-,-,-.-.-.-.-.-.-,-,-,-.-.-.-,-,-.-.-.-.-.-.-.-.-.-.-X-----------------------------------------------------------------------------------------------
------------------------------------------------------------------,-X-.-,-,-.-.-.-.-,-,-,-,-.-.-.-.-.-W-.-.-.-.-,-,-,-.-.-,-,-,-.-.-.-.-.-.-.-.-X-----------------------------------------------------------------------------------------------
------------------------------------------------------------------,-X-.-,-.-.-,-,-,-,-.-.-.-.-.-.-.-.-.-.-.-.-E-.-.-,-,-.-.-.-,-,-,-.-.-.-.-.-.-X-----------------------------------------------------------------------------------------------
------------------------------------------------------------------,-X-.-,-.-,-,-.-.-.-.-.-.-.-.-.-.-.-.-.-.-.-.-.-.-.-,-,-,-.-.-.-,-,-,-.-.-.-.-X-----------------------------------------------------------------------------------------------
------------------------------------------------------------------,-X-.-,-.-,-.-.-.-.-.-.-.-.-.-.-.-.-.-.-.-.-.-.-.-.-.-.-,-,-,-.-.-.-,-,-,-.-.-X-----------------------------------------------------------------------------------------------
------------------------------------------------------------------,-X-.-,-.-,-.-E-.-.-.-.-.-.-.-.-.-.-.-.-.-.-.-.-.-.-.-.-.-.-,-,-,-.-.-.-,-.-.-X-----------------------------------------------------------------------------------------------
------------------------------------------------------------------,-X-.-,-.-,-.-.-.-.-.-.-.-.-.-.-.-.-.-.-.-.-.-.-.-.-.-.-.-.-.-.-,-.-.-.-,-.-.-X-----------------------------------------------------------------------------------------------
------------------------------------------------------------------,-X-.-,-.-,-.-.-.-.-.-.-.-.-.-.-.-.-.-.-.-.-.-.-.-.-.-.-.-.-.-E-,-.-.-.-,-.-.-X-----------------------------------------------------------------------------------------------
------------------------------------------------------------------,-X-.-,-.-,-.-.-.-.-.-.-.-.-.-.-.-.-.-.-.-.-.-.-.-.-.-.-.-.-.-.-,-.-.-.-,-.-.-X-----------------------------------------------------------------------------------------------
------------------------------------------------------------------,-X-.-,-.-,-.-.-.-.-.-.-.-.-.-.-.-.-.-.-.-.-.-.-.-.-.-.-.-.-.-.-,-.-.-.-,-.-.-X-----------------------------------------------------------------------------------------------
------------------------------------------------------------------,-X-.-,-.-,-.-.-.-.-.-.-.-.-.-.-.-.-.-.-.-.-.-.-.-.-.-.-.-.-.-.-,-.-.-.-,-.-.-X-----------------------------------------------------------------------------------------------
------------------------------------------------------------------,-X-.-,-.-,-.-.-.-.-.-.-.-.-.-.-.-.-.-.-.-.-.-.-.-.-.-.-.-.-.-.-,-.-.-.-,-.-.-X-----------------------------------------------------------------------------------------------
------------------------------------------------------------------,-X-.-,-.-,-.-.-.-.-.-.-.-.-.-.-.-.-.-.-.-.-.-.-.-.-.-.-.-.-.-.-,-.-.-.-,-.-.-X-----------------------------------------------------------------------------------------------
------------------------------------------------------------------,-X-.-,-.-,-.-.-.-.-.-.-.-.-.-.-.-.-.-.-.-.-.-.-.-.-.-.-.-.-.-.-,-.-.-.-,-W-.-X-----------------------------------------------------------------------------------------------
------------------------------------------------------------------,-X-.-,-.-,-.-.-.-.-.-.-.-.-.-.-.-.-.-.-.-.-.-.-.-.-.-.-.-.-.-.-,-.-.-.-,-.-.-X-----------------------------------------------------------------------------------------------
------------------------------------------------------------------,-X-.-,-.-,-.-.-.-.-.-.-.-.-.-.-.-.-,-,-,-.-.-.-.-.-.-.-.-.-.-.-,-.-.-.-,-.-.-X-----------------------------------------------------------------------------------------------
----------,-,-,-,-,-,---------------------------------------------,-X-.-,-.-,-.-.-.-.-.-.-.-.-.-.-.-,-,-.-,-,-,-,-.-.-.-.-.-.-.-.-,-.-.-.-,-.-.-X-----------------------------------------------------------------------------------------------
----------,-X-X-X-X-X---------------------------------------------,-X-,-,-.-,-.-.-.-.-.-.-.-.-.-.-,-,-.-.-.-.-.-,-,-.-.-.-.-.-.-.-,-,-.-.-,-,-.-X-----------------------------------------------------------------------------------------------
--------,-,-X-.-.-.-X---------------------------------------------,-X-,-.-.-,-E-.-,-,-,-,-,-,-.-,-,-.-.-<-.-.-.-.-W-.-.-.-.-.-.-.-.-,-,-.-.-,-,-X-----------------------------------------------------------------------------------------------
--------,-X-.-.-.-.-X---------------------------------------------,-X-X-X-X-X-X-X-X-X-.-.-.-X-X-X-.-.-.-.-.-X-X-X-X-X-X-X-X-X-X-X-X-X-X-X-X-X-X-X-----------------------------------------------------------------------------------------------
--------,-X-.-.-.-.-X-------------------------------------------------------------,-X-.-.-.-X-,-X-.-.-.-.-.-X---------,-,-,-,---------------------------------------,-,-------------------------------------------------------------------------
--------,-X-.-.-.-.-X-------------------------------------------------------------,-X-,-,-,-X-,-X-.-.-.-.-.-X-------,-,-X-X-X-,-,-,-,-,---------------------------,-,-X-,-----------------------------------------------------------------------
------,-,-X-.-.-.-.-X-------------------------------------------------------------,-X-E-.-.-X-,-X-.-.-.-.-.-X-----,-,-X-.-.-.-X-X-X-X-X-,-,-,-------------------,-,-X-.-X-,---------------------------------------------------------------------
------,-X-.-.-.-.-,-X-------------------------------------------------------------,-X-,-,-,-X-,-X-W-.-.-.-.-X---,-,-X-.-.-.-.-.-.-.-.-.-X-X-X-----------------,-,-X-.-.-.-X-,-------------------------------------------------------------------
------,-X-.-.-.-.-X---------------------------------------,-,-,-,-,-,-,-,-,-,-,-,-,-X-,-,-,-X-,-X-.-.-.-.-.-X-,-,-X-.-,-,-,-,-.-.-.-.-.-.-H-X-----------------,-X-.-W-.-.-.-X-------------------------------------------------------------------
----,-,-X-.-.-.-.-X---------------------------------------,-X-X-X-X-X-X-X-X-X-X-X-X-X-.-.-.-X-X-X-.-.-.-.-.-X-,-X-.-.-,-.-.-,-.-.-.-.-,-,-,-X-----------------,-X-.-H-.-.-.-X-------------------------------------------------------------------
----,-X-.-.-.-.-.-X---------------------------------------,-X-.-.-.-,-.-,-.-,-.-,-.-.-.-.-.-,-.-.-.-.-.-.-.-X-,-X-.-.-,-.-A-,-.-.-,-,-,-,-,-X-----------------,-X-X-.-.-.-,-X-----------,-,-,-,-,-,-,-,-,-,-,-,-,-,-,-,-,-----------------------
----,-X-.-.-.-.-.-X---------------------------------------,-X-.-.-.-,-.-,-.-,-.-,-.-.-.-.-.-,-.-.-.-.-.-.-.-X-X-X-,-.-,-,-,-,-.-,-,-,-,-,-,-X---------------------,-X-.-X-X---------,-,-,-X-X-X-X-X-X-X-X-X-X-X-X-X-X-X-X-,---------------------
--,-,-X-.-.-.-.-.-X---------------------------------------,-X-,-,-,-,-.-,-.-,-.-,-.-.-.-.-.-,-.-.-.-.-.-.-.-.-<-.-,-.-.-.-.-,-,-,-,-,-,-,-,-X-,-,-,-,-,-,-,-,-,-,-,-X-.-X-------,-,-,-X-X-.-.-.-.-.-.-.-.-.-.-.-.-.-.-.-.-X-,-------------------
--,-X-.-.-.-.-.-.-X---------------------------------------,-X-.-.-.-X-X-X-X-X-X-X-X-X-X-X-X-X-X-X-X-X-X-X-.-.-,-.-,-.-.-,-,-,-,-,-,-,-,-,-,-X-X-X-X-X-X-X-X-X-X-X-X-X-.-X---,-,-,-X-X-.-.-.-.-.-.-.-.-.-.-.-.-.-.-.-.-.-.-.-X-,-----------------
--,-X-.-.-.-.-.-,-X-,-,-----------------------------------,-X-.-E-.-X-,-,-,-,-,-,-,-,-,---------,-,-,-,-X-.-.-<-.-,-.-,-,-,-,-,-,-,-E-,-,-,-.-.-.-.-.-.-.-.-.-.-.-.-.-.-X-,-,-X-X-.-.-.-.-.-.-.-.-.-.-.-.-.-.-.-.-.-.-.-.-.-.-X-,---------------
--,-X-.-.-.-.-.-,-.-X-X-,-,-------------------------------,-X-.-.-.-X-X-X-X-X-X-X-X-X-X---------,-X/X/X/X-.-.-,-.-,-.-,-,-,-,-,-,-,-,-,-,-,-.-.-.-.-<-.-.-.-.-.-.-.-X-X-X-,-X-.-.-.-.-.-.-.-.-.-.-.-.-.-.-.-.-.-.-.-.-.-.-.-.-.-X---------------
,-,-X-.-.-.-.-,-,-.-.-.-X-X-,-,---------------------------,-X-.-.-.-.-.-.-.-.-.-.-E-.-X---------,-X-.-X-X-.-.-<-.-,-.-.-,-,-,-,-,-,-,-,-,-,-.-.-.-.-.-.-.-.-.-.-.-.-X-----,-X-W-.-.-.-.-.-.-.-.-.-.-.-,-,-,-,-,-,-,-,-.-.-.-.-.-X---------------
,-X-.-.-.-.-,-,-.-.-.-.-.-.-X-X-,-,-----------------------,-X-X-X-X-X-X-X-X-X-.-.-.-.-X---------,-X-.-X-,-X-.-,-.-,-.-.-.-.-,-,-,-,-,-,-E-,-X-X-X-X-X-X-X-X-X-.-.-.-X-----,-X-.-.-.-.-.-.-.-.-.-.-.-.-,-.-.-,-,-.-.-,-.-.-.-.-.-X---------------
,-X-.-.-.-,-,-.-.-.-.-.-.-.-.-.-X-X-,-,-----------------------------------,-X-.-.-.-.-X---------,-X-.-X---X-.-<-,-,-.-,-,-,-,-.-,-,-,-,-,-,-X-,-,-,-,-,-,-,-X-.-.-.-X-----,-X-.-.-.-.-.-.-.-.-.-.-.-.-,-.-E-,-,-.-E-,-.-.-.-.-.-X---------------
,-X-.-.-.-,-.-.-.-.-.-.-.-.-.-.-.-,-X-,-,-,-------------------------------,-X-.-.-.-.-X---------,-X-.2X---,-X-X-X-.-.-,-.-.-,-.-.-,-,-,-,-,-X-,-X-X-X-X-X-,-X-.-.-.-X-----,-X-.-.-.-.-.-.-.-.-.-.-.-.-,-.-.-.-.-.-.-,-.-.-.-.-.-X---------------
X-.-.-.-,-,-.-.-.-.-.-.-.-.-.-.-.-,-.-X-X-,-,-,-,-,-,-,-,-,-,-,-,-,-,-,-,-,-X-,-,-,-,-X---------,-X2.2X2------,-X-.-.-,-.-.-,-.-.-.-.-,-,-,-X-,-X-A-.-.-X-,-X-.-.-.-X-,-,-,-X-.-.-.-.-.-.-.-.-.-.-.-.-,-.-.-.-W-.-.-,-.-.-.-.-.-X---------------
X-.-.-.-,-.-.-.-.-.-.-.-.-.-.-.-,-,-.-.-.-X-X-X-X-X-X-X-X-X-X-X-X-X-X-X-X-X-X-.-.-.-.-X---------,-X2.2X2------,-X-.-.-,-,-,-,-.-.-.-.-.-.-,-X-,-X-.-.-.-X-X-X-.-.-.-X-X-X-X-X-.-.-.-.-.-.-.-.-.-.-.-.-,-,-,-,-,-,-,-,-.-.-.-.-.-X---------------
X-.-.-.-,-.-.-.-.-.-.-.-.-.-.-.-,-.-.-.-.-,-.-.-.-.-.-.-.-.-.-.-.-.-.-.-.-.-,-,-.-.-.-X---------,-X2.2X2--------,-X-.-.-.-.-.-.-.-.-.-.-.-.-X-,-X-.-.-.-.-.-,-.-.-E-.-.-.-.-+-.-.-.-.-.-.-.-.-.-.-.-.-.-.-.-.-.-.-.-.-.-.-.-.-.-X---------------
X-.-.-.-,-.-.-.-.-.-.-.-.-.-.-,-,-.-.-.-,-,-.-.-.-.-.-.-.-.-.-.-.-.-.-.-.-.-.-,-,-.-.-X-------,-,-X2,2X2,-,-------,-X-.-.-.-.-.-.-.-.-,-X-X-X-,-X-.-.-.-X-X-X-.-.-.-.-.-.-.-+-.-.-.-.-.-.-.-.-.-W-.-.-E-.-.-.-E-.-.-.-.-.-.-.-.-X---------------
X-.-.-.-,-.-.-.-.-.-.-.-.-.-,-,-.-.-.-.-,-.-.-.-.-.-.-.-.-.-.-.-.-.-.-E-.-E-.-.-,-,-.-X---,-,-,-X-.-.-.-X-X-,-,-----,-X-.-.-,-X-X-X-X-X-------,-X-A-.-.-X-,-X-E-.-.-.-.-.-.-+-.-.-.-.-.-.-.-.-.-.-.-.-,-,-,-,-,-,-,-,-.-.-.-.-.-X---------------
X-.-.-.-,-.-.-.-.-.-.-.-.-.-,-.-.-.-.-.-,-.-.-.-.-.-.-.-.-.-.-.-.-.-.-.-.-.-.-E-.-,-,-X-,-,-X-X-.-.-.-.-.-.-X-X-,-,---,-X-X-X-----------------,-X-X-X-X-X-,-X-.-.-.-X-X-X-X-X-.-.-.-.-.-.-.-.-.-.-.-.-,-.1.1.3.-.-.-,-.-.-.-.-.-X---------------
X-.-.-.-,-.-.-.-.-.-.-.-.-,-,-.-.-.-.-.-,-.-.-.-.-.-.-.-.-.-.-.-.-.-.-.-.-.-.-.-.-.-,-X-,-X-.-.-.-.-.-.-.-.-.-.-X-X-,-,-,-,-,-,-,-,-,-,-,-,-,-----------,-,-X-.-.-.-X-----,-X-.-.-.-.-.-.-.-.-.-.-.-.-,-.-.-.3.-.-.-,-.-.-.-.-.-X---------------
X-.-.-.-,-.-.-.-.-.-.-.-.-,-.-.-.-.-.-,-,-.-.-.-.-.-.-.-.-.-.-.-.-.-.-.-.-E-.-.-E-.-W-X-X-.-.-.-.-.-.-.-.-.-.-.-.-.-X-X-X-X-X-X-X-X-X-X-X-X-X-X-X-X-X-X-X-X-X-.-E-.-X-----,-X-.-.-.-.-.-.-.-.-.-.-.-.-,-.-.-,3,-.-.-,-.-.-.-.-.-X---------------
X-.-.-.-,-.-.-.-.-.-.-.-,-,-.-.-.-.-.-,-.-.-.-.-.-.-.-.-.-.-.-.-.-.-.-.-.-.-.-.-.-.-.-X-X-.-.-.-.-,-,-,-,-.-.-.-.-.-.-,-.-.-.-E-.-.-.-.-.-E-,-,-,-,-,-.-.-.-.-.-.-.-X-----,-X-.-.-.-.-.-.-.-.-.-.-.-.-,-.-E-,-,-.-E-,-.-.-.-.-.-X---------------
X-.-.-.-,-.-.-.-.-.-.-,-,-.-.-.-.-.-.-,-.-.-.-.-.-.-.-.-.-.-.-.-.-.-.-.-.-.-.-.-.-.-A-X-X-.-.-.-.-,-.3.3,3.-.-.-.-.-.-,-,-.-.-.-.-<-.-.-.-.-,-,-.-.-.-.-.-.-.-.-.-.-X-----,-X-.-.-.-.-.-.-.-.-.-.-.-.-,-,-,-,-,-,-,-,-.-.-.-.-.-X---------------
X-.-.-.-,-.-.-.-.-.-.-,-.-.-.-.-.-.-.-,-.-.-.-.-.-.-.-.-.-.-.-.-.-.-.-.-.-.-.-.-.-.-.-X-X-.-.-.-.-,-.3.-,3.-.-.-.-.-.-.-,-.-.-.-.-.-.-E-.-.-.-.-.-.-.-.-.-.-.-.-.-E-X-----,-X-.-.-.-.-.-.-.-.-.-.-.-.-.-.-.-.-.-.-.-.-.-.-.-.-.-X---------------
X-.-.-.-,-.-.-.-.-.-,-,-.-.-.-.-.-.-.-,-.-.-.-.-.-.-.-.-.-.-.-.-.-.-.-.-.-.-.-.-.-.-.-X-X-.-.-.-.-,-,3,3,3.-.-.-.-.-.-.-X-X-X-X-X-X-X-X-X-X-X-X-X-X-X-X-X-X-X-.-.-.-X-----,-X-.-.-.-.-.-.-.-.-.-.-.-.-.-.-.-.-.-.-.-.-.-.-.-.-.-X-,-,-----------
X-.-.-.-,-.-.-.-.-.-,-.-.-.-.-.-.-.-,-,-.-.-.-.-.-.-.-.-.-.-.-.-.-.-.-.-.-.-.-.-.-.-.-X-X-.-.-.-.-.-.-.-.-.-.-.-.-.-.-.-X---------------------------------,-X-.-.-.-X-----,-X-X-.-.-.-.-.-.-.-.-.-.-.-.-.-.-.-.-.-.-.-.-.-.-.-.-+QX-X-,---------
X-.-.-.-,-.-.-.-.-,-,-.-.-.-.-.-.-.-,-.-.-.-.-.-.-.-.-.-.-.-.-.-.-.-.-.-.-.-.-.-.-.-.-X-X-.-.-.-.-.-.-.-.-.-,-,-.-.-.-.-X-------------------------------,-,-X-.-.-.-X-,-------,-X-X-X-.-.-.-.-.-.-.-.-.-.-.-.-.-.-.-.-.-.-.-.-+Q+-,-.-X-,-------
X-.-.-.-,-.-.-.-.-,-.-.-.-.-.-.-.-.-,-.-.-.-.-.-.-.-.-.-.-.-.-.-.-.-.-.-.-.-.-.-.-.-.-X-X-.-.-.-.-.-.-.-.-,-,-,-,-.-.-.-X-----------------------------,-,-X-.-.-.-.-X-,-,-----------,-X-X-.-.-.-.-.-.-.-.-.-.-.-.-.-.-.-.-.-+Q+-H-,-.-.-X-,-----
X-.-.-.-,-.-.-.-.-,-,-.-.-.-.-.-.-.-,-.-.-.-.-.-.-.-.-.-.-.-.-.-.-.-.-.-.-.-.-.-.-.-.-X-X-.-.-.-.-.-.-.-.-,-.-.-,-.-.-.-X-----------------------------,-X-.-.-.-.-.-.-X-X---------------,-X-X-X-X-X-X-X-X-X-X-X-X-X-X-X-X-+Q+-.-.-,-.-.-.-X-,---
X-.-.-.-,-.-.-.-.-.-,-.-.-.-.-.-.-.-,-.-.-.-.-.-.-.-.-.-.-.-.-.-.-.-.-.-.-.-.-.-.-.-.-X-X-.-.-.-.-.-.-.-,-,-.-.-,-.-.-.-X-----------------------------,-X-.-.-.-.-.-.-.-X-----------------------------------------------,-X-H-,-H-,-.-.-.-.-X-,-
X-.-.-.-,-.-.-.-.-.-,-.-.-.-.-.-.-.-,-.-.-.-.-.-.-.-.-.-.-.-.-.-.-.-.-.-.-.-.-.-.-.-.-X-X-,-X-X-.-.-,-,-,-.-.-.-,-.-.-.-X-----------------------------,-X-.-.-.-.-.-.-,-X-----------------------------------------------,-X-.-.-.-.-.-.-.-,-,-X-
X-.-.-.-,-.-.-.-.-.-,-.-.-.-.-.-.-.-,-,-.-.-.-.-.-.-.-.-.-.-.-.-.-.-.-.-.-.-.-.-.-.-.-X-X-X-,-X-,-,-,-.-.-.-.-.-,-.-.-.-X-------------------------------,-X-.-.-.-.-,-X---------------------------------------------------,-X-.-.-.-.-.-,-,-.-X-
X-.-.-.-,-.-.-.-.-.-,-,-.-.-.-.-.-.-.-,-.-.-.-.-.-.-.-.-.-.-.-.-.-.-.-.-.-.-.-.-.-.-,-,-X-X-X-X-,-.-.-.-.-W-.-,-,-.-.-.-X---------------------------------,-X-.-.-,-X-------------------------------------------------------,-X-.-.-.-,-,-.-.-X-
X-.-.-.-,-.-.-.-.-.-.-,-.-.-.-.-.-.-.-,-.-.-.-.-.-.-.-.-.-.-.-.-.-.-.-.-.-.-.-.-.-,-,-.-,-.-,-.-,-,-.-.-.-.-,-,-.-.-.-.-X-------------------------------,-,-,-XS+SXS,-,-------------------------------------------------------,-X-.-,-,-.-.-.-X-
X-.-.-.-,-.-.-.-.-.-.-,-.-.-.-.-.-.-.-,-.-.-.-.-.-.-.-.-.-.-.-.-.-.-.-.-.-.-.-.-,-,-.-.-,-.-,-.-.-,-.-.-.-,-,-.-.-.-.-.-X-------------------------------,-X3X-XS+SXSX-X3--------------------------------------------------------,-X-,-.-.-.-.-X-
X-.-.-.-,-.-.-.-.-.-.-,-.-.-.-.-.-.-.-,-.-.-.-.-.-.-.-.-.-.-.-.-.-.-.-.-.-.-.-,-,-.-.-.-,-.-,-.-.-,-.-,-,-,-.-.-.-.-.-.-X-------------------------------,-X3.-.-.-.-.-X3----,-,-,-,-,-,-,-,-,-,-,---------------------------------,-X-.-.-.-.-X-
X-.-.-.-,-.-.-.-.-.-.-,-,-.-.-.-.-.-.-,-.-.-.-.-.-.-.-.-.-.-.-.-.-.-.-.-.-.-,-,-,-,-,-.-,-.-,-.-.-,-,-,-.-.-.-.-.-.-.-.-X-------------------------------,-X3.-.-W-.-,-X3----,-X-X-X-X-X-X-X-X-X-X---------------------------------,-X-.-.-.-.-X-
X-.-.-.-,-.-.-.-.-.-.-.-,-.-.-.-.-.-.-,-.-.-.-.-.-.-.-.-.-.-.-.-.-.-.-.-.-,-,-,-,-.-,-,-,-.-,-.-,-,-,-,-,-,-,-.-.-.-.-.-X-----,-,-,-,---------------------,-X-.-.-,-X-------,-X-.-.-.-.-.-.-.-.-X-,-,-,-,-,-,---------------------,-X-.-.-.-.-X-
X-.-.-.-,-.-.-.-.-.-.-.-,-.-.-.-.-.-.-,-.-.-.-.-.-.-.-.-.-.-.-.-.-.-.-.-.-,-.-,-.-.-,-,-X-X-X-X-,-,-,-,-.-.-,-.-.-.-.-.-X---,-,-X-X-X-,---------------------,-X-,-X---------,-X-.-X-X-X-X-X-X-.-X-X-X-X-X-X-X-,-,-,---------------,-X-.-.-.-.-X-
X-.-.-.-,-.-.-.-.-.-.-.-,-.-.-.-.-.-.-,-,-.-.-.-.-.-.-.-.-.-.-.-.-.-.-.-.-,-.-,-.-.-,-XOXOX-,-X-,-.-.-,-.-.-,-.-.-.-.-.-X-,-,-.-X-H-.-X-,---------------------,-X-----------,-X-.-X-------,-X-.-+-.-+-W-.-+-.-X-X-X-,-------------,-X-,-,-,-,-X-
X-.-.-.-,-.-.-.-.-.-.-.-,-,-.-.-.-.-.-.-,-.-.-.-.-.-.-.-.-.-.-.-.-.-.-.-.-,-.-,-,-.-,-+O+OX-,-X-.-.-.-,-,-,-,-.-.-.-.-.-X-X-X-X-.-.-.-.->-----------------------------------,-X-.-X-------,-X-.-+-.-+-.-+-.-+-.-.-.-X-,---------,-,-X-.-.-.-.-X-
X-.-.-.-,-.-.-.-.-.-.-.-.-,-.-.-.-.-.-.-,-.-.-.-.-.-.-.-.-.-.-.-.-.-.-.-.-,-.-.-,-,-,-XOXO.-X-X-.-.-.-.-.-.-.-.-.-.-.-.-.-.-+-+-.-H-E-A->-----------------------------------,-X-.-X-------,-X-.-+-.-+-+-.-+-.-.-.-.-.-X-,-----,-,-X-.-.-.-.-,-X-
X-.-.-.-,-.-.-.-.-.-.-.-.-,-.-.-.-.-.-.-,-.-.-.-.-.-.-.-.-.-.-.-.-.-.-.-.-,-.-.-.-,-,-X-X-.-.-.-.-.-.-.-.-.-.-.-.-.-.-,-X-X-X-X-.-.-.-,->-----------------------------------,-X-.-X-------,-X-X-X-X-X-.-+-.-.-.-.-.-.-.-X-,-,-,-X-.-.-.-.-.-X---
X-.-.-.-,-.-.-.-.-.-.-.-.-,-.-.-.-.-.-.-,-.-.-.-.-.-.-.-.-.-.-.-.-.-.-.-.-,-.-.-.-.-.-X-X-.-.-.-.-.-.-.-.-.-.-.-.-.-.-X-------X-.-H-,-X-------------------------------------,-X-.-X-----------------,-X-.-.-.-.-.-.-.-.-.-X-X-X-.-.-.-.-.-,-X---
X-.-.-.-,-.-.-.-.-.-.-.-.-,-,-.-.-.-.-.-,-,-.-.-.-.-.-.-.-.-.-.-.-.-.-.-.-,-,-.-.-.-.-X-X-X-.-.-.-.-.-.-.-.-.-.-.-.-,-X-------,-X-X-X---------------------------------------,-X-.-X-----------------,-X-.-.-.-.-.-.-.-.-.-,-.-,-.-.-.-.-.-X-----
X-.-.-.-,-.-.-.-.-.-.-.-.-.-,-.-.-.-.-.-.-,-,-,-.-.-.-.-.-.-.-.-.-.-.-.-.-.-,-,-,-.-.-X---,-X-X-.-.-.-.-.-.-.-.-.-.-X-------------------------------------------------------,-X-.-X-----------------,-X-.-.-.-.-.-.-.-.-.-,-.-,-.-.-.-.-,-X-----
X-.-.-.-,-.-.-.-.-.-.-.-.-.-,-.-.-.-.-.-.-.-.-,-,-,-.-.-.-.-.-.-.-.-.-.-.-.-.-.-,-,-,-X-------,-X-+-X-X-X-X-X-X-X-.-X-------------------------------------------------------,-X-.-X-----------------,-X-.-.-.-.-.-.-.-.-.-,-.-,-.-.-,-X-X-------
X-.-.-.-,-.-.-.-.-.-.-.-.-.-,-.-.-.-.-.-.-.-.-.-.-,-,-.-.-.-.-.-.-.-.-.-.-.-.-.-.-.-,-X-,-----,-X-+-X-,-,-,-,-,-X-.-X-------------------------------------------------------,-X-.-X-----------------,-X-.-.-.-.-A-.-.-.-.-,-.-,-.-,-X-----------
X-.-.-.-,-.-.-.-.-.-.-.-.-.-,-,-.-.-.-.-.-.-.-.-.-.-,-,-,-.-.-.-.-.-.-.-.-.-.-.-.-.-.-.-X-,---,-X-.-X-X-X-X-X-X-X-E-X-------------------------------------------------------,-X-.-X-----------------,-X-.-.-.-.-.-.-.-.-.-,-.-,-X-X-------------
X-.-.-.-,-.-.-.-.-.-.-.-.-.-.-,-,-.-.-.-.-.-.-.-.-.-.-.-,-,-.-.-.-.-.-.-.-.-.-.-.-.-W-.-.-X-,-,-X-E-.-.-H-.-.-,-,-A-X-,-,-,-,-,-,-,-,-,-,-,-,-,-,-,-,-,-,-,-,-,-,-,-,-,-,-,-,-X-.-X---------------,-,-X-.-.-.-.-.-.-.-.-,-X-X-X-----------------
X-.-.-.-,-,-,-.-.-.-.-.-.-.-.-.-,-,-,-.-.-.-.-.-.-.-.-.-.-,-,-,-.-.-.-.-.-.-.-.-.-.-.-.-,-,-X-,-X-X-X-X-X-X-X-X-X-,-X-X-X-X-X-X-X-X-X-X-X-X-X-X-X-X-X-X-X-X-X-X-X-X-X-X-X-X-X-X-.-X---------------,-X-.-+-.-.-.-.-.-.-,-X-----------------------
X-.-.-.-.-.-,-,-,-.-.-.-.-.-.-.-.-.-,-,-,-.-.-.-.-.-.-.-.-.-.-,-,-,-.-.-.-.-.-.-.-.-,-,-,-.-.-X---------------,-X-,-,-.-.-.-.-.-.-.-.-.-.-.-.-.-.-.-.-.-.-.-.-.-.-.-.-.-.-.-.-.-.-X---------------,-X-+-.-+-.-.-.-.-,-X-------------------------
X-.-.-.-.-.-.-.-,-,-,-.-.-.-.-.-.-.-.-.-,-,-,-.-.-.-.-.-.-.-.-.-.-,-,-,-,-,-,-,-,-,-,-.-.-.-.-X-,-------------,-X-.-X-X-X-X-X-X-X-X-X-X-X-X-X-X-X-X-X-X-X-X-X-X-X-X-X-X-X-X-X-X-X-X---------------,-X-.-+-.-+-.-.-,-X---------------------------
X-.-.-.-.-.-.-.-.-.-,-,-,-.-.-.-.-.-.-.-.-.-,-,-,-.-.-.-.-.-.-.-.-.-.-.-.-.-.-.-.-.-.-.-.-.-,-,-X-,-----------,-X-.-X-----------------------------------------------------------------------------,-X-W-.-+-,-X-X-X-----------------------------
X-.-.-.-.-.-.-.-.-.-.-.-,-,-,-.-.-.-.-.-.-.-.-.-,-,-,-.-.-.-.-.-.-.-.-.-.-.-.-.-.-.-.-.-.-,-,-.-.-X-,---------,-X-X-X-----------------------------------------------------------------------------,-X-X-X-X-X-----------------------------------
X-.-.-.-.-.-.-.-.-.-.-.-.-.-,-,-,-.-.-.-.-.-.-.-.-.-,-,-,-.-.-.-.-.-.-.-.-.-.-.-.-.-.-,-,-,-.-.-.-.-X-,-----------------------------------------------------------------------------------------------------------------------------------------
X-.-.-.-.-.-.-.-.-.-.-.-.-.-.-.-,-,-,-.-.-.-.-.-.-.-.-.-,-,-,-.-.-.-.-.-.-.-.-.-.-.-,-,-.-.-.-.-.-.-.-X-,---------------------------------------------------------------------------------------------------------------------------------------
X-.-.-.-.-.-.-.-.-.-.-.-.-.-.-.-.-.-,-,-,-.-.-.-.-.-.-.-.-.-,-,-,-.-.-.-.-,-,-,-,-,-,-.-.-.-.-.-.-.-.-.-X-,-------------------------------------------------------------------------------------------------------------------------------------
,-X-X-.-.-.-.-.-.-.-.-.-.-.-.-.-.-.-.-.-,-,-,-.-.-.-.-.-.-.-.-.-,-,-,-,-,-,-.-.-.-.-.-.-.-.-.-.-.-.-.-.-.-X-------------------------------------------------------------------------------------------------------------------------------------
----,-X-X-.-.-.-.-.-.-.-.-.-.-.-.-.-.-.-.-.-,-,-,-.-.-.-.-.-.-.-.-.-.-.-.-.-.-.-.-.-.-.-.-.-.-.-.-.-.-.-.-X-,-----------------------------------------------------------------------------------------------------------------------------------
--------,-X-X-.-.-.-.-.-.-.-.-.-.-.-.-.-.-.-.-.-,-,-,-.-.-.-.-.-.-.-.-.-.-.-.-.-.-.-.-.-.-.-.-.-.-.-.-.-.-.-X-,---------------------------------------------------------------------------------------------------------------------------------
------------,-X-X-.-.-.-.-.-.-.-.-.-.-.-.-.-.-.-.-.-,-,-,-.-.-.-.-.-.-.-.-.-.-.-.-.-.-.-.-.-.-.-.-.-.-.-.-.-.-X-,-------------------------------------------------------------------------------------------------------------------------------
----------------,-X-X-.-.-.-.-.-.-.-.-.-.-.-.-.-.-.-.-.-,-,-,-.-.-.-.-.-.-.-.-.-.-.-.-.-.-.-.-.-.-.-.-.-.-.-.-.-X-,-----------------------------------------------------------------------------------------------------------------------------
--------------------,-X-.-.-.-.-.-.-.-.-.-.-.-.-.-.-.-.-.-.-,-,-,-,-,-,-,-,-,-,-,-,-,-,-,-,-,-,-,-,-,-,-,-,-,-,-,-X-,-,-,-,-,-,-,-,-,-,-,-,-,-,-,-,-,-,-,-,-,-----------------------------------------------------------------------------------
----------------------,-X-X-.-.-.-.-.-.-.-.-.-.-.-.-.-.-.-.-.-.-.-.-.-.-.-.-.-.-.-.-.-.-.-.-.-.-.-.-.-.-.-.-.-.-.-.-X-X-X-X-X-X-X-X-X-X-X-X-X-X-X-X-X-X-X-X-X-----------------------------------------------------------------------------------
--------------------------,-X-X-.-.-.-.-.-.-.-.-.-.-.-.-.-.-.-.-.-.-.-.-.-.-.-.-.-.-.-.-.-.-.-.-.-.-.-.-.-.-.-.-.-.-.-.-.-.-.-.-.-.-.-.-.-.-.-.-.-.-.-.-.-X-------------------------------------------------------------------------------------
------------------------------,-X-X-.-.-.-.-.-.-.-.-.-.-.-.-.-.-.-.-.-.-.-.-.-.-.-.-.-.-.-.-.-.-.-.-.-.-.-.-.-.-.-.-.-.-.-.-.-.-.-.-.-.-.-.-.-.-.-.-.-.-,-X-------------------------------------------------------------------------------------
----------------------------------,-X-X-.-.-.-.-.-.-.-.-.-.-.-.-.-.-.-.-.-.-.-.-.-.-.-.-.-.-.-.-.-.-.-.-.-.-.-.-.-.-.-.-.-.-.-.-.-.-.-.-.-.-.-.-.-.-.-,-X---------------------------------------------------------------------------------------
--------------------------------------,-X-X-.-.-.-.-.-.-.-.-.-.-.-.-.-.-.-.-.-.-.-.-.-.-.-.-.-.-.-.-.-.-.-.-.-.-.-.-.-.-.-.-.-.-.-.-.-.-.-.-.-.-.-.-,-X-----------------------------------------------------------------------------------------
------------------------------------------,-X-.-.-.-.-.-.-.-.-.-.-.-.-.-.-.-.-.-.-.-.-.-.-.-.-.-.-.-.-.-.-.-.-.-.-.-.-.-.-.-.-.-.-.-.-.-.-.-.-.-.-.-X-------------------------------------------------------------------------------------------
--------------------------------------------,-X-X-.-.-.-.-.-.-.-.-.-.-.-.-.-.-.-.-.-.-.-.-.-.-.-.-.-.-.-.-.-.-.-.-.-.-.-.-.-.-.-.-.-.-.-.-.-.-.-.-,-X-------------------------------------------------------------------------------------------
------------------------------------------------,-X-X-.-.-.-.-.-.-.-.-.-.-.-.-.-.-.-.-.-.-.-.-.-.-.-.-.-.-.-.-.-.-.-.-.-.-.-.-.-.-.-.-.-.-.-.-.-,-X---------------------------------------------------------------------------------------------
----------------------------------------------------,-X-X-.-.-.-.-.-.-.-.-.-.-.-.-.-.-.-.-.-.-.-.-.-.-.-.-.-.-.-.-.-.-.-.-.-.-.-.-.-.-.-.-.-.-,-X-----------------------------------------------------------------------------------------------
--------------------------------------------------------,-X-X-.-.-.-.-.-.-.-.-.-.-.-.-.-.-.-.-.-.-.-.-.-.-.-.-.-.-.-.-.-.-.-.-.-.-.-.-.-.-.-.-X-------------------------------------------------------------------------------------------------
------------------------------------------------------------,-X-X-.-.-.-.-.-.-.-.-.-.-.-.-.-.-.-.-.-.-.-.-.-.-.-.-.-.-.-.-.-.-.-.-.-.-.-.-.-,-X-------------------------------------------------------------------------------------------------
----------------------------------------------------------------,-X-X-X-X-X-X-X-X-X-X-X-X-X-X-X-X-X-X-X-X-X-X-X-X-X-X-X-X-X-X-X-X-X-X-X-X-X-X---------------------------------------------------------------------------------------------------
