X-X-X-X-X-X-X-X-X-X-X-X-X-X-X-X-X-X-X-X-X-X-X-X-X-X-X-X-X-X-X-X-X-X-X-X-X-X-X-X-X-X-X-X-X-X-X-X-X-X-X-X-X-X-X-X-X-X-X-X-X-X-X-X-X-X-X-X-X-X-X-X-X-X-X-X-X-X-X-X-X-X-X-X-X-X-X-X-X-X-X-X-X-X-X-X-X-X-X-X-X-X-X-X-X-X-X-X-X-X-X-X-X-X-X-X-X-X-X-X-
X---------------------------------------------------------------------------------------------------------------------------------------------------------------------------------------------------------------------------------------------X-
X---------------------------------------------------------------------------------------------------------------------------------------------------------------------------------------------------------------------------------------------X-
X---------------------------------------------------------------------------------------------------------------------------------------------------------------------------------------------------------------------------------------------X-
X---------------------------------------------------------------------------------------------------------------------------------------------------------------------------------------------------------------------------------------------X-
X---------------------------------------------------------------------------------------------------------------------------------------------------------------------------------------------------------------------------------------------X-
X---------------------------------------------------------------------------------------------------------------------------------------------------------------------------------------------------------------------------------------------X-
X---------------------------------------------------------------------------------------------------------------------------------------------------------------------------------------------------------------------------------------------X-
X---------------------------------------------------------------------------------------------------------------------------------------------------------------------------------------------------------------------------------------------X-
X---------------------------------------------------------------------------------------------------------------------------------------------------------------------------------------------------------------------------------------------X-
X---------------------------------------------------------------------------------------------------------------------------------------------------------------------------------------------------------------------------------------------X-
X---------------------------------------------------------------------------------------------------------------------------------------------------------------------------------------------------------------------------------------------X-
X---------------------------------------------------------------------------------------------------------------------------------------------------------------------------------------------------------------------------------------------X-
X---------------------------------------------------------------------------------------------------------------------------------------------------------------------------------------------------------------------------------------------X-
X---------------------------------------------------------------------------------------------------------------------------------------------------------------------------------------------------------------------------------------------X-
X---------------------------------------------------------------------------------------------------------------------------------------------------------------------------------------------------------------------------------------------X-
X---------------------------------------------------------------------------------------------------------------------------------------------------------------------------------------------------------------------------------------------X-
X---------------------------------------------------------------------------------------------------------------------------------------------------------------------------------------------------------------------------------------------X-
X---------------------------------------------------------------------------------------------------------------------------------------------------------------------------------------------------------------------------------------------X-
X---------------------------------------------------------------------------------------------------------------------------------------------------------------------------------------------------------------------------------------------X-
X-------------------------------------------,-,-,-,-,-,-,-,-,-,-,-,-,-,-,-,-,-,-,-,-,-,-,-,-,-,-,-,-,-,-,-,-,-,-,-,-,-,-,-,-,-,-,-,-,-,-,-,-,-,-,-,-,-,-,-,-,-,-,-,-,-,-,-,-,-,-,-,-,-,-,-,-,-,-,-,-------------------------------------------X-
X-------------------------------------------,-.-.-.-.-.-.-.-.-.-.-.-.-.-.-.-.-.-.-.-.-.-.-.-.-.-.-.-.-.-.-.-.-.-.-.-.-.-.-.-.-.-.-.-.-.-.-.-.-.-.-.-.-.-.-.-.-.-.-.-.-.-.-.-.-.-.-.-.-.-.-.-.-.-.-,-------------------------------------------X-
X-------------------------------------------,-.-.-.-.-.-.-.-.-.-.-.-.-.-.-.-.-.-.-.-.-.-.-.-.-.-.-.-.-.-.-.-.-.-.-.-.-.-.-.-.-.-.-.-.-.-.-.-.-.-.-.-.-.-.-.-.-.-.-.-.-.-.-.-.-.-.-.-.-.-.-.-.-.-.-,-------------------------------------------X-
X-------------------------------------------,-.-.-.-.-.-.-.-.-.-.-.-.-.-.-.-.-.-.-.-.-.-.-.-.-.-.-.-.-.-.-.-.-.-.-.-.-.-.-.-.-.-.-.-.-.-.-.-.-.-.-.-.-.-.-.-.-.-.-.-.-.-.-.-.-.-.-.-.-.-.-.-.-.-.-,-------------------------------------------X-
X-------------------------------------------,-.-.-.-.-W-.-.-.-.-.-.-.-.-.-.-.-.-.-.-.-.-.-.-.-.-.-.-.-.-.-.-.-.-.-.-.-.-.-.-.-.-.-.-.-.-.-.-.-.-.-.-.-.-.-.-.-.-.-.-.-.-.-.-.-.-.-.-.-.-.-W-.-.-.-,-------------------------------------------X-
X-------------------------------------------,-.-.-.-.-.-.-.-.-.-.-.-.-.-.-.-.-.-.-.-.-.-.-.-.-.-.-.-.-.-.-.-.-.-.-.-.-.-.-.-.-.-.-.-.-.-.-.-.-.-.-.-.-.-.-.-.-.-.-.-.-.-.-.-.-.-.-.-.-.-.-.-.-.-.-,-------------------------------------------X-
X-------------------------------------------,-.-.-.-.-.-.-.-.-.-.-.-.-.-.-.-.-.-.-.-.-.-.-.-.-.-.-.-.-.-.-.-.-.-.-.-.-.-.-.-.-.-.-.-.-.-.-.-.-.-.-.-.-.-.-.-.-.-.-.-.-.-.-.-.-.-.-.-.-.-.-.-.-.-.-,-------------------------------------------X-
X-------------------------------------------,-.-.-.-.-.-.-.-.-.-.-.-.-.-.-.-.-.-.-.-.-.-.-.-.-.-.-.-.-.-.-.-.-.-.-.-.-.-.-.-.-.-.-.-.-.-.-.-.-.-.-.-.-.-.-.-.-.-.-.-.-.-.-.-.-.-.-.-.-.-.-.-.-.-.-,-------------------------------------------X-
X-------------------------------------------,-.-.-.-.-.-.-.-.-.-.-.-.-.-.-.-.-.-.-.-.-.-.-.-.-.-.-.-.-.-.-.-.-.-.-.-.-.-.-.-.-.-.-.-.-.-.-.-.-.-.-.-.-.-.-.-.-.-.-.-.-.-.-.-.-.-.-.-.-.-.-.-.-.-.-,-------------------------------------------X-
X-------------------------------------------,-.-.-.-.-.-.-.-.-.-.-.-.-.-.-.-.-.-.-.-.-.-.-.-.-.-.-.-.-.-.-.-.-.-.-.-.-.-.-.-.-.-.-.-.-.-.-.-.-.-.-.-.-.-.-.-.-.-.-.-.-.-.-.-.-.-.-.-.-.-.-.-.-.-.-,-------------------------------------------X-
X-------------------------------------------,-.-.-.-.-.-.-.-.-.-.-.-.-.-.-.-.-.-.-.-.-.-.-.-.-.-.-.-.-.-.-.-.-.-.-.-.-.-.-.-.-.-.-.-.-.-.-.-.-.-.-.-.-.-.-.-.-.-.-.-.-.-.-.-.-.-.-.-.-.-.-.-.-.-.-,-------------------------------------------X-
X-------------------------------------------,-.-.-.-.-.-.-.-.-.-.-.-.-.-.-.-.-.-.-.-.-.-.-.-.-.-.-.-.-.-.-.-.-.-.-.-.-.-.-.-.-.-.-.-.-.-.-.-.-.-.-.-.-.-.-.-.-.-.-.-.-.-.-.-.-.-.-.-.-.-.-.-.-.-.-,-------------------------------------------X-
X-------------------------------------------,-.-.-.-.-.-.-.-.-.-.-.-.-.-.-.-.-.-.-.-.-.-.-.-.-.-.-.-.-.-.-.-.-.-.-.-.-.-.-.-.-.-.-.-.-.-.-.-.-.-.-.-.-.-.-.-.-.-.-.-.-.-.-.-.-.-.-.-.-.-.-.-.-.-.-,-------------------------------------------X-
X-------------------------------------------,-.-.-.-.-.-.-.-.-.-.-.-.-.-.-.-.-.-.-.-.-.-.-.-.-.-.-.-.-.-.-.-.-.-.-.-.-.-,-,-,-,-,-,-,-,-,-,-.-.-.-.-.-.-.-.-.-.-.-.-.-.-.-.-.-.-.-.-.-.-.-.-.-.-.-,-------------------------------------------X-
X-------------------------------------------,-.-.-.-.-.-.-.-.-.-.-.-.-.-.-.-.-.-.-.-.-.-.-.-.-.-.-.-.-.-.-.-.-.-.-.-.-X-X-X-X-X-,-,-X-X-X-,-,-,-.-.-.-.-.-.-.-.-.-.-.-.-.-.-.-.-.-.-.-.-.-.-.-.-.-,-------------------------------------------X-
X-------------------------------------------,-.-.-.-.-.-.-.-.-.-.-.-.-.-.-.-.-.-.-.-.-.-.-.-.-.-.-.-.-.-.-.-.-.-.-.-.-X-,-X-.-.-.-.-.-,-X-,-.-X-.-.-.-.-.-.-.-.-.-.-.-.-.-.-.-.-.-.-.-.-.-.-.-.-.-,-------------------------------------------X-
X-------------------------------------------,-.-.-.-.-.-.-.-.-.-.-.-.-.-.-.-.-.-.-.-.-.-.-.-.-.-.-.-.-.-.-.-.-.-.-.-.-X-,-X-<-.-.-.-.-.-.-,-,-X-X-.-.-.-.-.-.-.-.-.-.-.-.-.-.-.-.-.-.-.-.-.-.-.-.-,-------------------------------------------X-
X-------------------------------------------,-.-.-.-.-.-.-.-.-.-.-.-.-.-.-.-.-.-.-.-.-.-.-.-.-.-.-.-.-.-.-,-,-,-,-.-.-X-,-X-.-.-.-.-.-.-.-.-.-X-X-,-.-.-.-.-.-.-.-.-.-.-.-.-.-.-.-.-.-.-.-.-.-.-.-,-------------------------------------------X-
X-------------------------------------------,-.-.-.-.-.-.-.-.-.-.-.-.-.-.-.-X-X-X-X-X-X-X-X-X-X-X-X-X-X-X-X-X-.-X-X-X-X-,-X-.-.-.-.-.-.-.-.-.-,-,-,-,-.-.-.-.-.-.-.-.-.-.-.-.-.-.-.-.-.-.-.-.-.-.-,-------------------------------------------X-
X-------------------------------------------,-.-.-.-.-.-.-.-.-.-.-.-.-.-.-.-X-X-X-X-X-X-X-X-X-X-X-X-X-X-X-X-X-.-X-X-X-X-,-X-.-.-.-.-.-.-.-.-A-.-,-,-X-.-.-.-.-.-.-.-.-.-.-.-.-.-.-.-.-.-.-.-.-.-.-,-------------------------------------------X-
X-------------------------------------------,-.-.-.-.-.-.-.-.-.-.-.-.-.-.-.-X-X-.-.-.-.-.-,-,-,-,-,-,-.-.-.-.-.-.-.-W-X-,-X-.-.-.-.-.-.-.-.-.-.-,-X-X-.-.-.-.-.-.-.-.-.-.-.-.-.-.-.-.-.-.-.-.-.-.-,-------------------------------------------X-
X-------------------------------------------,-.-.-.-.-.-.-.-.-.-.-.-.-.-.-.-X-X-.-.-.-.-.-,-,-,-,-,-,-,-,-,-,-,-,-.-.-X-,-X-.-.-.-.-.-.-.-.-.-.-,-X-X-.-.-.-.-.-.-.-.-.-.-.-.-.-.-.-.-.-.-.-.-.-.-,-------------------------------------------X-
X-------------------------------------------,-.-.-.-.-.-.-.-.-.-.-.-.-.-.-.-X-X-.-.-.-.-.-.-.-.-.-.-.-.-.-.-.-.-,-.-.-X-,-X-.-.-.-.-.-.-.-.-.-W-,-.-,-.-.-.-.-.-.-.-.-.-.-.-.-.-.-.-.-.-.-.-.-.-.-,-------------------------------------------X-
X-------------------------------------------,-.-.-.-.-.-.-.-.-.-.-.-.-.-.-.-X-X-.-.-.-.-.-.-.-.-.-.-.-.-.-.-.-.-,-,-,-X-X-X-.-.-.-.-.-.-.-.-.-.-,-.-,-.-.-.-.-.-.-.-.-.-.-.-.-.-.-.-.-.-.-.-.-.-.-,-------------------------------------------X-
X-------------------------------------------,-.-.-.-.-.-.-.-.-.-.-.-.-.-.-.-X-X-.-.-.-.-.-.-.-.-.-.-.-.-.-.-.-.-,-,-,-,-.-.-.-.-.-.-.-.-.-.-.-.-,-X-X-.-.-.-.-.-.-.-.-.-.-.-.-.-.-.-.-.-.-.-.-.-.-,-------------------------------------------X-
X-------------------------------------------,-.-.-.-.-.-.-.-.-.-.-.-.-.-.-.-X-X-.-.-.-.-.-.-.-.-.-.-.-.-.-.-.-.-,-.-.-X-X-X-.-.-.-.-.-.-.-.-.-.-,-X-X-.-.-.-.-.-.-.-.-.-.-.-.-.-.-.-.-.-.-.-.-.-.-,-------------------------------------------X-
X-------------------------------------------,-.-.-.-.-.-.-.-.-.-.-.-.-.-.-.-X-X-.-.-.-.-.-.-.-.-.-.-.-.-.-.-.-.-,-.-.-X-,-X-.-.-.-.-.-.-.-.-A-,-,-,-X-.-.-.-.-.-.-.-.-.-.-.-.-.-.-.-.-.-.-.-.-.-.-,-------------------------------------------X-
X-------------------------------------------,-.-.-.-.-.-.-.-.-.-.-.-.-.-.-.-X-X-.-.-.-.-.-.-.-.-.-.-.-.-.-.-.-.-,-.-.-X-,-X-.-.-.-.-.-.-.-.-.-,-,-,-.-.-.-.-.-.-.-.-.-.-.-.-.-.-.-.-.-.-.-.-.-.-.-,-------------------------------------------X-
X-------------------------------------------,-.-.-.-.-.-.-.-.-.-.-,-X-X-X-X-X-X-.-.-.-.-.-.-.-.-.-.-.-.-.-.-.-.-,-.-.-X-,-X-.-.-.-.-.-.-,-,-,-,-X-.-.-.-.-.-.-.-.-.-.-.-.-.-.-.-.-.-.-.-.-.-.-.-.-,-------------------------------------------X-
X-------------------------------------------,-.-.-.-.-.-.-.-.-.-.-,-X-X-X-X-X-X-.-.-.-.-.-.-.-.-.-.-.-.-.-.-.-.-,-.-.-X-,-X-.-.-.-.-.-,-,-.-X-X-X-.-.-.-.-.-.-.-.-.-.-.-.-.-.-.-.-.-.-.-.-.-.-.-.-,-------------------------------------------X-
X-------------------------------------------,-.-.-.-.-.-.-.-.-.-.-,-.-+-+-.-.-.-.-.-.-.-.-.-.-.-.-.-.-.-.-.-.-.-,-.-H-X-,-X-X-X-.-X-X-X-X-,-,-X-.-.-.-.-.-.-.-.-.-.-.-.-.-.-.-.-.-.-.-.-.-.-.-.-.-,-------------------------------------------X-
X-------------------------------------------,-.-.-.-.-<-.-.-.-.-<-,-.-+-+-.-.-.-.-.-.-.-.-.-.-.-.-.-.-.-.-.-.-.-,-.-.-X-.-.-,-X-+-X-.-X-X-,-.-.-.-.-.-.-.-.-.-.-.-.-.-.-.-.-.-.-.-.-.-.-.-.-.-.-.-,-------------------------------------------X-
X-------------------------------------------,-.-.-.-.-.-.-.-.-.-.-,-.-+-+-.-.-.-.-.-.-.-.-.-.-.-.-.-.-.-.-.-.-.-,-.-.-X-,-,-,-X-+-X-.-+-.-<-.-.-.-.-.-.-.-.-.-.-.-.-.-.-.-.-.-.-.-.-.-.-.-.-.-.-.-,-------------------------------------------X-
X-------------------------------------------,-.-.-.-.-.-.-.-.-.-.-,-X-X-X-X-X-X-.-.-.-.-.-.-.-.-.-.-.-.-.-.-.-.-,-.-.-X-,-X-X-X-.-X-+-X-X-X-X-X-X-X-X-X-X-X-X-X-X-X-X-X-X-.-.-.-.-.-.-.-.-.-.-.-.-,-------------------------------------------X-
X-------------------------------------------,-.-.-.-.-.-.-.-.-.-.-.-X-X-X-X-X-X-.-.-.-.-.-.-.-.-.-.-.-.-.-.-.-.-,-.-.-X-,-X-.-.-.-.-.-X-X-X-X-X-X-X-X-X-X-X-X-X-X-X-X-X-X-.-.-.-.-.-.-.-.-.-.-.-.-,-------------------------------------------X-
X-------------------------------------------,-.-.-.-.-.-.-.-.-.-.-.-.-.-.-.-X-X-.-.-.-.-.-.-.-.-.-.-.-.-.-.-.-.-,-,-,-X-,-X-.-.-.-.-.-X-.-.-.-.-.-.-.-.-.-.-.-.-A-A-.-X-X-.-.-.-.-.-.-.-.-.-.-.-.-,-------------------------------------------X-
X-------------------------------------------,-.-.-.-.-.-.-.-.-.-.-.-.-.-.-.-X-X-.-.-.-.-.-.-.-.-.-.-.-.-.-.-.-.-.-.-.-X-X-X-.-.-.-.-.-X-,-,-,-X-X-.-.-.-.-.-.-.-.-.-.-X-X-.-.-.-.-.-.-.-.-.-.-.-.-,-------------------------------------------X-
X-------------------------------------------,-.-.-.-.-.-.-.-.-.-.-.-.-.-.-.-X-X-.-.-.-.-.-.-.-.-.-.-.-.-.-.-.-.-,-,-,-,-.-.-.-.-.-.-.-X-,-,-,-X-X-.-.-.-.-.-.-.-A-A-.-X-X-.-.-.-.-.-.-.-.-.-.-.-.-,-------------------------------------------X-
X-------------------------------------------,-.-.-.-.-.-.-.-.-.-.-.-.-.-.-.-X-X-.-.-.-.-.-.-.-.-.-.-.-.-.-.-.-.-,-.0.0X0X-X-.-.-.-.-.-X-,-,-,-X-X-.-.-.-.-.-.-.-.-.-.-X-X-.-.-.-.-.-.-.-.-.-.-.-.-,-------------------------------------------X-
X-------------------------------------------,-.-.-.-.-.-.-.-.-.-.-.-.-.-.-.-X-X-.-.-.-.-.-.-.-.-.-.-.-.-.-.-.-.-,-.0.0X0,-X-.-.-.-.-.-X-,-,-,-X-X-.-.-.-.-.-.-.-A-A-.-X-X-.-.-.-.-.-.-.-.-.-.-.-.-,-------------------------------------------X-
X-------------------------------------------,-.-.-.-.-.-.-.-.-.-.-.-.-.-.-.-X-X-,-,-,-,-,-,-,-,-,-,-,-,-,-.-,-,-,-.0.0X0,-X-.-.-.-.-.-X-,-,-,-X-X-.-.-.-.-.-.-.-.-.-.-X-X-.-.-.-.-.-.-.-.-.-.-.-.-,-------------------------------------------X-
X-------------------------------------------,-.-.-.-.-.-.-.-.-.-.-.-.-.-.-.-X-X-.-.-.-.-.-.-.-.-.-.-.-.-,-.-,-.0.0.0.0X0,-X-.-.-.-.-.-X-,-,-,-X-X-H-.-.-.-.-.-.-A-A-.-X-X-.-.-.-.-.-.-.-.-.-.-.-.-,-------------------------------------------X-
X-------------------------------------------,-.-.-.-.-.-.-.-.-.-.-.-.-.-.-.-X-X-W-.-,-,-,-,-.-.-.-.-.-.-,-.-,-.0.0.0.0X0,-X-.-.-.-.-.-.-.-.-.-X-X-H-.-.-W-.-.-.-.-.-.-X-X-.-.-.-.-.-.-.-.-.-.-.-.-,-------------------------------------------X-
X-------------------------------------------,-.-.-.-.-.-.-.-.-.-.-.-.-.-.-.-X-X-X-X-X-X-,-X-X-X-X-X-X-X-X-X-,-X0X0X0X0X0,-X-.-.-.-.-.-.-.-<-.-X-X-.-.-.-.-.-.-.-A-A-.-X-X-.-.-.-.-.-.-.-.-.-.-.-.-,-------------------------------------------X-
X-------------------------------------------,-.-.-.-.-.-.-.-.-.-.-.-.-.-.-.-,-,-,-.-.-.-.-.-.-X-,-X-X-X-X-X-.-X-X-X-X-X-X-X-.-.-.-.-,-,-,-,-,-X-X-H-.-.-.-.-.-.-.-.-.-X-X-.-.-.-.-.-.-.-.-.-.-.-.-,-------------------------------------------X-
X-------------------------------------------,-.-.-.-.-.-.-.-.-.-.-.-.-.-.-.-,-,-,-.-.-.-.-.-.-X-,-X-.-.-.-.-.-.-.-.-.-.-.-.-.-.-.-.-,-X-,-,-,-X-X-.-.-.-.-.-.-.-A-A-.-X-X-.-.-.-.-.-.-.-.-.-.-.-.-,-------------------------------------------X-
X-------------------------------------------,-.-.-.-.-.-.-.-.-.-.-.-.-.-.-.-,-X-A-.-.-.-.-.-.-X-,-X-.-.-.-.-.-.-.-.-.-.-.-.-.-.-.-.-,-X-,-,-,-X-X-.-.-.-.-.-.-.-.-.-.-X-X-.-.-.-.-.-.-.-.-.-.-.-.-,-------------------------------------------X-
X-------------------------------------------,-.-.-.-.-.-.-.-.-.-.-.-.-.-.-.-,-X-.-.-.-.-.-.-.-X.X.X..-.-.-.-.-.-.-.-.-.-.-.-.-.-.-.-,-X-.-.-.-X-X-.-.-.-.-.-.-.-A-A-.-X-X-.-.-.-.-.-.-.-.-.-.-.-.-,-------------------------------------------X-
X-------------------------------------------,-.-.-.-.-.-.-.-.-.-.-.-.-.-.-.-,-X-W-.-.-.-.-.-t/....,..-.-.-.-.-.-.-.-.-.-.-.-.-.-.-.-,-X-,-,-,-X-X-.-.-.-.-.-.-.-.-.-.-X-X-.-.-.-.-.-.-.-.-.-.-.-.-,-------------------------------------------X-
X-------------------------------------------,-.-.-.-.-.-.-.-.-.-.-.-.-.-.-.-,-X-A-.-.-.-.-.-.-X.X.X..-.-.-.-.-.-<-.-.-.-.-.-.-.-.-.-,-X-.-.-.-X-X-.-.-.-.-.-.-.-A-A-.-X-X-.-.-.-.-.-.-.-.-.-.-.-.-,-------------------------------------------X-
X-------------------------------------------,-.-.-.-.-.-.-.-.-.-.-.-.-.-.-.-,-,-,-.-.-.-.-.-.-X-,-X-.-.-.-.-.-.-.-.-.-.-.-.-.-.-.-.-W-X-.-.-.-.-.-.-.-.-.-.-.-.-.-A-.-X-X-.-.-.-.-.-.-.-.-.-.-.-.-,-------------------------------------------X-
X-------------------------------------------,-.-.-.-.-.-.-.-.-.-.-.-.-.-.-.-.-,-,-,-,-,-,-,-.-X-,-X-X-X-X-X-X-X-+-X-X-X-X-X-X-X-X-X-X-X-.-.-.-.-.-.-.-.-.-.-.-.-A-.-.-X-X-.-.-.-.-.-.-.-.-.-.-.-.-,-------------------------------------------X-
X-------------------------------------------,-.-.-.-.-.-.-.-.-.-.-.-.-.-.-.-.-,-X-X-X-X-.-X-X-X-.-.-.-.-.-.-,->->->-X-X-X-X-X-X-X-X-X-X-X-X-X-X-X-X-X-X-X-X-X-X-+-X-X-X-X-.-.-.-.-.-.-.-.-.-.-.-.-,-------------------------------------------X-
X-------------------------------------------,-.-.-.-.-.-.-.-.-.-.-.-.-.-.-.-.-.-.-X-X-X-,-X-X-X-.-.-.-.-.-.-,-X-.-X-X-.-.-.-.-.-.-.-.-.-.-.-.-.-.-.-.-.-.-.-X-X-.-X-.-.-X-.-.-.-.-.-.-.-.-.-.-.-.-,-------------------------------------------X-
X-------------------------------------------,-.-.-.-.-.-.-.-.-.-.-.-.-.-.-.-.-.-.-.-.-.-.-.-.-X-.-.-.-.-.-.-,-X-X-X-X-.-.-.-.-.-.-.-.-.-.-.-.-.-.-.-.-.-.-.-X-X-X-X-.-.-X-.-.-.-.-.-.-.-.-.-.-.-.-,-------------------------------------------X-
X-------------------------------------------,-.-.-.-.-.-.-.-.-.-.-.-.-.-.-.-.-.-.-.-.-.-.-.-.-X-X-X-X-X-X-X-X-X-X-X-X-.-.-.-.-.-.-.-.-.-.-.-.-.-.-.-.-.-.-.-X-X-X-X-X-X-X-.-.-.-.-.-.-.-.-.-.-.-.-,-------------------------------------------X-
X-------------------------------------------,-.-.-.-.-.-.-.-.-.-.-.-.-.-.-.-.-.-.-.-.-.-.-.-.-.-.-.-.-.-.-.-.-.-.-.-.-.-.-.-.-.-.-.-.-.-.-.-.-.-.-.-.-.-.-.-.-.-.-.-.-.-.-.-.-.-.-.-.-.-.-.-.-.-.-,-------------------------------------------X-
X-------------------------------------------,-.-.-.-.-.-.-.-.-.-.-.-.-.-.-.-.-.-.-.-.-.-.-.-.-.-.-.-.-.-.-.-.-.-.-.-.-.-.-.-.-.-.-.-.-.-.-.-.-.-.-.-.-.-.-.-.-.-.-.-.-.-.-.-.-.-.-.-.-.-.-.-.-.-.-,-------------------------------------------X-
X-------------------------------------------,-.-.-.-.-.-.-.-.-.-.-.-.-.-.-.-.-.-.-.-.-.-.-.-.-.-.-.-.-.-.-.-.-.-.-.-.-.-.-.-.-.-.-.-.-.-.-.-.-.-.-.-.-.-.-.-.-.-.-.-.-.-.-.-.-.-.-.-.-.-.-.-.-.-.-,-------------------------------------------X-
X-------------------------------------------,-.-.-.-.-.-.-.-.-.-.-.-.-.-.-.-.-.-.-.-.-.-.-.-.-.-.-.-.-.-.-.-.-.-.-.-.-.-.-.-.-.-.-.-.-.-.-.-.-.-.-.-.-.-.-.-.-.-.-.-.-.-.-.-.-.-.-.-.-.-.-.-.-.-.-,-------------------------------------------X-
X-------------------------------------------,-.-.-.-.-.-.-.-.-.-.-.-.-.-.-.-.-.-.-.-.-.-.-.-.-.-.-.-.-.-.-.-.-.-.-.-.-.-.-.-.-.-.-.-.-.-.-.-.-.-.-.-.-.-.-.-.-.-.-.-.-.-.-.-.-.-.-.-.-.-.-.-.-.-.-,-------------------------------------------X-
X-------------------------------------------,-.-.-.-.-.-.-.-.-.-.-.-.-.-.-.-.-.-.-.-.-.-.-.-.-.-.-.-.-.-.-.-.-.-.-.-.-.-.-.-.-.-.-.-.-.-.-.-.-.-.-.-.-.-.-.-.-.-.-.-.-.-.-.-.-.-.-.-.-.-.-.-.-.-.-,-------------------------------------------X-
X-------------------------------------------,-.-.-.-.-.-.-.-.-.-.-.-.-.-.-.-.-.-.-.-.-.-.-.-.-.-.-.-.-.-.-.-.-.-.-.-.-.-.-.-.-.-.-.-.-.-.-.-.-.-.-.-.-.-.-.-.-.-.-.-.-.-.-.-.-.-.-.-.-.-.-.-.-.-.-,-------------------------------------------X-
X-------------------------------------------,-.-.-.-.-.-.-.-.-.-.-.-.-.-.-.-.-.-.-.-.-.-.-.-.-.-.-.-.-.-.-.-.-.-.-.-.-.-.-.-.-.-.-.-.-.-.-.-.-.-.-.-.-.-.-.-.-.-.-.-.-.-.-.-.-.-.-.-.-.-.-.-.-.-.-,-------------------------------------------X-
X-------------------------------------------,-.-.-.-.-.-.-.-.-.-.-.-.-.-.-.-.-.-.-.-.-.-.-.-.-.-.-.-.-.-.-.-.-.-.-.-.-.-.-.-.-.-.-.-.-.-.-.-.-.-.-.-.-.-.-.-.-.-.-.-.-.-.-.-.-.-.-.-.-.-.-.-.-.-.-,-------------------------------------------X-
X-------------------------------------------,-.-.-.-.-.-.-.-.-.-.-.-.-.-.-.-.-.-.-.-.-.-.-.-.-.-.-.-.-.-.-.-.-.-.-.-.-.-.-.-.-.-.-.-.-.-.-.-.-.-.-.-.-.-.-.-.-.-.-.-.-.-.-.-.-.-.-.-.-.-.-.-.-.-.-,-------------------------------------------X-
X-------------------------------------------,-.-.-.-W-.-.-.-.-.-.-.-.-.-.-.-.-.-.-.-.-.-.-.-.-.-.-.-.-.-.-.-.-.-.-.-.-.-.-.-.-.-.-.-.-.-.-.-.-.-.-.-.-.-.-.-.-.-.-.-.-.-.-.-.-.-.-.-.-.-.-W-.-.-.-,-------------------------------------------X-
X-------------------------------------------,-.-.-.-.-.-.-.-.-.-.-.-.-.-.-.-.-.-.-.-.-.-.-.-.-.-.-.-.-.-.-.-.-.-.-.-.-.-.-.-.-.-.-.-.-.-.-.-.-.-.-.-.-.-.-.-.-.-.-.-.-.-.-.-.-.-.-.-.-.-.-.-.-.-.-,-------------------------------------------X-
X-------------------------------------------,-.-.-.-.-.-.-.-.-.-.-.-.-.-.-.-.-.-.-.-.-.-.-.-.-.-.-.-.-.-.-.-.-.-.-.-.-.-.-.-.-.-.-.-.-.-.-.-.-.-.-.-.-.-.-.-.-.-.-.-.-.-.-.-.-.-.-.-.-.-.-.-.-.-.-,-------------------------------------------X-
X-------------------------------------------,-,-,-,-,-,-,-,-,-,-,-,-,-,-,-,-,-,-,-,-,-,-,-,-,-,-,-,-,-,-,-,-,-,-,-,-,-,-,-,-,-,-,-,-,-,-,-,-,-,-,-,-,-,-,-,-,-,-,-,-,-,-,-,-,-,-,-,-,-,-,-,-,-,-,-,-------------------------------------------X-
X---------------------------------------------------------------------------------------------------------------------------------------------------------------------------------------------------------------------------------------------X-
X---------------------------------------------------------------------------------------------------------------------------------------------------------------------------------------------------------------------------------------------X-
X---------------------------------------------------------------------------------------------------------------------------------------------------------------------------------------------------------------------------------------------X-
X---------------------------------------------------------------------------------------------------------------------------------------------------------------------------------------------------------------------------------------------X-
X---------------------------------------------------------------------------------------------------------------------------------------------------------------------------------------------------------------------------------------------X-
X---------------------------------------------------------------------------------------------------------------------------------------------------------------------------------------------------------------------------------------------X-
X---------------------------------------------------------------------------------------------------------------------------------------------------------------------------------------------------------------------------------------------X-
X---------------------------------------------------------------------------------------------------------------------------------------------------------------------------------------------------------------------------------------------X-
X---------------------------------------------------------------------------------------------------------------------------------------------------------------------------------------------------------------------------------------------X-
X---------------------------------------------------------------------------------------------------------------------------------------------------------------------------------------------------------------------------------------------X-
X---------------------------------------------------------------------------------------------------------------------------------------------------------------------------------------------------------------------------------------------X-
X---------------------------------------------------------------------------------------------------------------------------------------------------------------------------------------------------------------------------------------------X-
X---------------------------------------------------------------------------------------------------------------------------------------------------------------------------------------------------------------------------------------------X-
X---------------------------------------------------------------------------------------------------------------------------------------------------------------------------------------------------------------------------------------------X-
X---------------------------------------------------------------------------------------------------------------------------------------------------------------------------------------------------------------------------------------------X-
X---------------------------------------------------------------------------------------------------------------------------------------------------------------------------------------------------------------------------------------------X-
X---------------------------------------------------------------------------------------------------------------------------------------------------------------------------------------------------------------------------------------------X-
X---------------------------------------------------------------------------------------------------------------------------------------------------------------------------------------------------------------------------------------------X-
X---------------------------------------------------------------------------------------------------------------------------------------------------------------------------------------------------------------------------------------------X-
X---------------------------------------------------------------------------------------------------------------------------------------------------------------------------------------------------------------------------------------------X-
X---------------------------------------------------------------------------------------------------------------------------------------------------------------------------------------------------------------------------------------------X-
X---------------------------------------------------------------------------------------------------------------------------------------------------------------------------------------------------------------------------------------------X-
X-X-X-X-X-X-X-X-X-X-X-X-X-X-X-X-X-X-X-X-X-X-X-X-X-X-X-X-X-X-X-X-X-X-X-X-X-X-X-X-X-X-X-X-X-X-X-X-X-X-X-X-X-X-X-X-X-X-X-X-X-X-X-X-X-X-X-X-X-X-X-X-X-X-X-X-X-X-X-X-X-X-X-X-X-X-X-X-X-X-X-X-X-X-X-X-X-X-X-X-X-X-X-X-X-X-X-X-X-X-X-X-X-X-X-X-X-X-X-X-
