------------------------------------------,-,-,-X-X-X-X-X-X-X-X-X-,-,-,-------------------------------------------------------------------------------------------------------------
--------------------------------------,-,-,-X-X-.-.-.-.-.-.-W-.-.-X-X-X-,-,---------------------------------------------------------------------------------------------------------
------------------------------------,-,-X-X-.-.-.-.-.-.-.-.-.-.-.-.-.-.-X-X-,-,-----------------------------------------------------------------------------------------------------
----------------------------------,-,-X-.-.-.-.-.-.-.-.-.-.-.-.-.-.-.-.-.-.-X-X-,---------------------------------------------------------------------------------------------------
----------------------------------,-X-.-.-.-.-.-.-.-.-.-.-.-.-.-.-.-.-.-.-.-.-.-X---------------------------------------------------------------------------------------------------
--------------------------------,-,-X-.-.-.-.-.-.-.-.-.-.-.-.-.-.-.-.-.-.-.-.-.-X-,-------------------------------------------------------------------------------------------------
------------------------------,-,-X-.-.-.-.-.-.-.-.-.-.-.-.-.-.-.-.-.-.-.-.-.-.-.-X-------------------------------------------------------------------------------------------------
------------------------------,-X-.-.-.-.-.-.-.-.-.-.-.-.-.-.-.-.-.-.-.-.-.-.-.-.-X-,-----------------------------------------------------------------------------------------------
----------------------------,-,-X-H-.-.-.-.-.-.-.-.-.-.-.-.-.-.-.-.-.-.-.-.-.-.-.-.-X-----------------------------------------------------------------------------------------------
--------------------------,-,-X-.-.-.-.-.-.-.-.-.-.-.-.-.-.-.-.-.-.-.-.-.-.-.-.-.-.-X-,---------------------------------------------------------------------------------------------
--------------------------,-X-,-,-,-,-.-.-.-.-.-.-.-.-.-.-,-,-,-,-,-.-.-.-.-.-.-.-.-.-X---------------------------------------------------------------------------------------------
------------------------,-,-X-.-.-.-,-,-,-.-.-.-.-.-.-,-,-,-.-.-.-,-,-,-.-.-.-.-.-H-.-X---------------------------------------------------------------------------------------------
----------------------,-,-X-.-.-.-.-.-.-,-,-.-.-.-.-,-,-.-.-.-.-.-.-.-,-,-.-.-.-.-.-.-X---------------------------------------------------------------------------------------------
----------------------,-X-.-.-.-.-.-.-.-.-,-,-.-.-,-,-.-.-.-.-.-.-.-.-.-,-,-.-.-.-.-.-X---------------------------------------------------------------------------------------------
--------------------,-,-X-.-.-.-.-.-.-.-.-.-,-A-,-,-.-.-.-.-.-.-.-.-.-.-.-,-,-.-.-.-W-X---------------------------------------------------------------------------------------------
--------------------,-X-.-.-.-.-.-.-.-.-.-.-.-,-,-.-.-.-.-.-.-.-.-.-.-.-.-.-,-,-.-.-.-X---------------------------------------------------------------------------------------------
------------------,-,-X-.-.-.-.-.-.-.-.-.-.-,-X-,-,-,-,-,-X-X-X-X-X-X-X-X-X-X-X-X-X-X-X---------------------------------------------------------------------------------------------
------------------,-X-.-.-.-.-.-.-.-.-.-.-X-X-X-.-.-.-.-.-X-------------------------------------------------------------------------------------------------------------------------
----------------,-,-X-.-.-.-.-.-.-.-.-.-.-X-,-X-.-.-.-.-.-X-------------------------------------------------------------------------------------------------------------------------
----------------,-X-.-.-.-.-.-.-.-.-.-.-.-X-,-X-.-.-.-.-.-X-,-,-,-,-,-,-,-,-,-,-,-,-,-,-,-,-----------------------------------------------------------------------------------------
--------------,-,-X-.-.-.-.-.-.-.-.-.-.-,-X-,-X-.-.-.-<-.-X-,-X-X-X-X-X-X-X-X-X-X-X-X-X-X-X-----------------------------------------------------------------------------------------
--------------,-X-.-.-.-.-.-.-.-.-.-.-.-X---,-X-.-.-.-.-.-X-,-X-.-.-.-.-.-.-.-.-.-.-.-.-,-X-----------------------------------------------------------------------------------------
------------,-,-X-.-.-.-.-.-.-.-.-.-.-.-X---,-X-.-.-.-W-.-X-,-X-.-.-.-X-X-X-.-.-.-.-,-,-,-X-----------------------------------------------------------------------------------------
------------,-X-.-.-.-.-.-.-.-.-.-.-.-.-X-,---,-X-.-.-.-.-X-,-X-.-.-.-X-.-X-.-.-,-,-,-,-,-X-------------------------------------------,-,-,-,-,-,-,-,-,-,-,-,-,-,-,-,-,-------------
----------,-,-X-.-.-.-.-.-.-.-.-.-.-.-W-.-X-----,-X-.-.-,-X-X-X-.-.-.-X-X-X-.-,-,-,-,-,-,-X-------------------------------------,-,-,-,-X-X-X-X-X-X-X-X-X-X-X-X-X-X-X-X-,-----------
----------,-X-.-.-.-.-.-.-.-.-.-.-.-.-.-<-X-------,-X-,-,-<-.-,-.-.-.-.-.-,-,-,-,-,-,-,-,-X-,-,-,-,-,-,-,-,-,-,-,-,---------,-,-,-X-X-X-.-.-.-.-.-.-.-.-.-.-.-.-.-.-.-.-X-,---------
--------,-,-X-.-.-.-.-.-.-,-,-,-,-,-,-,-,-X-,-------,-X-.-.-.-,-.-.-.-,-,-,-,-,-,-,-,-,-,-X-X-X-X-X-X-X-X-X-X-X-X-X-----,-,-,-X-X-.-.-.-.-.-.-.-.-.-.-.-.-.-.-.-.-.-.-.-.-X-,-------
--------,-X-.-.-.-.-,-,-,-,-.-.-.-.-,-,-.-.-X-------,-X-.-<-.-,-.-.-,-,-,-,-,-,-,-,-,-,-,-.-.-.-.-.-.-.-.-.-.-.-W-X-----,-X-X-.-.-A-.-.-.-.-.-.-.-.-.-.-.-.-.-.-.-.-.-.-.-.-X-,-----
------,-,-X-.-.-,-,-,-.-.-.-.-.-.-,-,-.-.-.-X-,---,-,-X-,-.-.-,-.-.-,-,-,-,-,-,-,-,-,-,-,-.-.-.-.-.-.-.-.-.-.-.-.-X-----,-X-.-W-.-.-.-.-.-.-.-.-.-.-.-.-.-.-.-.-.-.-.-.-.-.-.-X-----
------,-X-.-,-,-,-.-.-.-.-.-.-.-.-,-.-.-.-.-.-X-,-,-X-,-,-<-.-,-.-.-.-,-,-,-,-,-,-,-,-,-,-.-.-.-.-.-.-.-.-.-.-.-.-X-----,-X-.-.-.-.-.-.-.-.-.-.-.-.-,-,-,-,-,-,-,-,-.-.-.-.-.-X-----
----,-,-X-,-,-.-.-.-.-.-.-.-.-.-,-,-.-.-.-.-.-X-,-X-,-,-,-,-.-,-.-.-.-.-.-,-,-,-,-,-,-,-,-X-X-X-X-X-X-X-X-X-.-.-.-X-----,-X-.-.-.-.-.-.-.-.-.-.-.-.-,-.-.-,-,-.-.-,-.-.-.-.-.-X-----
----,-X-,-,-.-.-.-.-.-.-.-.-.-,-,-.-.-.-.-.-.-,-X-,-,-,-,-<-.-,-.-.-.-.-.-.-.-,-,-,-,-,-,-X-------------,-X-.-.-.-X-----,-X-.-.-.-.-.-.-.-.-.-.-.-.-,-.-.-,-,-.-.-,-.-.-.-.-.-X-----
--,-,-X-.-.-.-.-.-.-.-.-.-.-,-,-.-.-.-.-.-.-.-.-,-.-,-,-,-X-X-X-.-.-.-X-X-X-.-.-,-,-,-,-,-X-------------,-X-.-.-.-X-----,-X-.-.-.-.-.-.-.-.-.-.-.-.-,-.-.-X-X-X-.-,-.-.-.-.-.-X-----
--,-X-.-.-.-.-.-.-.-.-.-.-.-,-.-.-.-.-.-.-.-.-.-,-,-,-X-X---,-X-.-.-.-X-.-X-.-.-.-.-,-,-,-X-------------,-X-.-.-.-X-,-,-,-X-.-.-.-.-.-.-.-.-.-.-.-.-,-.-.-X-A-X-.-,-.-.-.-.-.-X-----
--,-X-H-.-.-.-.-.-.-.-.-.-.-,-.-.-.-.-.-.-.-.-.-.-,-X-X-----,-X-.-.-.-X-X-X-.-.-.-.-.-.-,-X-------------,-X-.-.-.-X-X-X-X-X-.-.-.-.-.-.-.-.-.-.-.-.-,-,-,-X-X-X-,-,-.-.-.-.-.-X-----
--,-X-.-.-.-.-.-.-.-.-.-.-.-,-,-.-.-.-.-.-.-.-,-,-,-X.,-----,-X-.-.-.-.-A-.-.-.-.-.-.-.-.-X-------------,-X-.-.-.-.-.-.-.-,-.-.-.-.-.-.-.-.-.-.-.-.-.-.-.-.-.-.-.-.-.-.-.-.-.-X-----
,-,-X-.-.-.-.-.-.-.-.-.-.-.-.-,-.-.-.-.-.-,-,-,-......X-,---,-X-X-X-X-X-X-X-X-X-X-X-X-X-X-X-------------,-X-.-.-.-.-.-.-.-,-.-.-.-.-.-.-.-.-.-.-.-.-.-.-.-.-.-.-.-.-.-.-.-.-.-X-----
,-X-.-.-.-.-.-.-.-.-.-.-.-.-.-,-,-.-.-.-,-,-X-X.........X-----------------------------------------------,-X-.-.-.-.-.-.-.-,-.-.-.-.-.-.-.-.-.-.-.-.-,-,-,-,-,-,-,-,-.-.-.-.-.-X-----
,-X-.-.-.-.-.-.-.-.-.-.-.-.-.-.-,-,-.-,-X-X-.-X-X.......X.,---------------------------------------------,-X-.-.-.-X-X-X-X-X-.-.-.-.-.-.-.-.-.-.-.-.-,-.-.-X-X-X-.-,-.-.-.-.-.-X-----
,-X-.-.-.-.-.-.-.-.-.-.-,-,-,-,-.-,-X-X---,-X-.-X-X-......X.,-,-,-,-,-,-,-,-,-,-,-,-,-,-,-,-----------,-,-X-.-.-.-X-----,-X-.-.-.-.-.-.-.-.-.-.-.-.-,-.-.-X-W-X-.-,-.-.-.-.-.-X-----
,-X-.-.-.-.-.-.-.-.-.-,-,-.-.-,-,-.-X-,-,-,-X-W-.-,-X-X-..,.X.X-X-X-X-X-X-X-X-X-X-X-X-X-X-X-X-X-X-X-X-X-X-X-.-.-.-X-----,-X-.-.-.-.-.-.-.-.-.-.-.-.-,-.-.-X-X-X-.-,-.-.-.-.-.-X-----
,-X-.-.-.-.-.-.-.-.-.-,-.-.-A-.-,-.-X-X-X-X-X-X-X-X-X-X-X.,-.-.-W-.-,-.-.-.-.-.-.-.-.-.-.-,-,-,-,-,-.-.-.-.-.-.-.-X-----,-X-.-.-.-.-.-.-.-.-.-.-.-.-,-.-.-,-,-.-.-,-.-.-.-.-.-X-----
,-X-.-.-.-.-.-.-.-.-.-,-.-.-,-,-,-,-X-X-.-.-.-.-.-.-.-.-.-.-.-.-.-.-,-,-.-.-.-.-.-.-.-.-.-,-,-.-.-.-.-.-.-.-.-.-.-X-----,-X-.-.-.-.-.-.-.-.-.-.-.-.-,-,-,-,-,-,-,-,-.-.-.-.-.-X-----
,-X-.-.-.-.-.-.-.-.-.-,-.-.-,-.-.-,-X-X-.-.-.-.-.-.-.-.-.-.-.-.-.-.-.-,-.-.-.-.-.-.-.-.-.-.-.-.-.-.-.-.-.-.-.-.-.-X-----,-X-.-.-.-.-.-.-.-.-.-.-.-.-.-.-.-.-.-.-.-.-.-.-.-.-.-X-,-,-
,-X-.-.-.-.-.-.-.-.-.-,-.-<-,-.-H-,-.-,-.-.-.-.-.-.-.-.-.-.-.-.-.-.-.-X-X-X-X-X-X-X-X-X-X-X-X-X-X-X-X-X-X-X-.-.-.-X-----,-X-X-.-.-.-.-.-.-.-.-.-.-.-.-.-.-.-.-.-.-.-.-.-.-.-.-X-X-X-
X-.-.-.-.-.-.-.-.-.-.-,-.-.-,-,-,-,-X-X-.-.-.-.-.-.-.-.-.-.-.-.-.-.-.-X---------------------------------,-X-.-.-.-X---------,-X-X-.-.-.-.-.-.-.-.-.-.-.-.-.-.-.-.-.-.-.-.-.-.-.-H-X-
X-.-.-.-.-.-.-.-.-.-.-,-.-.-.-,-,-.-X-X-.-.-.-.-.-.-.-.-.-.-.-.-.-.-.-X-------------------------------,-,-X-.-.-.-X-,-----------,-X-X-.-.-.-.-.-.-.-.-.-.-.-.-.-.-.-.-.-.-.-.-.-.-X-
X-.-.-.-.-.-.-.-.-.-.-,-,-.-W-.-,-.-X-X-.-.-.-.-.-.-.-.-.-.-.-.-.-.-.-X-----------------------------,-,-X-.-.-.-.-.-X-,-------------,-X-X-.-.-.-.-.-.-.-.-.-.-.-.-.-.-.-.-.-.-.-.-X-
X-.-.-.-.-.-.-.-.-.-.-.-,-,-,-,-,-.-X-X-H-.-.-.-.-.-.-.-.-.-.-.-.-.-.-X-----------------------------,-X-.-.-.-.-.-.-.-X-----------------,-X-X-X-X-X-X-X-X-X-X-X-X-X-X-X-.-H-.-.-.-X-
X-.-.-.-.-.-.-.-.-.-.-.-.-,-,-.-.-.-X-X-,-X-X-.-.-.-.-.-.-.-.-.-.-.-.-X-,---------------------------,-X-.-.-.-H-.-.-.-X---------------------------------------------,-X-.-.-.-.-H-X-
X-.-.-.-.-.-.-.-.-.-.-.-.-.-.-.-.-.-X-X-X---,-X-.-.-.-.-.-.-.-.-.-.-.-X-X---------------------------,-X-.-.-.-.-.-.-,-X---------------------------------------------,-X-X-X-X-X-X-X-
X-.-.-.-.-.-.-.-.-.-.-.-.-.-.-.-.-.-X-X-X-,-,-X-.-.-.-.-.-.-.-.-.-.-.-.-X-----------------------------,-X-.-.-.-.-,-X---------------------------------------------------------------
,-X-.-.-.-.-.-.-.-.-.-.-.-.-.-.-.-,-,-X-X-X-X-.-.-.-.-.-.-.-.-.-.-.-.-.-X-------------------------------,-X-.-W-,-X-----------------------------------------------------------------
,-X-.-.-.-.-.-.-.-.-.-.-.-.-.-.-,-,-.-A-.-,-,-,-.-.-.-.-.-.-.-.-.-.-H-.-X-----------------------------,-,-X-X-.-X-,-,---------------------------------------------------------------
,-X-.-.-.-.-.-.-.-.-.-.-.-.-.-,-,-.-.-,-.-,-.-,-.-.-.-.-.-.-.-.-.-.-.-X-X-----------------------------,-X-.-.-.-.-X-X---------------------------------------------------------------
,-X-.-.-.-.-.-.-.-.-.-.-.-.-,-,-.-.-.-,-.-W-.-,-.-.-.-.-.-.-.-.-.-.-.-X-,-,-,-,-,-,-,-,-,-,-,-,-,-,-,-,-X-.-.-.-.-.-X---------------------------------------------------------------
,-X-.-.-.-.-.-.-.-.-.-.-.-,-,-,-,-,-.-,-.-,-.-,-.-.-.-.-.-.-.-.-.-.-.-X-X-X-X-X-X-X-X-X-X-X-X-X-X-X-X-X-X-,-.-.-.-,-X---------------------------------------------------------------
--X-.-.-.-.-.-.-.-.-.-.-,-,-,-,-.-,-,-,-.-,-,-,-.-.-.-.-.-.-.-.-.-.-.-.-.-.-.-.-.-.-.-.-.-.-.-.-.-.-,-,-.-<-,-.-,-X-----------------------------------------------------------------
--,-X-.-.-.-.-.-.-.-.-.-,-.-,-.-.-,-,-X-X-X-X-.-.-.-.-.-.-.-.-.-.-.-.-.-.-.-.-.-.-.-.-.-.-W-.-.-.-.-.-,-,-.-,-,-X-------------------------------------------------------------------
--,-X-.-.-.-.-.-.-.-.-.-,-.-,-.-,-,-X-X-X-,-,-X-.-.-.-.-.-.-.-.-.-.-.-.-.-.-.-.-.-.-.-.-,-X-X-X-X-X-X-X-X-X-X-X---------------------------------------------------------------------
--,-X-.-.-.-.-.-.-.-.-.-,-.-,-.-,-.-.-.-X-X-X-X-.-.-.-.-.-.-.-.-.-.-.-X-X-X-X-X-X-X-X-X-X-------------------------------------------------------------------------------------------
----,-X-.-.-.-.-.-.-.-.-,-.-,-.-,-.-.-.-.-.-.-.-.-.-.-.-.-.-.-.-.-.-,-X-------------------------------------------------------------------------------------------------------------
------,-X-.-.-.-.-.-.-.-,-.-,-,-,-,-.-.-.-.-.-.-.-.-.-.-.-.-.-.-.-.-X---------------------------------------------------------------------------------------------------------------
------,-X-.-.-.-.-.-.-.-,-.-.-,-.-,-.-.-.-.-.-.-.-.-.-.-.-.-.-.-.-.-X---------------------------------------------------------------------------------------------------------------
--------,-X-.-.-.-.-.-.-,-.-.-,-,-,-X-X-.-.-.-.-.-.-.-.-.-.-.-.-.-,-X---------------------------------------------------------------------------------------------------------------
----------,-X-.-.-.-.-.-,-,-,-.-,-,-X-X-.-.-.-.-.-.-,-,-,-,-.-.-.-X-----------------------------------------------------------------------------------------------------------------
------------,-X-.-.-.-.-.-.-,-,-,-.-X-X-X-X-X-X-.-X-X->->->-X-X-.-X-----------------------------------------------------------------------------------------------------------------
------------,-X-.-.-.-.-.-.-.-.-,-,-X-------,-X-.-X-X-X-,-X-X-X-W-X-----------------------------------------------------------------------------------------------------------------
--------------,-X-.-.-.-.-.-.-.-.-W-X-------,-X-H-.-.-.-.-.-.-.-.-X-----------------------------------------------------------------------------------------------------------------
----------------,-X-X-.-.-.-.-.-.-.-X-------,-X-.-.-.-.-.-.-.-.-.-X-----------------------------------------------------------------------------------------------------------------
--------------------,-X-X-.-.-H-.-<-X-------,-X-X-X-X-X-X-X-X-X-X-X-----------------------------------------------------------------------------------------------------------------
------------------------,-X-X-.-,-,-X-----------------------------------------------------------------------------------------------------------------------------------------------
----------------------------,-X-X-X-------------------------------------------------------------------------------------------------------------------------------------------------
