----------------------------------------------,-,-,-,-,-,-,-,-,-,-,-,-,-,-,-,-,-,-,-,-,-,-,-,-,-,-,-,-,-,-,-,-,-,-,-,-,-,-,-,-,-,-,-,-,-X-X->->->-X-,-,-,-,-,-,-,-,-,-,-,-,-,-,-,-,-,-,-,-,-,-,-,-,-,-,-,-,-,-,-,-,-,-,-,-,-,-,-,-,-,-,-,-,-,---------------------------------------------
----------------------------------------------,-X-X-X-X-X-X-X-X-X-X-X-X-X-X-X-X-X-X-X-X-X-X-X-X-X-X-X-X-X-X-X-X-X-X-X-X-X-X-X-X-X-X-X-X-X-X-X-,-X-X-X-X-X-X-X-X-X-X-X-X-X-X-X-X-X-X-X-X-X-X-X-X-X-X-X-X-X-X-X-X-X-X-X-X-X-X-X-X-X-X-X-X-X-X-X---------------------------------------------
----------------------------------------------,-X-.-.-.-.-.-.-.-A-.-.-.-.-.-.-.-.-.-.-.-.-.-A-.-.-.-.-.-.-.-.-.-.-A-.-.-.-.-.-.-.-.-.-.-.-.-.-.-.-.-.-.-.-.-.-.-.-.-.-.-.-.-.-.-.-.-.-.-.-.-.-.-.-.-.-.-.-.-.-.-.-.-.-.-.-.-.-.-.-.-.-.-.-.-X---------------------------------------------
----------------------------------------------,-X-.-.-.-.-.-.-.-.-.-.-.-.-.-.-.-.-.-.-.-.-.-.-.-.-.-.-.-.-.-.-.-.-.-.-.-.-.-.-.-.-.-.-A-.-.-.-.-.-.-A-.-.-.-.-.-.-.-.-A-.-.-.-.-.-.-.-.-.-A-.-.-.-.-.-.-.-A-.-.-.-.-.-.-.-.-.-A-.-.-.-.-.-.-X---------------------------------------------
----------------------------------------------,-X-.-.-.-.-.-.-.-.-.-.-,-,-,-,-,-,-,-,-,-,-,-,-,-,-,-,-,-,-,-,-,-,-,-,-,-,-,-,-,-,-,-,-,-,-.-.-.-.-,-,-,-,-,-,-,-,-,-,-,-,-,-,-,-,-,-,-,-,-,-,-,-,-,-,-,-,-,-,-,-,-,-,-,-,-.-.-.-.-.-.-.-.-.-X---------------------------------------------
----------------------------------------------,-X-.-.-.-X-X-X-X-X-X-X-X-X-.-.-.-.-.-.-.-.-.-.-.-.-.-.-.-.-.-.-A-.-.-.-.-.-.-.-.-.-.-.-.-,-.-.-.-.-,-.-.-.-.-.-.-.-.-.-.-.-.-.-.-.-.-.-.-.-.-.-.-.-.-.-.-.-.-.-.-.-.-.-.-X-X-X-X-X-X-X-.-.-.-X---------------------------------------------
----------------------------------------------,-X-.-.-.-X-------------,-X-.-.-.-.-.-.-.-.-.-.-.-.-.-.-.-.-.-.-.-.-.-.-.-.-.-.-.-.-.-.-.-,-.-.-<-.-,-.-.-A-.-.-.-.-.-.-.-.-.-.-.-.-.-.-.-.-.-.-.-.-.-.-.-.-.-A-.-.-.-.-.-X---------,-X-.-.-.-X---------------------------------------------
----------------------------------------------,-X-.-.-.-X-------------,-X-,-,-,-,-,-,-,-,-,-,-,-,-,-,-,-,-,-,-,-,-,-,-,-,-,-,-,-,-,-,-,-,-.-.-W-.-,-,-,-,-,-,-,-,-,-,-,-,-,-,-,-,-,-,-,-,-,-,-,-,-,-,-,-,-,-,-,-,-,-,-,-X---------,-X-.-.-.-X---------------------------------------------
----------------------------------------------,-X-.-.-.-X-------------,-X-.-.-.-.-.-.-.-.-.-.-.-.-.-.-.-.-.-.-.-.-.-.-.-.-.-.-.-.-.-.-.-,-.-.-.-.-,-.-.-.-.-.-.-.-.-.-.-.-.-.-.-.-.-.-.-.-.-.-.-.-.-.-.-.-.-.-.-.-.-.-.-X---------,-X-.-.-.-X---------------------------------------------
----------------------------------------------,-X-.-.-.-X-------------,-X-,-,-,-,-,-,-,-,-,-,-,-,-,-,-,-,-,-,-,-,-,-,-,-,-,-,-,-,-,-,-,-,-.-.-.-.-,-,-,-,-,-,-,-,-,-,-,-,-,-,-,-,-,-,-,-,-,-,-,-,-,-,-,-,-,-,-,-,-,-,-,-X---------,-X-.-.-.-X---------------------------------------------
----------------------------------------------,-X-.-.-.-X-------------,-X-.-.-.-.-.-.-.-.-.-.-.-.-.-.-.-.-.-.-.-.-.-.-.-.-.-.-.-.-.-.-.-,-.-.-.-.-,-.-.-.-.-.-.-.-.-.-.-.-.-.-.-.-A-.-.-.-.-.-.-.-.-.-.-.-.-.-.-.-.-.-.-X---------,-X-.-.-.-X---------------------------------------------
----------------------------------------------,-X-.-.-.-X-------------,-X-,-,-,-,-,-,-,-,-,-,-,-,-,-,-,-,-,-,-,-,-,-,-,-,-,-,-,-,-,-,-,-,-.-.-.-.-,-,-,-,-,-,-,-,-,-,-,-,-,-,-,-,-,-,-,-,-,-,-,-,-,-,-,-,-,-,-,-,-,-,-,-X---------,-X-.-.-.-X---------------------------------------------
----------------------------------------------,-X-.-.-.-X-------------,-X-.-.-.-.-.-.-A-.-.-.-.-.-.-.-.-.-.-.-.-.-.-.-.-.-.-.-.-A-.-.-.-,-.-.-.-.-,-.-.-A-.-.-.-.-.-.-.-.-.-.-.-.-.-.-.-.-.-.-.-.-.-.-.-.-.-A-.-.-.-.-.-X---------,-X-.-.-.-X---------------------------------------------
----------------------------------------------,-X-.-.-.-X-------------,-X-,-,-,-,-,-,-,-,-,-,-,-,-,-,-,-,-,-,-,-,-,-,-,-,-,-,-,-,-,-,-,-,-.-.-.-.-,-,-,-,-,-,-,-,-,-,-,-,-,-,-,-,-,-,-,-,-,-,-,-,-,-,-,-,-,-,-,-,-,-,-,-X---------,-X-.-.-.-X---------------------------------------------
----------------------------------------------,-X-.-.-.-X-------------,-X-.-.-.-.-.-.-.-.-.-.-.-.-.-.-.-.-.-.-.-.-.-.-.-.-.-.-.-.-.-.-.-,-.-.-H-.-,-.-.-.-.-.-.-.-.-.-.-.-.-.-.-.-.-.-.-.-.-.-.-.-.-.-.-.-.-.-.-.-.-.-.-X---------,-X-.-.-.-X---------------------------------------------
----------------------------------------------,-X-.-.-.-X-------------,-X-,-,-,-,-,-,-,-,-,-,-,-,-,-,-,-,-,-,-,-,-,-,-,-,-,-,-,-,-,-,-,-,-.-.-.-.-,-,-,-,-,-,-,-,-,-,-,-,-,-,-,-,-,-,-,-,-,-,-,-,-,-,-,-,-,-,-,-,-,-,-,-X---------,-X-.-.-.-X---------------------------------------------
----------------------------------------------,-X-.-.-.-X-------------,-X-.-.-.-.-.-.-.-.-.-.-.-.-.-.-.-.-.-.-.-.-.-.-.-.-.-.-.-.-.-.-.-,-.-.-.-.-,-.-.-.-.-.-.-.-.-.-.-.-.-.-.-.-A-.-.-.-.-.-.-.-.-.-.-.-.-.-.-.-.-.-.-X---------,-X-.-.-.-X---------------------------------------------
----------------------------------------------,-X-.-.-.-X-------------,-X-,-,-,-,-,-,-,-,-,-,-,-,-,-,-,-,-,-,-,-,-,-,-,-,-,-,-,-,-,-,-,-,-.-.-.-.-,-,-,-,-,-,-,-,-,-,-,-,-,-,-,-,-,-,-,-,-,-,-,-,-,-,-,-,-,-,-,-,-,-,-,-X---------,-X-.-.-.-X---------------------------------------------
----------------------------------------------,-X-.-.-.-X-------------,-X-.-.-.-.-.-.-.-.-.-.-.-.-.-.-.-.-.-.-A-.-.-.-.-.-.-.-.-.-.-.-.-,-.-.-.-.-,-.-.-A-.-.-.-.-.-.-.-.-.-.-.-.-.-.-.-.-.-.-.-.-.-.-.-.-.-A-.-.-.-.-.-X---------,-X-.-.-.-X---------------------------------------------
----------------------------------------------,-X-.-.-.-X-------------,-X-,-,-,-,-,-,-,-,-,-,-,-,-,-,-,-,-,-,-,-,-,-,-,-,-,-,-,-,-,-,-,-,-.-.-.-.-,-,-,-,-,-,-,-,-,-,-,-,-,-,-,-,-,-,-,-,-,-,-,-,-,-,-,-,-,-,-,-,-,-,-,-X---------,-X-.-.-.-X---------------------------------------------
------,-,-,-,---------,-,-,-,---------,-,-,-,-,-X-.-.-.-X-------------,-X-.-.-.-.-.-.-.-.-.-.-.-.-.-.-.-.-.-.-.-.-.-.-.-.-.-.-.-.-.-.-.-,-.-.-.-.-,-.-.-.-.-.-.-.-.-.-.-.-.-.-.-.-.-.-.-.-.-.-.-.-.-.-.-.-.-.-.-.-.-.-.-X---------,-X-.-.-.-X-,-,-,-,-----,-,-,-,---------,-,-,-,---------
------,-X-X-X---------,-X-X-X---------,-X-X-X-,-X-.-.-.-X-------------,-X-,-,-,-,-,-,-,-,-,-,-,-,-,-,-,-,-,-,-,-,-,-,-,-,-,-,-,-,-,-,-,-,-.-.-.-.-,-,-,-,-,-,-,-,-,-,-,-,-,-,-,-,-,-,-,-,-,-,-,-,-,-,-,-,-,-,-,-,-,-,-,-X---------,-X-.-.-.-X-,-X-X8X-----,-X-X-X---------,-X-X-X---------
------,-X-W-X-,-,-,-,-,-X-.-X-,-,-,-,-,-X-.-X-,-X-.-.-.-X-----,-,-,-,-,-X-.-.-.-.-.-.-.-.-.-.-.-.-.-.-.-.-.-.-.-.-.-.-.-.-.-.-.-.-.-.-.-,-.-.-.-.-,-.-.-.-.-.-.-.-.-.-.-.-.-.-.-.-A-.-.-.-.-.-.-.-.-.-.-.-.-.-.-.-.-.-.-X-,-,-,-,-,-X-.-.-.-X-,-X-W-X-,-,-,-X-.-X-,-,-,-,-,-X-.-X---------
----,-,-X-.-X-X-X-X-X-X-X-.-X-X-X-X-X-X-X-.-X-,-X-.-.-.-X-----,-X-X-X-X-X-,-,-,-,-,-,-,-,-,-,-,-,-,-,-,-,-,-,-,-,-,-,-,-,-,-,-,-,-,-,-,-,-.-.-.-.-,-,-,-,-,-,-,-,-,-,-,-,-,-,-,-,-,-,-,-,-,-,-,-,-,-,-,-,-,-,-,-,-,-,-,-X-X-X-X-X-,-X-.-.-.-X-,-X-.-X-X-X-X-X-.-X-X-X-X-X-X-X-.-X-,-------
,-,-,-X-.-.-.-.-.-.-.-.-.-.-.-.-.-.-.-.-.-.-X-,-X-.-.-.-X-----,-X-.-.-.-.-.-.-.-.-.-.-.-.-.-.-.-.-.-.-.-.-.-.-.-.-.-.-.-.-.-.-.-.-.-.-.-.-.-.-.-.-.-.-.-.-.-.-.-.-.-.-.-.-.-.-.-.-.-.-.-.-.-.-.-.-.-.-.-.-.-.-.-.-.-.-.-.-.-.-.-X-,-X-.-.-.-X-,-X-.-.-.-.-.-.-.-.-.-.-.-.-.-.-.-.-X-,-,-,-
X-X-X-.-.-.-.-.-.-.-.-.-.-.-.-.-.-.-.-.-.-.-X-,-X-.-.-.-X-----,-X-.-.-.-.-.-.-.-.-.-.-.-.-.-.-.-.-.-.-.-.-.-.-.-.-.-.-.-.-.-.-.-.-.-.-.-.-.-.-.-.-.-.-.-.-.-.-.-A-.-.-.-.-.-.-.-.-.-.-.-.-.-.-.-.-.-.-.-.-.-.-.-.-.-.-.-.-.-.-.-X-,-X-.-.-.-X-,-X-.-.-.-.-.-.-.-.-.-.-.-.-.-.-.-.-.-X-X-X-
X-.-.-.-.-.-.-.-.-.-.-.-.-.-.-.-.-.-.-.-.-.-X-,-X-.-.-.-X-----,-X-.-.-<-.-.-.-.-.-.-.-.-.-.-.-.-.-.-.-.-.-.-.-.-.-.-.-.-.-.-.-.-.-.-.-.-A-.-.-.-.-.-.-.-.-.-.-.-.-.-.-.-.-.-.-.-.-.-.-A-.-.-.-.-.-.-.-.-.-.-.-.-.-.-<-.-.-.-.-.-X-,-X-.-.-.-X-,-X-.-.-.-.-.-.-.-.-.-.-.-.-.-.-.-.-.-.-.-X-
X-X-X-.-.-.-.-.-.-.-.-.-.-.-.-.-.-.-.-.-.-.-X-,-X-.-.-.-X-----,-X-.-.-.-.-.-.-.-.-.-.-.-A-.-.-.-.-.-.-.-.-.-.-.-A-.-.-.-.-.-.-.-.-.-.-.-.-.-.-.-.-.-.-.-.-.-.-.-.-.-.-.-.-.-.-.-.-.-.-.-.-.-.-.-.-.-.-.-.-.-.-.-.-.-.-.-.-.-.-.-X-,-X-.-.-.-X-,-X-.-.-.-.-.-.-.-.-.-.-.-.-.-.-.-.-.-X-X-X-
--,-X-.-.-.-.-.-.-.-.-.-.-.-.-.-.-.-.-.-.-.-X-,-X-.-.-.-X-----,-X-.-.-.-.-.-.-.-.-.-.-.-.-.-.-.-.-.-.-.-.-.-.-.-.-.-.-.-.-.-.-.-.-.-.-.-.-.-.-.-.-.-.-.-.-.-.-.-.-.-.-.-.-.-.-.-.-.-.-.-.-.-.-.-.-.-.-.-.-.-.-.-.-.-.-.-.-.-.-.-X-,-X-.-.-.-X-,-X-.-.-.-.-.-.-.-.-.-.-.-.-.-.-.-.-.-X-----
--,-X-.-.-.-.-.-.-.-.-.-.-.-.-.-.-.-.-.-.-.-X-,-X-.-.-.-X-----,-X-.-.-.-.-.-.-.-.-.-.-.-.-.-.-.-.-.-.-.-.-.-.-.-.-.-.-.-.-.-.-.-.-.-.-.-.-.-.-.-.-.-.-.-.-.-.-.-.-.-.-.-.-.-.-.-.-.-.-.-.-.-.-.-.-.-.-.-.-.-.-.-.-.-.-.-.-.-.-.-X-,-X-.-.-.-X-,-X-.-.-.-.-.-.-.-.-.-.-.-.-.-.-.-.-.-X-----
--,-X-.-.-.-.-.-.-.-.-.-.-.-.-.-.-.-.-.-.-.-X-,-X-.-.-.-X-----,-X-.-.-.-.-.-.-.-.-.-.-.-.-.-.-.-.-.-.-.-.-.-.-.-.-.-.-.-.-.-.-.-.-.-.-.-.-.-.-.-.-.-.-.-.-.-.-.-.-.-.-.-.-.-.-.-.-.-.-.-.-.-.-.-.-.-.-.-.-.-.-.-.-.-.-.-.-.-.-.-X-,-X-.-.-.-X-,-X-.-.-.-.-.-.-.-.-.-.-.-.-.-.-.-.-.-X-----
--,-X-.-.-.-.-.-.-.-.-.-.-.-.-.-.-.-.-.-.-.-X-,-X-.-.-.-X-----,-X-.-.-.-.-.-.-.-.-.-.-.-.-.-.-.-.-.-.-.-.-.-.-.-.-.-.-.-.-.-.-.-.-.-.-.-.-.-.-.-.-.-.-.-.-.-.-.-.-.-.-.-.-.-.-.-.-.-.-.-.-.-.-.-.-.-.-.-.-.-.-.-.-.-.-.-.-.-.-.-X-,-X-.-.-.-X-,-X-.-.-.-.-.-.-.-.-.-.-.-.-.-.-.-.-.-X-----
,-,-X-.-.-.-.-.-.-.-.-.-.-.-.-.-.-.-.-.-.-.-X-,-X-.-<-.-X-----,-X-.-.-.-.-.-.-.-.-.-.-.-.-.-.-.-.-.-.-.-.-.-.-.-.-.-.-.-.-.-.-.-.-.-.-.-.-.-.-.-.-.-.-.-.-.-.-.-.-.-.-.-.-.-.-.-.-.-.-.-.-.-.-.-.-.-.-.-.-.-.-.-.-.-.-.-.-.-.-.-X-,-X-.-<-,-X-,-X-.-.-.-.-.-.-.-.-.-.-.-.-.-.-.-.-.-X-,-,-
X-X-X-.-.-.-.-.-.-.-.-.-.-.-.-.-.-.-.-.-.-.-X4X4X4.-.-.-X-----,-X-.-.-.-.-.-.-.-.-.-.-.-.-.-.-.-.-.-.-.-.-.-.-.-.-.-.-.-.-.-.-.-.-.-.-.-.-.-.-.-.-.-.-.-.-.-.-.-.-.-.-.-.-.-.-.-.-.-.-.-.-.-.-.-.-.-.-.-.-.-.-.-.-.-.-.-.-.-.-.-X-,-X-.-.-,-X2X2X2.-.-.-.-.-.-.-.-.-.-.-.-.-.-.-.-.-X-X-X-
X-W-.-.-.-.-.-.-.-.-.-H-.-.-.-.-.-.-.-.-.-.-.4.4,4.-.-.-X-----,-X-.-.-.-.-.-.-.-.-.-.-.-.-.-.-.-.-.-.-.-.-.-.-.-.-.-.-.-.-.-.-.-.-.-.-.-.-.-.-.-.-.-.-.-.-.-.-.-.-.-.-.-.-.-.-.-.-.-.-.-.-.-.-.-.-.-.-.-.-.-.-.-.-.-.-.-.-.-.-.-X-,-X-.-.-,-.2.2.2.-.-.-.-.-.-.-.-.-.-.-.-.-.-.-.-.-W-.-X-
X-X-X-.-.-.-.-.-.-.-.-.-.-.-.-.-.-.-.-.-.-.-.4.4,4.-W-.-X-----,-X-.-.-.-.-.-.-.-.-.-.-.-.-.-.-.-.-.-.-.-.-.-.-.-.-.-.-.-.-.-.-.-.-.-.-.-.-.-.-.-.-.-.-.-.-.-.-.-.-.-.-.-.-.-.-.-.-.-.-.-.-.-.-.-.-.-.-.-.-.-.-.-.-.-.-.-.-.-.-.-X-,-X-.-W-,-.2.2.2.-.-.-.-.-.-.-.-.-.-.-.-.-.-.-.-.-X-X-X-
--,-X-.-.-.-.-.-.-.-.-.-.-.-.-.-.-.-.-.-.-.-.4.4,4.-.-.-X-----,-X-.-.-.-.-.-.-.-.-.-.-.-.-.-.-.-.-.-.-.-.-.-.-.-.-.-.-.-.-.-.-.-.-.-.-.-.-.-.-.-.-.-.-.-.-.-.-.-.-.-.-.-.-.-.-.-.-.-.-.-.-.-.-.-.-.-A-.-.-.-.-.-.-.-.-.-.-.-.-.-X-,-X-.-.-,-.2.2.2.-.-.-.-.-.-.-.-.-.-.-.-.-.-.-.-.-X-----
--,-X-.-.-.-.-.-.-.-.-.-.-.-.-.-.-.-.-.-.-.-X4X4X4X-X-X-X-----,-X-.-.-.-.-.-.-.-.-.-.-.-.-.-.-.-.-.-A-.-.-.-.-.-.-.-.-.-.-.-A-.-.-.-.-.-.-.-.-.-.-.-A-.-.-.-.-.-.-.-.-.-.-A-.-.-.-.-.-.-.-.-.-.-.-.-.-.-.-.-.-.-.-.-.-.-.-.-.-.-X-,-X-X-X-X-X2X2X2.-.-.-.-.-.-.-.-.-.-.-.-.-.-.-.-.-X-----
--,-X-.-.-.-.-.-.-.-.-.-.-.-.-.-.-.-.-.-.-.-X-----------------,-X-.-.-.-.-.-.-.-.-.-.-.-.-.-.-.-.-.-.-.-.-.-.-.-.-.-.-.-.-.-.-.-.-.-.-.-.-.-.-.-.-.-.-.-.-.-.-.-.-.-.-.-.-.-.-.-.-.-.-.-.-.-.-.-.-.-.-.-.-.-.-.-.-.-.-.-.-.-.-.-X-------------,-X-.-.-.-.-.-.-.-.-.-.-.-.-.-.-.-.-.-X-----
--,-X-.-.-.-.-.-.-.-.-.-.-.-.-.-.-.-.-.-.-.-X-----------------,-X-.-.-.-.-.-.-.-.-.-.-.-.-.-.-.-.-.-.-.-.-.-.-.-.-.-.-.-.-.-.-.-.-.-.-.-.-.-.-.-.-.-.-.-.-.-.-.-.-.-.-.-.-.-.-.-.-.-.-.-.-.-.-.-.-.-.-.-.-.-.-.-.-.-.-.-.-.-.-.-X-------------,-X-.-.-.-.-.-.-.-.-.-.-.-.-.-.-.-.-.-X-----
,-,-X-.-.-.-.-.-.-.-.-.-.-.-.-.-.-.-.-.-.-.-X-----------------,-X-.-.-.-.-.-.-.-.-.-.-.-.-.-.-.-.-.-.-.-.-.-.-.-.-.-.-.-.-.-.-.-.-.-.-.-.-.-.-.-.-.-.-.-.-.-.-.-.-.-.-.-.-.-.-.-.-.-.-.-.-.-.-.-.-.-.-.-.-.-.-.-.-.-.-.-.-.-.-.-X-------------,-X-.-.-.-.-.-.-.-.-.-.-.-.-.-.-.-.-.-X-,-,-
X-X-X-.-.-.-.-.-.-.-.-.-.-.-.-.-.-.-.-.-X-X-X-----------------,-X-.-,-,-,-.-.-.-.-.-.-.-.-.-.-.-.-.-.-.-.-.-.-.-.-.-.-.-.-.-.-.-.-.-.-.-.-.-.-.-.-.-.-.-.-.-.-.-.-.-.-.-.-.-.-.-.-.-.-.-.-.-.-.-.-.-.-.-.-.-.-.-.-.-.-.-,-,-,-.-X-------------,-X-X-X-.-.-.-.-.-.-.-.-.-.-.-.-.-.-.-X-X-X-
X-.-.-.-.-.-.-.-.-.-.-.-.-.-.-.-.-.-.-.-X-,-,-,-,-,-,-,-,-,-,-,-X-.-,-,-,-.-.-.-.-.-.-.-.-.-.-.-.-.-.-.-.-.-.-.-.-.-.-.-.-.-.-.-.-.-.-.-.-.-.-.-.-.-.-.-.-.-.-.-.-.-.-.-.-.-.-.-.-.-.-.-.-.-.-.-.-.-.-.-.-.-.-.-.-.-.-.-,-,-,-,-X-,-,-,-,-,-,-,-,-,-X-.-.-.-.-.-.-.-.-.-.-.-.-.-.-.-.-H-X-
X-X-X-.-.-.-.-.-.-.-.-.-.-.-.-.-.-.-.-.-X-X-X-X-X-X-X-X-X-X-X-X-X-.-,-./,/.-.-.-.-.-.-.-.-.-.-.-.-.-.-.-.-.-.-.-.-.-.-.-.-.-.-.-.-.-.-.-.-.-.-.-.-.-.-.-.-.-.-.-.-.-.-.-.-.-.-.-.-.-.-.-.-.-.-.-.-.-.-.-.-.-.-.-.-.-.-.-,-..,.,-X-X-X-X-X-X-X-X-X-X-X-.-.-.-.-.-.-.-.-.-.-.-.-.-.-.-X-X-X-
--,-X-.-.-.-.-.-.-.-.-.-.-.-.-.-.-.-.-.-.-.-.-,-,-,-,-,-,-,-,-,-,-.-,-./,/.-.-.-.-.-.-.-.-.-.-.-.-.-.-.-.-.-.-.-.-.-.-.-.-.-.-.-.-.-.-.-.-.-.-.-.-.-.-.-.-.-.-.-.-.-.-.-.-.-.-.-.-.-.-.-.-.-.-.-.-.-.-.-.-.-.-.-.-.-.-.-,-..,.,-,-,-,-,-,-,-,-,-,-.-.-.-.-.-.-.-.-.-.-.-.-.-.-.-.-.-X-----
--,-X-.-.-.-.-.-.-.-.-.-.-.-.-.-.-.-.-.-.-.-.-,-,-,-,-,-,-,-,-,-,-.-,-./,/.-.-.-.-.-.-.-.-.-.-.-.-.-.-.-.-.-.-.-A-.-.-.-.-.-.-.-.-.-.-.-.-.-.-.-.-.-.-.-.-.-.-.-.-.-.-.-.-.-.-.-.-.-.-A-.-.-.-.-.-.-.-.-.-.-.-.-.-.-.-.-,-..,.,-,-,-,-,-,-,-,-,-,-.-.-.-.-.-.-.-.-.-.-.-.-.-.-.-.-.-X-----
--,-X-.-.-.-.-.-.-.-.-.-.-.-.-.-.-.-.-.-.-.-.-,-,-,-,-,-,-,-,-,-,-.-,-./,/.-.-.-.-.-.-.-A-.-.-.-.-.-.-.-.-.-.-.-.-.-.-.-.-.-.-.-.-.-.-.-A-.-.-.-.-.-.-.-.-.-.-.-A-.-.-.-.-.-.-.-.-.-.-.-.-.-.-.-.-.-.-.-.-.-.-.-.-.-.-.-,-..,.,-,-,-,-,-,-,-,-,-,-.-.-.-.-.-.-.-.-.-.-.-.-.-.-.-.-.-X-----
--,-X-.-.-.-.-.-.-.-.-.-.-.-.-.-.-.-.-.-.-<-.-,-,-,-,-,-,-,-,-,-,-.-,-./,/.-.-.-.-.-.-.-.-.-.-.-.-.-.-.-.-.-.-.-.-.-.-.-.-.-.-.-.-.-.-.-.-.-.-.-.-.-.-.-.-.-.-.-.-.-.-.-.-.-.-.-.-.-.-.-.-.-.-.-.-.-.-.-.-.-.-.-.-.-.-.-,-..,.,-,-,-,-,-,-,-,-,-,-.-<-.-.-.-.-.-.-.-.-.-.-.-.-.-.-.-X-----
,-,-X-.-.-.-.-.-.-.-.-.-.-.-.-.-.-.-.-.-.-.-.-,-,-,-,-,-,-,-,-,-,-.-,-./,/.-.-.-.-.-.-.-.-.-.-.-.-.-.-.-.-.-.-.-.-.-.-.-.-.-.-.-.-.-.-.-.-.-.-.-.-.-.-.-.-.-.-.-.-.-.-.-.-.-.-.-.-.-.-.-.-.-.-.-.-.-.-.-.-.-.-.-.-.-.-.-,-..,.,-,-,-,-,-,-,-,-,-,-.-.-.-.-.-.-.-.-.-.-.-.-.-.-.-.-.-X-,-,-
X-X-X-.-.-.-.-.-.-.-.-.-.-.-.-.-.-.-.-.-.-.-.-,-,-,-,-,-,-,-,-,-,-.-,-./,/.-.-.-.-.-.-.-.-.-.-.-.-.-.-.-.-.-.-.-.-.-.-.-.-.-.-.-.-.-.-.-.-.-.-.-.-.-.-.-.-.-.-.-.-.-.-.-.-.-.-.-.-.-.-.-.-.-.-.-.-.-.-.-.-.-.-.-.-.-.-.-,-,.,.,-,-,-,-,-,-,-,-,-,-.-.-.-.-.-.-.-.-.-.-.-.-.-.-.-.-.-X-X-X-
X-.-.-.-.-.-.-.-.-.-.-.-.-.-.-.-.-.-.-.-.-.-.-,-,-,-,-,-,-,-,-,-,-.-,-,/,/.-.-.-.-.-.-.-.-.-.-.-.-.-.-.-.-.-.-.-.-.-.-.-.-.-.-.-.-.-.-.-.-.-.-.-.-.-.-.-.-.-.-.-.-.-.-.-.-.-.-.-.-.-.-.-.-.-.-.-.-.-.-.-.-.-.-.-.-.-.-.-,-..,.,-X-X-X-X-X-X-X-X-X-X-X-.-.-.-.-.-.-.-.-.-.-.-.-.-.-.-.-H-X-
X-X-X-.-.-.-.-.-.-.-.-.-.-.-.-.-.-.-.-.-X-X-X-X-X-X-X-X-X-X-X-X-X-.-,-./,/.-.-.-.-.-.-.-.-.-.-.-.-.-.-.-.-.-.-.-.-.-.-.-.-.-.-.-.-.-.-.-.-.-.-.-.-.-.-.-.-.-.-.-.-.-.-.-.-.-.-.-.-.-.-.-.-.-.-.-.-.-.-.-.-.-.-.-.-.-.-.-,-,-,-.-X-------------,-,-,-X-.-.-.-.-.-.-.-.-.-.-.-.-.-.-.-X-X-X-
--,-X-.-.-.-.-.-.-.-.-.-.-.-.-.-.-.-.-.-X-,-,-----------------,-X-.-,-,-,-.-.-.-.-.-.-.-.-.-.-.-.-.-.-.-.-.-.-.-.-.-.-.-.-.-.-.-.-.-.-.-.-.-.-.-.-.-.-.-.-.-.-.-.-.-.-.-.-.-.-.-.-.-.-.-.-.-.-.-.-.-.-.-.-.-.-.-.-.-.-.-.-.-.-.-X-------------,-X-X-X-.-.-.-.-.-.-.-.-.-.-.-.-.-.-.-X-----
--,-X-.-.-.-.-.-.-.-.-.-.-.-.-.-.-.-.-.-X-X-X-----------------,-X-.-.-.-.-.-.-.-.-.-.-.-.-.-.-.-.-.-.-.-.-.-.-.-.-.-.-.-.-.-.-.-.-.-.-.-.-.-.-.-.-.-.-.-.-.-.-.-.-.-.-.-.-.-.-.-.-.-.-.-.-.-.-.-.-.-.-.-.-.-.-.-.-.-.-.-.-.-.-.-X-------------,-X-.-.-.-.-.-.-.-.-.-.-.-.-.-.-.-.-.-X-----
--,-X-.-.-.-.-.-.-.-.-.-.-.-.-.-.-.-.-.-.-.-X-----------------,-X-.-.-.-.-.-.-.-.-.-.-.-.-.-.-.-.-.-.-.-.-.-.-.-.-.-.-.-.-.-.-.-.-.-.-.-.-.-.-.-.-.-.-.-.-.-.-.-.-.-.-.-.-.-.-.-.-.-.-.-.-.-.-.-.-.-.-.-.-.-.-.-.-.-.-.-.-.-.-.-X-------------,-X-.-.-.-.-.-.-.-.-.-.-.-.-.-.-.-.-.-X-----
--,-X-.-.-.-.-.-.-.-.-.-.-.-.-.-.-.-.-.-.-.-X-----------------,-X-.-.-.-.-.-.-.-.-.-.-.-.-.-.-.-.-.-.-.-.-.-.-.-.-.-.-.-.-.-.-.-.-.-.-.-.-.-.-.-.-.-.-.-.-.-.-.-.-.-.-.-.-.-.-.-.-.-.-.-.-.-.-.-.-.-A-.-.-.-.-.-.-.-.-.-.-.-.-.-X-,-,-,-,-,-,-,-X-.-.-.-.-.-.-.-.-.-.-.-.-.-.-.-.-.-X-----
,-,-X-.-.-.-.-.-.-.-.-.-.-.-.-.-.-.-.-.-.-.-X-,-,-,-,-,-,-----,-X-.-.-.-.-.-.-.-.-.-.-.-.-.-.-.-.-.-.-.-.-.-.-.-.-.-.-.-.-.-.-.-.-.-.-.-.-.-.-.-.-.-.-.-.-.-.-.-.-.-.-.-.-A-.-.-.-.-.-.-.-.-.-.-.-.-.-.-.-.-.-.-.-.-.-.-.-.-.-.-X-,-X-X-X-X-X1X1X1.-.-.-.-.-.-.-.-.-.-.-.-.-.-.-.-.-X-,-,-
X-X-X-.-.-.-.-.-.-.-.-.-.-.-.-.-.-.-.-.-.-.-X3X3X3X-X-X-X-----,-X-.-.-.-.-.-.-.-.-.-.-.-.-.-.-.-.-.-.-.-.-.-.-.-.-.-.-.-.-.-A-.-.-.-.-.-.-.-.-.-.-.-A-.-.-.-.-.-.-.-.-.-.-.-.-.-.-.-.-.-.-.-.-.-.-.-.-.-.-.-.-.-.-.-.-.-.-.-.-.-X-,-X-.-.-,-.1.1.1.-.-.-.-.-.-.-.-.-.-.-.-.-.-.-.-.-X-X-X-
X-W-.-.-.-.-.-.-.-.-.-H-.-.-.-.-.-.-.-.-.-.-.3.3,3.-.-.-X-----,-X-.-.-.-.-.-.-.-.-.-.-.-.-.-.-.-.-.-A-.-.-.-.-.-.-.-.-.-.-.-.-.-.-.-.-.-.-.-.-.-.-.-.-.-.-.-.-.-.-.-.-.-.-.-.-.-.-.-.-.-.-.-.-.-.-.-.-.-.-.-.-.-.-.-.-.-.-.-.-.-X-,-X-.-.-,-.1.1.1.-.-.-.-.-.-.-.-.-.-.-.-.-.-.-.-.-W-.-X-
X-X-X-.-.-.-.-.-.-.-.-.-.-.-.-.-.-.-.-.-.-.-.3.3,3.-W-.-X-----,-X-.-.-.-.-.-.-.-.-.-.-.-.-.-.-.-.-.-.-.-.-.-.-.-.-.-.-.-.-.-.-.-.-.-.-.-.-.-.-.-.-.-.-.-.-.-.-.-.-.-.-.-.-.-.-.-.-.-.-.-.-.-.-.-.-.-.-.-.-.-.-.-.-.-.-.-.-.-.-.-X-,-X-.-W-,-.1.1.1.-.-.-.-.-.-.-.-.-.-.-.-.-.-.-.-.-X-X-X-
--,-X-.-.-.-.-.-.-.-.-.-.-.-.-.-.-.-.-.-.-.-.3.3,3.-.-.-X-----,-X-.-.-.-.-.-.-.-.-.-.-.-.-.-.-.-.-.-.-.-.-.-.-.-.-.-.-.-.-.-.-.-.-.-.-.-.-.-.-.-.-.-.-.-.-.-.-.-.-.-.-.-.-.-.-.-.-.-.-.-.-.-.-.-.-.-.-.-.-.-.-.-.-.-.-.-.-.-.-.-X-,-X-.-.-,-.1.1.1.-.-.-.-.-.-.-.-.-.-.-.-.-.-.-.-.-X-----
--,-X-.-.-.-.-.-.-.-.-.-.-.-.-.-.-.-.-.-.-.-X3X3X3.-.-.-X-----,-X-.-.-.-.-.-.-.-.-.-.-.-.-.-.-.-.-.-.-.-.-.-.-.-.-.-.-.-.-.-.-.-.-.-.-.-.-.-.-.-.-.-.-.-.-.-.-.-.-.-.-.-.-.-.-.-.-.-.-.-.-.-.-.-.-.-.-.-.-.-.-.-.-.-.-.-.-.-.-.-X-,-X-.-.-,-X1X1X1.-.-.-.-.-.-.-.-.-.-.-.-.-.-.-.-.-X-----
--,-X-.-.-.-.-.-.-.-.-.-.-.-.-.-.-.-.-.-.-.-X-,-X-.-<-.-X-----,-X-.-.-<-.-.-.-.-.-.-.-.-.-.-.-.-.-.-.-.-.-.-.-.-.-.-.-.-.-.-.-.-.-.-.-.-.-.-.-.-.-.-.-.-.-.-.-.-.-.-.-.-.-.-.-.-.-.-.-.-.-.-.-.-.-.-.-.-.-.-.-.-.-.-.-.-.-.-.-.-X-,-X-.-<-.-X-,-X-.-.-.-.-.-.-.-.-.-.-.-.-.-.-.-.-.-X-----
--,-X-.-.-.-.-.-.-.-.-.-.-.-.-.-.-.-.-.-.-.-X-,-X-.-.-.-X-----,-X-.-.-.-.-.-.-.-.-.-.-.-A-.-.-.-.-.-.-.-.-.-.-.-.-.-.-.-.-.-.-.-.-.-.-.-.-.-.-.-.-.-.-.-.-.-.-.-.-.-.-.-.-.-.-.-.-.-.-.-.-.-.-.-.-.-.-.-.-.-.-.-.-.-.-.-.-.-.-.-X-,-X-.-.-.-X-,-X-.-.-.-.-.-.-.-.-.-.-.-.-.-.-.-.-.-X-----
,-,-X-.-.-.-.-.-.-.-.-.-.-.-.-.-.-.-.-.-.-.-X-,-X-.-.-.-X-----,-X-.-.-.-.-.-.-.-.-.-.-.-.-.-.-.-.-.-.-.-.-.-.-.-.-.-.-.-.-.-.-.-.-.-.-.-.-.-.-.-.-.-.-.-.-.-.-.-.-.-.-.-.-.-.-.-.-.-.-A-.-.-.-.-.-.-.-.-.-.-.-.-.-.-.-.-<-.-.-.-X-,-X-.-.-.-X-,-X-.-.-.-.-.-.-.-.-.-.-.-.-.-.-.-.-.-X-,-,-
X-X-X8.-.-.-.-.-.-.-.-.-.-.-.-.-.-.-.-.-.-.-X-,-X-.-.-.-X-----,-X-.-.-.-.-.-.-.-.-.-.-.-.-.-.-.-.-.-.-.-.-.-.-A-.-.-.-.-.-.-.-.-.-.-.-.-A-.-.-.-.-.-.-.-.-.-.-.-A-.-.-.-.-.-.-.-.-.-.-.-.-.-.-.-.-.-.-.-.-.-.-.-.-.-.-.-.-.-.-.-X-,-X-.-.-.-X-,-X-.-.-.-.-.-.-.-.-.-.-.-.-.-.-.-.-.-X7X-X-
X-.-t8.-.-.-.-.-.-.-.-.-.-.-.-.-.-.-.-.-.-.-X-,-X-.-.-.-X-----,-X-.-.-.-.-.-.-.-.-.-.-.-.-.-.-.-.-.-.-.-.-.-.-.-.-.-.-.-.-.-.-.-.-.-.-.-.-.-.-.-.-.-.-.-.-.-.-.-.-.-.-.-.-.-.-.-.-.-.-.-.-.-.-.-.-.-.-.-.-.-.-.-.-.-.-.-.-.-.-.-X-,-X-.-.-.-X-,-X-.-.-.-.-.-.-.-.-.-.-.-.-.-.-.-.-.-t7.-X-
X-X-X8.-.-.-.-.-.-.-.-.-.-.-.-.-.-.-.-.-.-.-X-,-X-.-.-.-X-----,-X-.-.-.-.-.-.-.-.-.-.-.-.-.-.-.-.-.-.-.-.-.-.-.-.-.-.-.-.-.-.-.-.-.-.-.-.-.-.-.-.-.-.-.-.-.-.-.-.-.-.-.-.-.-.-.-.-.-.-.-.-.-.-.-.-.-.-.-.-.-.-.-.-.-.-.-.-.-.-.-X-,-X-.-.-.-X-,-X-.-.-.-.-.-.-.-.-.-.-.-.-.-.-.-.-,-X7X-X-
----,-X-.-.-.-.-.-.-.-.-.-.-.-.-.-.-.-.-.-.-X-,-X-.-.-.-X-----,-X-.-.-,-,-,-,-,-,-,-,-,-,-,-,-,-,-,-,-,-,-,-,-,-,-,-,-,-,-,-,-,-,-,-,-,-,-.-.-.-.-,-,-,-,-,-,-,-,-,-,-,-,-,-,-,-,-,-,-,-,-,-,-,-,-,-,-,-,-,-,-,-,-,-,-,-,-.-.-.-X-,-X-.-.-.-X-,-X-.-.-.-.-.-.-.-.-.-.-.-.-.-.-.-,-X-------
------,-X-.-X-X-X-X-X-X-X-.-X-X-X-X-X-X-X7.-X-,-X-.-.-.-X-----,-X-X-X-X-X-.-.-.-A-.-.-.-.-.-.-.-.-.-.-.-.-.-.-.-.-.-.-.-.-.-A-.-.-.-.-.-,-.-.-.-.-,-.-.-.-.-.-.-.-.-.-.-.-.-.-.-.-.-.-.-.-.-.-.-.-.-.-.-.-.-.-.-.-.-.-.-X-X-X-X-X-,-X-.-.-.-X-,-X-W-X-X-X-X-X-.-X-X-X-X-X-X-X-.-X---------
------,-X-.-X---------,-X-.-X---------,-X-.-X-,-X-.-.-.-X-------------,-X-,-,-,-,-,-,-,-,-,-,-,-,-,-,-,-A-,-,-,-,-,-,-,-,-,-,-,-,-,-,-,-,-.-.-.-.-,-,-,-,-,-,-,-,-,-,-,-,-,-,-,-,-,-,-,-,-,-,-,-,-,-,-,-,-,-,-,-,-,-,-,-X---------,-X-.-.-.-X-,-X-.-X-----,-X-.-X---------,-X-W-X---------
------,-X-X-X---------,-X-X-X---------,-X-X-X-,-X-.-.-.-X-------------,-X-.-.-.-.-.-.-.-.-.-.-.-.-.-.-.-.-.-.-.-.-.-.-.-.-.-.-.-.-.-.-.-,-.-.-.-.-,-.-.-.-.-.-.-.-.-.-.-.-.-.-.-.-A-.-.-.-.-.-.-.-.-.-.-.-.-.-.-.-.-.-.-X---------,-X-.-.-.-X-,-X-X-X-----,-X-X-X---------,-X-X-X---------
----------------------------------------------,-X-.-.-.-X-------------,-X-,-,-,-A-,-,-,-,-,-,-,-,-,-,-,-A-,-,-,-,-,-,-,-,-,-A-,-,-,-,-,-,-.-.-.-.-,-,-,-,-,-,-,-,-,-,-,-,-,-,-,-,-,-,-,-,-,-,-,-,-,-,-,-,-,-,-,-,-,-,-,-X---------,-X-.-.-.-X---------------------------------------------
----------------------------------------------,-X-.-.-.-X-------------,-X-.-.-.-.-.-.-.-.-.-.-.-.-.-.-.-A-.-.-.-.-.-.-.-.-.-.-.-.-.-.-.-,-.-.-.-.-,-.-.-.-.-.-.-.-.-.-.-.-.-.-.-.-.-.-.-.-.-.-.-.-.-.-.-.-.-.-.-.-.-.-.-X---------,-X-.-.-.-X---------------------------------------------
----------------------------------------------,-X-.-.-.-X-------------,-X-,-,-,-A-,-,-,-,-,-,-,-,-,-,-,-,-,-,-,-,-,-,-,-,-,-A-,-,-,-,-,-,-.-.-.-.-,-,-,-,-,-,-,-,-,-,-,-,-,-,-,-,-,-,-,-,-,-,-,-,-,-,-,-,-,-,-,-,-,-,-,-X---------,-X-.-.-.-X---------------------------------------------
----------------------------------------------,-X-.-.-.-X-------------,-X-.-.-.-.-.-.-.-.-.-.-.-.-.-.-.-.-.-.-.-.-.-.-.-.-.-.-.-.-.-.-.-,-.-.-.-.-,-.-.-.-.-.-.-.-.-.-.-.-.-.-.-.-.-.-.-.-.-.-.-.-.-.-.-.-.-.-.-.-.-.-.-X---------,-X-.-.-.-X---------------------------------------------
----------------------------------------------,-X-.-.-.-X-------------,-X-,-,-,-A-,-,-,-,-,-,-,-,-,-,-,-A-,-,-,-,-,-,-,-,-,-A-,-,-,-,-,-,-.-.-.-.-,-,-,-,-,-,-,-,-,-,-,-,-,-,-,-,-,-,-,-,-,-,-,-,-,-,-,-,-,-,-,-,-,-,-,-X---------,-X-.-.-.-X---------------------------------------------
----------------------------------------------,-X-.-.-.-X-------------,-X-.-.-.-.-.-.-.-.-.-.-.-.-.-.-.-.-.-.-.-.-.-.-.-.-.-.-.-.-.-.-.-,-.-.-.-.-,-.-.-.-.-.-.-.-.-.-.-.-.-.-.-.-.-.-.-.-.-.-.-.-.-A-.-.-.-.-.-.-.-.-.-X---------,-X-.-.-.-X---------------------------------------------
----------------------------------------------,-X-.-.-.-X-------------,-X-,-,-,-A-,-,-,-,-,-,-,-,-,-,-,-A-,-,-,-,-,-,-,-,-,-A-,-,-,-,-,-,-.-.-.-.-,-,-,-,-,-,-,-,-A-,-,-,-,-,-,-,-,-,-,-,-,-,-,-,-,-,-,-,-,-,-,-,-,-,-,-X---------,-X-.-.-.-X---------------------------------------------
----------------------------------------------,-X-.-.-.-X-------------,-X-.-.-.-.-.-.-.-.-.-.-.-.-.-.-.-.-.-.-.-.-.-.-.-.-.-.-.-.-.-.-.-,-.-.-.-.-,-.-.-.-.-.-.-.-.-.-.-.-.-.-.-.-.-.-.-.-.-.-.-.-.-.-.-.-.-.-.-.-.-.-.-X---------,-X-.-.-.-X---------------------------------------------
----------------------------------------------,-X-.-.-.-X-------------,-X-,-,-,-A-,-,-,-,-,-,-,-,-,-,-,-A-,-,-,-,-,-,-,-,-,-A-,-,-,-,-,-,-.-.-.-.-,-,-,-,-,-,-,-,-,-,-,-,-,-,-,-,-,-,-,-,-,-,-,-,-,-,-,-,-,-,-,-,-,-,-,-X---------,-X-.-.-.-X---------------------------------------------
----------------------------------------------,-X-.-.-.-X-------------,-X-.-.-.-.-.-.-.-.-.-.-.-.-.-.-.-A-.-.-.-.-.-.-.-.-.-.-.-.-.-.-.-,-.-.-.-.-,-.-.-.-.-.-.-.-.-.-.-.-.-.-.-.-.-.-.-.-.-.-.-.-.-.-.-.-.-.-.-.-.-.-.-X---------,-X-.-.-.-X---------------------------------------------
----------------------------------------------,-X-.-.-.-X-------------,-X-,-,-,-A-,-,-,-,-,-,-,-,-,-,-,-,-,-,-,-,-,-,-,-,-,-A-,-,-,-,-,-,-.-.-.-.-,-,-,-,-,-,-,-,-,-,-,-,-,-,-,-,-,-,-,-,-,-,-,-,-,-,-,-,-,-,-,-,-,-,-,-X---------,-X-.-.-.-X---------------------------------------------
----------------------------------------------,-X-.-.-.-X-------------,-X-.-.-.-.-.-.-.-.-.-.-.-.-.-.-.-.-.-.-.-.-.-.-.-.-.-A-.-.-.-.-.-,-.-.-.-.-,-.-.-.-.-.-.-.-.-.-.-.-.-.-.-.-.-.-.-.-.-.-.-.-.-.-.-.-.-.-.-.-.-.-.-X---------,-X-.-.-.-X---------------------------------------------
----------------------------------------------,-X-.-.-.-X-------------,-X-,-,-,-A-,-,-,-,-,-,-,-,-,-,-,-A-,-,-,-,-,-,-,-,-,-,-,-,-,-,-,-,-.-.-.-.-,-,-,-,-,-,-,-,-,-,-,-,-,-,-,-,-,-A-,-,-,-,-,-,-,-,-,-,-,-,-,-,-,-,-,-X---------,-X-.-.-.-X---------------------------------------------
----------------------------------------------,-X-.-.-.-X-------------,-X-.-.-.-.-.-.-.-.-.-.-.-.-.-.-.-.-A-.-.-.-.-.-.-.-.-A-.-.-.-.-.-,-.-.-W-.-,-.-.-.-.-.-.-.-.-.-.-.-.-.-.-.-.-.-.-.-.-.-.-.-.-.-.-.-.-.-.-.-.-.-.-X---------,-X-.-.-.-X---------------------------------------------
----------------------------------------------,-X-.-.-.-X-,-,-,-,-,-,-,-X-.-.-.-A-.-.-.-.-.-.-.-.-.-.-.-.-.-.-.-.-.-.-.-.-.-.-.-.-.-.-.-,-.-.-<-.-,-.-.-.-.-.-.-.-.-.-.-.-.-.-.-.-.-.-.-.-.-.-.-.-.-.-.-.-.-.-.-.-.-.-.-X-,-,-,-,-,-X-.-.-.-X---------------------------------------------
----------------------------------------------,-X-.-.-.-X-X-X-X-X-X-X-X-X-,-,-,-,-,-,-,-,-,-,-,-,-,-,-,-,-,-,-,-,-,-,-,-,-,-,-,-,-,-,-,-,-.-.-.-.-,-,-,-,-,-,-,-,-,-,-,-,-,-,-,-,-,-,-,-,-,-,-,-,-,-,-,-,-,-,-,-,-,-,-,-X-X-X-X-X-X-X-.-.-.-X---------------------------------------------
----------------------------------------------,-X-.-.-.-.-.-.-.-.-.-.-.-.-.-.-.-.-.-.-.-.-.-.-.-.-.-.-.-.-.-.-.-.-.-.-.-.-.-.-.-.-.-.-.-.-.-.-.-.-.-.-.-.-.-.-.-.-.-.-.-.-.-.-.-.-.-.-.-.-A-.-.-.-.-.-.-.-.-.-.-.-.-.-.-.-.-.-.-.-.-.-.-.-.-X---------------------------------------------
----------------------------------------------,-X-.-.-.-.-A-.-.-.-.-.-.-.-.-A-.-.-.-.-.-.-.-.-A-.-.-.-.-.-.-.-.-.-A-.-.-.-.-.-.-.-.-.-A-.-.-.-.-.-.-.-.-.-.-.-.-.-.-A-.-.-.-.-.-.-.-.-.-.-.-.-.-.-.-.-.-.-.-.-.-A-.-.-.-.-.-A-.-.-.-.-.-.-.-X---------------------------------------------
----------------------------------------------,-X-.-.-.-.-.-.-.-.-.-.-.-.-.-.-.-.-.-.-.-.-.-.-.-.-.-.-.-.-.-.-.-.-.-.-.-.-.-.-.-.-.-.-.-.-.-.-.-.-.-.-.-.-.-.-.-.-.-.-.-.-.-.-.-.-.-.-.-.-.-.-.-.-.-.-.-.-.-.-.-.-.-.-.-.-.-.-.-.-.-.-.-.-.-X---------------------------------------------
----------------------------------------------,-X-X-X-X-X-X-X-X-X-X-X-X-X-X-X-X-X-X-X-X-X-X-X-X-X-X-X-X-X-X-X-X-X-X-X-X-X-X-X-X-X-X-X-X-X-X-X-X-X-X-X-X-X-X-X-X-X-X-X-X-X-X-X-X-X-X-X-X-X-X-X-X-X-X-X-X-X-X-X-X-X-X-X-X-X-X-X-X-X-X-X-X-X-X-X---------------------------------------------
