----------------------------------------------------------------------------,-,-X-,-,---------------------------------------------------------------------
----------------------------------,-,-,-,-,-------------------------------,-,-X-.-X-X-,-,-----------------------------------------------------------------
----------------------------------,-X-X-X2X-,-,---------------------------,-X-.-W-.-.-X-X-,-,-------------------------------------------------------------
----------------------------------,-X-.-t2.-X-X-,-,-------------------------,-X-.-.-.-.-.-X-X-,-----------------------------------------------------------
----------------------------------,-X2t2t2.-.-.-X-X-,-,-----------------------,-X-X-.-.-.-.-.-X-,-,-------------------------------------------------------
------------------------------------,-X-X-.-.-.-.-.-X-X-,-,-----------------------,-X-.-.-.-.-.-X-X-,-,---------------------------------------------------
----------------------------------------,-X-X-.-.-.-.-.-X-X-,-,---------------------,-X-.-.-.-.-.-.-X-X-,-,-----------------------------------------------
--------------------------------------------,-X-X-.-.-.-.-.-X-X-----------------------,-X-.-.-.-.-.-.-.-X-X-,---------------------------------------------
------------------------------------------------,-X-X-.-.-.-.-X-------------------------,-X-X-.-.-.-.-.-.-:-X---------------------------------------------
----------------------------------------------------,-X-.-.-.-X-----------------------------,-X-.-.-.-.-.-,-X---------------------------------------------
----------------------------------------------------,-X-.-.-.-X-----,-,-,-,-,-----------------,-X-.-.-.-.-X-----------------------------------------------
----------------------------------------------------,-X-.-.-.-X-----,-X-X-X-X---------------,-,-X-.-.-.-,-X-----------------------------------------------
----------------------------------------------------,-X-.-.-.-X-----,-X-.-<-X---------------,-X-.-.-.-.-X-------------------------------------------------
----------------------------------------------------,-X-.-.-.-X-----,-X-.-W-X---------------,-X-.-.-.-.-X-------------------------------------------------
----------------------------------------------------,-X-.-.-.-X---X-X-X-,-,-X-X-------------,-X-.-.-.-,-X-------------------------------------------------
,-,-,-,---------------------------------------------,-X-.-,-,-X-X---------------X-X-------,-,-X-.-.-.-X---------------------------------------------------
,-X-X-X-,-,-,-,-,-,---------------------------------,-X-,-,-------------------------X-X-X-,-X-.-.-.-,-X---------------------------------------------------
,-X-.-.-X-X-X-X-X-X-,-,-,---------,-,---------------X-X-----------------------------------X-X-,-.-.-X---------,-,-----------------------------------------
X-.-H-.-.-.-.-.-.-.-X-X-X-,-----,-,-X-,---------X-X-----A-----------------------------------A-,-,-,-X-------,-,-X-,---------------------------------------
X-X-.-.-.-.-.-.-.-.-.-.-.-X---,-,-X-.-X-,---X-X-------------------------------------------------------X-X-,-,-X-<-X-,-------------------------------------
--,-X-X-X-X-.-.-.-.-.-.-.-X-,-,-X-.-W-,-X-X---------------------------------------------------------------X-X-W-.-,-X-------------------------------------
--------,-,-X-X-X-.-.-.-.-.-X---,-X-,-,---------------------------------------------------------------------,-,-,-X---------------------------------------
----------------,-X-X-.-.-.-X-,---,-X---------------------------------,-,-,-,---------------------------------,-X-----------------------------------------
--------------------,-X-.-.-.-X---X-----------------------------------,-.0.0,0----------------------------------X-----------------------------------------
--------------------,-X-.-.-.-X-,-X-------------------------,-,-,-,-,-,-.0.-,0,-,-,-,-,---------------------------X---------------------------------------
----------------------,-X-.-.-.-X---------------------------,-.-.-.-.-.-.0.-.0.-.-.-.-,---------------------------X---------------------------------------
------------------------,-X-.-.-,---------------------------,-.-.-.-.-.-.0.0.0.-.-.-.-,-----------------------------X-------------------------------------
--------------------------,-X-,-,---------------------------,-.-.-A-.-.-.-.-.-.-.-A-.-,-----------------------------X-------------------------------------
--------------------------,-X-,-----------------------------,-.-.-.-.-.-.-.-.-.-.-.-.-,-----------------------------,-X-,-,-------------------------------
----------------------------,-X-----------------------------,-,-,-,-,-.-.-.-.-,-,-,-,-,-----------------------------,-X-X-X-,-,-,-,-,-,-------------------
------------------------------X-A-----------------------------------H-.-.-.-.-,-H-----------------------------------A-,-,-,-X-X-X-X-X-X-,-,-,-------------
----------------------------X---------------------------------------,-.-.-.-.-,---------------------------------------,-.-.-.-.-,-,-,-,-X-X-X-------------
----------------------------X---------------,-,-,-,-,-,-------------,-.-.-.-.-,-------------,-,-,-,-,-,---------------,-.-.-.-.-.-.-.-.-,-,-X-,-----------
----------------------------X---------------,-.-.-.-.-,-------------A-.-.-.-.-,-A-----------,-.-.-.-.-,---------------,-X-X-X-X-X-.-.-.-.-,-,-X-----------
--------------------------X-----------------,-.-.-.-.-,-------------,-.-.-.-.-,-------------,-.-.-.-.-,-------------------X---,-,-X-X-X-X-.-,-X-----------
--------------------------X-----------------,-.-.-A-.-,-----------W-,-.-.-.-.-,-,-W---------,-.-.-A-.-,-------------------X-----,-X-X-XWXW.-,-X-,---------
----------------,-,-,-,-X-------------------,-.-.-.-.-,-,-,-,-A-,-,-.-.-.-.-.-.-,-,-,-A-,-,-H-.-.-.-.-,-------------------,-X-,-,-X-.-+W+W,-,-,-X---------
----------------,-X-X-X-X---------------,-,-,-.-.-.-.-.-.-.-.-.-.-.-.-.-.-.-.-.-.-.-.-.-.-.-.-.-.-.-.-,-,-,---------------,-X-X-X-X-.-X7XWX-X-.-X-,-,-,-,-
----------------,-X-.-.-,---------------,-.1.1.1.1.-.-.-.-.-.-.-.-.-.-.-.-.-.-.-.-.-.-.-.-.-.-.-.-.-......,.--------------,-.-.-,->-.-X---,-X-.-X~X~X~X~X~
----------------,-X-<-W-,---------------,-.1.-.-.1.-.-.-.-.-.-.-.-.-.-.-.-W-.-.-.-.-.-.-.-.-.-.-.-.-...-.-,.--------------,-.-<-<->-.-X-,-,-X-W-.~+~+~t~X~
----------------,-X-X-X-X---------------,-,1,1.1.1.-.-.-.-.-.-.-.-.-.-.-.-.-.-.-.-.-.-.-.-.-.-.-.-.-..,.,.,.--------------,-X-X-X-X-.-X6XVX-X-,-X~X~X~X~X~
------------------------X-------------------,-.-.-.-.-,-,-,-,-,-,-,-.-.-.-.-.-.-,-,-,-,-,-,-,-.-.-.-.-,-------------------X-----,-X-.-.6+V.-,-,-X---------
--------------------------X-----------------,-.-.-.-.-,-H-----A---,-,-.-.-.-.-,-,-----A-----,-.-.-.-.-,-------------------X-----,-X-X-X6XV.-,-X-----------
--------------------------X-----------------,-.-.-A-.-,-----------W-,-.-.-.-.-,---W---------,-.-.-A-.-,---------------,-X-,-,-,-,-,-,-,-X-.-,-X-----------
--------------------------X-----------------,-.-.-.-.-,-------------,-.-.-.-.-,-------------,-.-.-.-.-,---------------,-X-X-X-X-X-X-X-X-X-,-,-X-----------
----------------------------X---------------,-,-,-,-,-,-------------A-.-.-.-.-,-A-----------,-,-,-,-,-,-------------,-,-.-.-.-.-.-.-.-,-,-,-X-------------
----------------------------X---------------------------------------,-.-.-.-.-,-------------------------------------,-.-.-,-,-,-,-,-,-,-X-X-X-------------
----------------------------,-X-------------------------------------,-.-.-.-.-,-------------------------------------,-,-,-,-X-X-X-X-X-X-------------------
--------------------------,-,-X-A---------------------------,-,-,-,-H-.-.-.-.-,-H-,-,-,-----------------------------A-X-X-X-------------------------------
--------------------------,-X-,-----------------------------,-.-.-.-.-.-.-.-.-.-.-.-.-,-------------------------------X-----------------------------------
------------------------,-,-X-,-,---------------------------,-.-.-.-.-.-.-.-.-.-.-.-.-,-----------------------------X-------------------------------------
----------------------,-,-X-.-.-,---------------------------,-.-.-A-.-.-.-.-.-.-.-A-.-,-----------------------------X-------------------------------------
----------------------,-.-X-.-.-X---------------------------,-.-.-.-.-.-./././.-.-.-.-,---------------------------X---------------------------------------
--------------------,-,-X-.-.-X-X---------------------------,-,-,-,-,-,-./.-,/,-,-,-,-,---------------------------X---------------------------------------
--------------------,-X-.-.-.-X---X-----------------------------------,-./.-,/------------------------------------X---------------------------------------
----------------,-,-,-X-.-.-X-,---X-,---------------------------------,-,/,/,/--------------------------------,-X-----------------------------------------
----------,-,-,-,-X-X-.-.-.-X---,-,-X-,---------------------------------------------------------------------,-,-X-,---------------------------------------
--,-,-,-,-X-X-X-X-.-.-.-.-X-,-,-,-X-W-,-,-----------------------------------------------------------------,-,-W-.-X-,-------------------------------------
,-,-X-X-X-.-.-.-.-.-.-.-.-X---,-X-<-.-,-X-X-------------------------------------------------------,-,-----X-X-.-<-,-X-------------------------------------
X-X-.-.-.-.-.-.-.-.-.-.-X-,-----,-X-,-X-----X-X-----------------------------------------------,-,-,-X-X-X---,-X-,-X---------------------------------------
X-.-.-.-.-.-.-.-.-,-X-X-X---------,-X-----------X-X-,-,-A-,-------------------------------,-A-,-.-.-X-,-------,-X-----------------------------------------
,-X-.-,-X-X-X-X-X-X---------------------------------X-X-.-,-,-,---------------------------X-X-.-.-.-.-X---------------------------------------------------
,-X-X-X---------------------------------------------,-X-.-.-.-X-X---------------------X-X-,-X-.-.-.-.-X---------------------------------------------------
----------------------------------------------------,-X-.-.-.-X---X-X-,-,-,-,---X-X-X-------,-X-.-.-.-X-,-------------------------------------------------
----------------------------------------------------,-X-.-.-.-X-----,-X-.-.-X-X-------------,-X-.-.-.-.-X-------------------------------------------------
----------------------------------------------------,-X-.-.-.-X-----,-X-.-<-X---------------,-X-.-.-.-.-X-,-----------------------------------------------
----------------------------------------------------,-X-.-.-.-X-----,-X-.-<-X---------------,-X-.-.-.-.-.-X-----------------------------------------------
----------------------------------------------------,-X-.-.-.-X-----,-X-X-X-X-----------------,-X-.-.-.-.-X-----------------------------------------------
----------------------------------------------------,-X-.-.-.-X-----------------------------,-,-X-.-.-.-.-X-,---------------------------------------------
------------------------------------------------,-,-,-X-.-.-.-X-------------------------,-,-,-X-.-.-.-.-.-.-X---------------------------------------------
--------------------------------------------,-,-,-X-X-.-.-.-.-X-----------------------,-,-X-X-.-.-.-.-.-.-:-X---------------------------------------------
----------------------------------------,-,-,-X-X-.-.-.-.-,-X-X---------------------,-,-X-.-.-.-.-.-.-,-X-X-----------------------------------------------
------------------------------------,-,-,-X-X-.-.-.-.-,-X-X-----------------------,-,-X-.-.-.-.-.-,-X-X---------------------------------------------------
----------------------------------,-,-X-X-.-.-.-.-,-X-X-----------------------,-,-,-X-.-.-.-.-,-X-X-------------------------------------------------------
----------------------------------,-X2t2t2.-.-,-X-X-------------------------,-,-X-X-.-.-.-.-,-X-----------------------------------------------------------
----------------------------------,-X-.-t2,-X-X---------------------------,-,-X-.-.-.-.-,-X-X-------------------------------------------------------------
----------------------------------,-X-X-X2X-------------------------------,-X-.-W-.-,-X-X-----------------------------------------------------------------
----------------------------------------------------------------------------,-X-,-X-X---------------------------------------------------------------------
------------------------------------------------------------------------------,-X-------------------------------------------------------------------------
