--------------------------------------------------------------------------------------------------------------------------------------,-X-X-X-----------------------------------------------------------------------------------------------------------------------------------------
--------------------------------------------------------------------------------------------------------------------------------------,-X-tJX-----------------------------------------------------------------------------------------------------------------------------------------
--------------------------------------------------------------------------------------------------------------------------------------,-XAtAXA----------------------------------------------------------------------------------------------------------------------------------------
--------------------------------------------------------------------------------------------------------------------------------,-,-,-,-X\+\X\,-,-,-----------------------------------------------------------------------------------------------------------------------------------
--------------------------------------------------------------------------------------------------------------------------------X-X-X-X-X\+\X\X-X-X-,-,-------------------------------------------------------------------------------------------------------------------------------
----------------------------------------------------------------------------------------------------------------------------X-X-,-,-.-.-.-.-.-,-,-.-X-X-,-,---------------------------------------------------------------------------------------------------------------------------
------------------------------------------------------------------------------------------------------------------------X-X-------,-.-.-.-H-.-,-.-.-,-,-X-X-,-------------------------------------------------------------------------------------------------------------------------
----------------------------------------------------------------------------------------------------------------------X-----------X-X<.-.-.-.-X-X-X-,-.-.-.-X-,-,---------------------------------------------------------------------------------------------------------------------
--------------------------------------------------------------------------------------------------------------------X-------X-X-X-,-X<.-.-.-.-X-,-,-X-X-.-,-,-X-X-,-------------------------------------------------------------------------------------------------------------------
------------------------------------------------------------------------------------------------------------------X-----X-X-------X-X<.-.-.-.-X-X-----,-X-X-.-.-,-X-,-----------------------------------------------------------------------------------------------------------------
----------------------------------------------------------------------------------------------------------------X-----X-------X-X-,-,-.-.-.-.-,---X-X-----,-X-,-,-.-X-----------------------------------------------------------------------------------------------------------------
----------------------------------------------------------------------------------------------------------------X---X---X-X-X-------,-.-.-A-.-,-------X-X---,-X-.-.-X-,---------------------------------------------------------------------------------------------------------------
--------------------------------------------------------------------------------------------------------------X---X---X---------,-,-,-.-.-.-.-,-,-,-------X-X-,-X-,-,-X---------------------------------------------------------------------------------------------------------------
------------------------------------------------------------------------------------------------------------X---X-----X-------,-,-.-.-.-.-.-.-.-.-,-,---------X-,-X-.-X-,-------------------------------------------------------------------------------------------------------------
------------------------------------------------------------------------------------------------------------X---X---X-----,-,-,-.-.-.-.-.-.-.-.-.-.-,-,-------X---,-X-.-X-------------------------------------------------------------------------------------------------------------
----------------------------------------------------------------------------------------------------------X---X-----X---,-,-.-.-.-.-.-.-.-E-.-.-.-.-.-,---------X-,-X-,-X-------------------------------------------------------------------------------------------------------------
----------------------------------------------------------------------------------------------------------X---X---X-----,-.-.-.-.-.-.-.-.-.-.-.-.-.-.-,-,-------X---,-X-X-,-----------------------------------------------------------------------------------------------------------
--------------------------------------------------------------------------------------------------------X-----X---X---,-,-.-.-.-.-.-.-.-.-.-.-.-.-.-.-.-,-,-------X-,-X-.-X-----------------------------------------------------------------------------------------------------------
--------------------------------------------------------------------------------------------------------X---X-----X---,-.-.-.-.-.-.-.-.-.-.-.-.-.-.-.-.-.-,-------X-,-X-,-X-----------------------------------------------------------------------------------------------------------
--------------------------------------------------------------------------------------------------------X---X---X-----,-.-.-.-.-.-.-.-.-.-<-.-.-.-.-.-.-.-,-------X-,-X-.-X-,---------------------------------------------------------------------------------------------------------
--------------------------------------------------------------------------------------------------------X---X---X-----,-.-.-.-.-.-.-.-.-.-.-.-.-.-.-.-.-.-,-------X---X-.-.-X---------------------------------------------------------------------------------------------------------
--------------------------------------------------------------------------------------------------------X---X-,-X-,-,-,-,-.-.-.-.-.-.-.-.-.-.-.-.-.-.-.-.-,-,-,-,-,-X-,-X-,-X---------------------------------------------------------------------------------------------------------
------------------------------------------------------------------------------------------------------,-X-,-X-,-X-.-.-.-,-.-A-.-.-.-.-.-.-W-.-.-T-.-.-.-,-,-.-.-.-.-X-,-X-.-X---------------------------------------------------------------------------------------------------------
--------------------------------,-,-,-----------------------------------------------------------------,-XX+XXX,-X-.-.-.-,-.-.-.-.-.-.-.-.-.-.-.-.-.-.-.-,-.-.-.-.-.-X-,-XY+YXY,-,-,-,-,-,-,-,-,-,-,-,-,-,-,-,-,-,-------------,-,-,-,-,-,-,-,-,-,-------------------------------------
----------------------------,-,-,-X-X-X-X-X-X-X-X-X-X-------------X-X-X-X-X-X-X-X-X-X-X-X-X-X-X-X-X-X-X-XX+XXXX-X-.-.-.-,-.-.-.-.-.-.-.-.-.-.-.-.-.-.-.-,-.-.-.-.-.-X-X-XY+YXYX-X-X-X-X-X-X-X-X-X-X-X-X-X-X-X-X-X-,-----,-,-,-,-X-X-X-X-X-X-X-X-X-,-,-,-------------------------------
----------,-,-,-,-------,-,-X-X-X-.-,-----------------X-X-,-,-X-X-------------------------------------,-,-,-,-XPXP.-.-.-,-.-.-.-.-.-.-.-.-.-.-.-.-.-.-.-,-.-.-.-.-.-XQ.-.-.-.-.-.-.-.-.-.-.-.-.-.-.-.-.-.-.-.-.-.-X-,-,-,-X-X-X-.-,-.-.-,-.-.-,-.-X-X-X-,-,---------------------------
----------,-X-X-X---,-,-,-X-.-,-,-.-,-,-----------------,-X-X-,-,-------------------------------------,-.-.-.-+P+P.-.-.-,-,-.-.-.-.-.-.-.-.-.-.-.-.-.-,-,-.-.-.-.-.-.1.-.-.-.-.-.-.-.-.-.-.-.-.-.-.-.-.-.-.-.-.-.-.-X-X-X-.-,-.-.-,-.-.-,-.-,-,-.-,-,-.-X-X---------------------------
----------,-X-.-X-,-,-X-X-,-,-.-,-.-.-,-,-,-,-,-,-,-----,-.-.-.-,-,-------------------------------<---,-.-.-.-+P+P.-.-.-.-,-,-,-.-.-.-.-.-.-.-.-.-.-,-,-.-.-W-.-.-.-.1.-.-.-.-.-.-.-.-.-.-.-.-.-.-.-.-.-.-.-.-.-.-.-.-,-.-.-,-,-.-,-.-.-,-.-,-.-.-,-.-.-,---X-,-----------------------
----------,-XItIXI,-X-,-.-.-,-.-,-,-,-,-.-.-.-.-.-,-,-,-,-.-.-.-.-,-,---------------------------------,-,-,-,-+P+P.-.-.-.-.-.-,-,-.-.-.-.-.-.-.-.-,-,-.-.-.-.-.-.-.-.1.-.-.-.-.-.-.-.-.-.-.-.-.-.-.-.-.-.-.-.-.-.-.-.-,-,-.-.-,-,-,-,-,-,-,-,-.-,-,-.-,-,-,-,-X-,---------------------
----------,-Xd+dXd,-X-,-,-.-,-,-,-,-.-.-.-.-.-.-.-.-.-.-.-.-.-.-.-.-,---------------------------------------,-XPXP.-.-.-.-.-.-.-,-.-.-.-.-.-.-.-,-,-.-.-.-.-.-.-.-,-XQ,-,-,-,-,-,-,-,-,-,-,-,-.-.-.-.-.-.-.-.-.-.-.-.-.-,-,-,-,-.-.-.-.-.-.-,-,-,-.-,-,-,-,-.-.-X-,-,-,-,-,-,-,-,-,-,-
----------,-Xd+dXdX-.-.-,-,-,-,-.-.-.-.-.-.-.-.-.-.-.-.-.-.-.-.-A-.-,-,---X-X-X-X-X-X-X-X-X-X-X-X-X-X-X-X-X-X-X-X-.-.-.-.-.-.-.-,-,-,-,-.-,-,-,-,-.-.-.-.-.-.-.-.-,-X-X-X-X-X-X-X-X-X-X-X-X-X-X-X-X-X-X-X-X-.-.-.-.-.-.-,-,-.-.-.-.-.-.-.-.-.-.-,-,-,-,-,-.-.-.-.-X-X6X-XlX-X-X-XNX-X-
----------,-X-t7t5.-.-.-,-X-.-.-.-.-.-.-.-.-.-.-.-.-.-.-.-.-.-.-.-.-.-X-X---,-,-X-X-X-,-X-X-X-X-X-X-X-X-X-X-X-X-X-.-.-.-.-.-.-.-.-.-.-,-,-,-.-.-.-.-.-.-.-.-.-.-.-,-X-A-.-.-.-E-.-E-.-E-.-.-X-X-X-X-,-----,-X-.-.-.-.-.-.-.-.-.-.-.-.-.-.-.-.-.-.-.-.-,-X-.-.-.-.-.-t6tB.L.-.-,-tNtOX-
----------,-X5t5t5.-.-,-X-.-.-.-.-.-.-.-.-.-.-.-.-.-.-.-.-.-.-.-.-.-.-X-,-,-,-X-.-.-X-,-X-.-X-X-tBtBtB.-.-.-A-X-X-X-.-.-.-.-.-.-.-.-.-.-.-.-.-.-.-.-.-.-.-.-.-.-.-X-X-Xg+gXgX-X-X-X-X-X-X-X-X-X-.-.-X-,-,-,-X-.-.-.-.-.-.-.-.-.-A-.-.-.-.-.-.-.-.-.-.-.-,-X-.-.-.-.-t6t6XlX-.-,-XNX-X-
----------,-X-.-.-.-.-,-.-.-.-.-.-.-W-.-.-.-.-.-.-.-.-.-.-.-.-.-.-.-.-.-X-,-X-.-.-A-.-X-X-E-X-X-tBt>tB.-.-.-.-X-X-X-.-.-.-.-.-.-.-.-.-.-.-.-.-.-.-.-.-.-.-.-.-.-.-X-X-Xg+gXgX-X-X-X-X-X-X-X-,-X-.-H-.-X-,-X-.-.-.-.-.-.-.-.-.-.-.-.-.-.-.-.-.-.-.-W-.-.-,-,-.-.-.-.-.-.-X-X-.-.-X-----
----X-X-X-X-X-.-.-.-,-,-.-.-.-.-.-.-.-.-.-.-.-.-.-.-.-.-.-.-A-.-.-.-.-.-X-,-X-.-.-.-.-X-X-.-X_X_tBtBtB.-.-.-.-.-,-.-.-.-.-.-.-.-H-.-.-.-.-.-.-.-.-.-.-.-.-.-.-.-.-,-.-.-.-.-.-.-.-,-tJtJtJX-,-X-.-.-.-X-,-X-.-.-.-.-A-.-.-.-.-.-.-.-.-.-.-.-.-.-.-.-.-.-.-,-,-.-.-.-.-.-X-X-.-.-X-----
----X-,-,-X-X-.-.-.-,-.-.-.-.-.-.-.-.-.-,-,-,-,-.-.-.-.-.-.-.-.-.-.-.-.-X-,-X-.-.-.-.-X-X-.-+_+_.-.-.-.-.-.-.-.-,-.-.-.-.-.-.-.-.-.-.-.-.-.-.-.-.-.-.-.-.-.-.-.-.-,-.-.-.-.-W-.-.-,-tJtItJX-X-.-.-.-.-X-,-X-.-.-.-.-.-.-.-.-.-.-.-.-,-,-,-,-.-.-.-.-.-.-.-.-,-.-.-.-.-.-X-X-.-.-X-----
----X-.-,-X-X-.-.-.-,-.-.-.-.-.-.-.-,-,-,-.-,-,-,-,-.-.-.-.-.-.-.-.-.-.-.-X-X-.-.-.-.-X-X-.-X_X_.-.-.-.-.-.-.-.-,-.-.-.-.-.-.-.-H-.-.-.-.-.-A-.-A-.-A-.-.-.-.-.-.-,-.-.-.-.-.-.-.-,-tJtJtJX-X-.-.-.-.-X-X-.-.-.-.-.-.-.-.-.-.-.-,-,-,-,-.-,-,-,-.-.-.-.-.-.-,-,-.-.-.-.-X-X-.-.-X-----
,-,-X-.-,-X-X-.-.-.-,-.-.-.-.-.-.-.-,-,-,-,-,-,-,-,-.-.-.-.-.-.-.-.-.-.-.-X-X-.-.-.-.-,-X-X-X-X-X-X-X-X-X-X-X-X-X-X-.-.-.-.-.-.-H-.-.-.-.-.-.-.-.-.-.-.-.-.-.-.-.-X-X-X-X-X-X-X-X-X-X-X-X-X-X-.-.-.-.-X-X-.-.-.-.-.-.-.-.-.-.-.-,-,-.-,-,-,-.-,-.-.-.-.-.-.-.-,-.-.-.-.-X-X-.-.-X-----
,->-X-.-,-,-.-.-.-,-,-.-.-.-.-.-.-,-,-.-.-.-.-,-,-,-,-.-.-.-.-.-.-.-.-.-.-.-X-.-.-.-.-,-X-X-X-X-X-X-X-X-X-X-X-X-X-X-.-.-.-.-.-.-.-.-.-.-.-.-.-.-.-.-.-.-.-.-.-.-.-X-X-X-X-X-X-X-X-X-X-X-X-X-X-.-.-.-.-X-XS.-.-.-A-.-.-.-.-.-.-,-,-,-,-,-,-.-.-,-,-.-.-.-.-.-.-,-.-.-.-.-.-.-.-.-X-----
,->-,-.-,-X-X..-.-,-.-.-.-.-.-.-.-,-.-.-.-.-.-,-,-.-,-.-.-.-.-.-.-.-.-.-.-.-.-.-.-.-.-,-,-,-,-,-,-,-,-.-.-.-.-.-,-.-.-.-.-.-.-.-.-.-.-.-.-.-.-.-.-.-.-.-.-.-.-.-.-,-.-.-.-.-.-,-,-,-,-,-,-,-,-.-.-.-.-.-+S.-.-.-.-.-.-.-.-.-.-,-.-.-,-.-,-,-.-.-,-.-.-.-.-.-.-,-.-.-.-.-X3.-.-.-X-----
-->-X-.-,-X-X.<-.-W-,-H-.-.-<-.-.-,-,;,;.;.-.-,-,-,-,-.-.-.-.-.-.-.-.-.-.-.-.-.-<-.-W-,-,-,-,-,-,-,-,-.-.-.-.-.-,-A-.-.-.-.-.-.-.-.-.-.-.-H-.-.-.-.-.-.-.-.-.-.-.-A-.-.-.-.-.-,-,-,-,-,-,-,-,-.-W-.-<-.-+S.-.-.-.-.-.-.-.-.-.-,-,-,-,-,-H-,-,9,9,9.-.-.-.-.-.-H-.-W-.-<-X3.-.-.-X-----
----X-.-,-X-X..-.-.-,-.-.-.-.-.-.-,-,-,-,-.-,-,-.-,-,-.-.-.-.-.-.-.-.-.-.-.-.-.-.-.-.-,-,-,-,-,-,-,-,-.-.-.-.-.-,-.-.-.-.-.-.-.-.-.-.-.-.-.-.-.-.-H-.-.-.-.-.-.-.-,-.-.-.-.-.-,-,-,-,-,-,-,-,-.-.-.-.-.-+S.-.-.-.-.-.-.-.-.-.-,-,-.-,-,-,-,-,-.-.-.-.-.-.-.-.-,-.-.-.-.-X3.-.-.-X-----
----X-.-,-,-.-.-.-.-,-.-.-.-.-.-.-.-,-.-,-,-,-,-,-,-.-.-.-.-.-.-.-.-.-.-.-X-X-.-.-.-.-,-X-X-X-X-X-X-X-X-X-X-X-X-X-X-.-.-.-.-.-.-.-.-.-.-.-.-.-.-.-.-.-.-.-.-.-.-.-X-X-X-X-X-X-X-X-X-X-X-X-X-X-.-.-.-.-X-XS.-.-.-A-.-.-.-.-.-.-.-,-,-,-.-,-.-,-,-.-.-.-.-.-.-.-,-.-.-.-.-.-.-.-.-X-----
----X-.-,-X-X-.-.-.-,-.-.-.-.-.-.-.-,-,-,-,-.-,-,-,-.-.-.-.-.-.-.-.-.-.-.-X-X-.-.-.-.-,-X-X-X-X-X-X-X-X-X-X-X-X-X-X-.-.-.-.-.-.-.-.-.-.-.-.-.-.-.-H-.-.-.-.-.-.-.-X-X-X-X-X-X-X-X-X-X-X-X-X-X-.-.-.-.-X-X-.-.-.-.-.-.-.-.-.-.-.-,-,-,-.-,-,-,-,-.-.-.-.-.-.-,-,-.-.-.-.-X-X-.-.-X-----
----X-,-,-X-X-.-.-.-,-,-.-.-.-.-.-.-.-.-,-,-,-,-.-.-.-.-.-.-.-.-.-.-.-.-X-,-X-.-.-.-.-X-,-X-tKtKtK.-.-.-.-.-.-.-,-.-.-.-.-.-.-.-.-.-.-.-.-.-.-.-.-H-.-.-.-.-.-.-.-,-.-.-.-.-.-.-.-.-.-X`.-X-X-.-.-.-.-X-X-.-.-.-.-.-.-.-.-.-.-.-.-.-,-,-,-,-.-.-.-.-.-.-.-.-,-.-.-.-.-.-X-X-.-.-X-----
----X-----X-X-.-.-.-.-,-.-.-.-.-.-.-.-.-.-.-.-.-.-.-.-.-.-.-.-.-.-.-.-.-X-,-X-.-.-.-.-X-,-X-tKtHtK.-.-.-W-.-.-.-,-.-.-.-.-.-.-.-.-.-.-.-.-.-.-.-.-.-.-.-.-.-.-.-.-,-.-.-.-.-.-,-,-,-,-.@.-X-X-.-.-.-.-X-,-X-.-.-.-.-.-.-.-.-.-.-.-.-.-.-.-.-.-.-.-.-.-.-.-,-,-.-.-.-.-.-X-X-H-.-X-----
----X-----X-X-.-.-.-.-,-,-.-.-.-.-.-W-.-.-.-.-.-.-.-.-.-.-.-A-.-.-.-.-.-X-,-X-.-.-.-,-X-,-X-tKtKtK.-.-.-.-.-.-.-,-.-.-.-.-.-.-.-A-.-.-A-.-A-.-.-.-.-.-.-.-.-.-.-.-,-.-.-.-.-.-,-tCtCtCX`.-X-,-X-.-.-.-X-,-X-.-.-.-.-A-.-.-.-.-.-.-.-.-.-.-.-.-.-.-.-.-.-,-,-.-.-.-.-.-.-X-X-X-X-X-----
,-,-X---,-X-X-,-,-.-.-.-X-,-.-.-.-.-.-.-.-.-.-.-.-.-.-.-.-.-.-.-.-.-.-,-X-,-X-.-.-H-,-X-X-X-X-X-X-X-X-X-X-Xf+fXfX-X-.-.-.-.-.-.-.-.-.-.-.-.-.-.-.-.-.-.-.-.-.-.-.-X-X-X-.-.-.-,-tCtAtCX-E-X-,-X-.-A-,-X-,-X-.-.-.-.-.-.-.-.-.-.-.-.-.-.-.-.-.-.-.-W-.-,-,-X-.-.-.-.-.-.-X-------------
X-X-XO--,-X-X-t4t4.-.-.-,-X-.-.-.-.-.-.-.-.-.-.-.-.-.-.-.-.-.-.-.-.-.-X-,-,-,-X-.-.-X-X-.-.-E-.-E-.-E-.-.-.-A-X-X-X-.-.-.-.-.-.-,-,-,-,-,-,-,-,-,-,-.-.-.-.-.-.-.-X-X-X-A-.-.-,-tCtCtCX-.-X-,-X-.-,-X-----,-X-.-.-.-.-.-.-.-.-.-A-.-.-.-.-.-.-.-.-.-,-,-X-,-.-.-.-.-t7t7X7------------
X-tNtO--,-+-+-tCt4.-.-,-,-,-,-.-.-.-.-.-.-.-.-.-.-.-.-,-,-.-.-.-.-.-.-X-X-X-,-,-X-X-X-X-X-X-X-X-X-X-X-X-X-X-X-X-X-.-.-.-.-.-.-.-,-.-.-.-.-.-.-.-.-,-.-.-.-.-.-.-.-.-X-X-X-X-X-X-X-X-X-X-X-X-,-X-X-X-----X-X-X-.-.-.-.-.-.-.-.-.-.-.-.-.-.-.-.-.-.-,-,-.-.-,-,-.-.-,-t7t5X-------------
X-X-XOX-X-X-X-X-X4X-,-,-----,-,-.-.-,-,-.-.-,-,-,-,-,-,-,-,-.-.-A-.-.-.-.-.-X-X-X-X-X-X-X-X-X-X-X-X-X-X-X-X-X-X-X-.-.-.-.-.-.-,-,-.-.-.-.-.-.-.-.-,-,-.-.-.-.-.-,-,-X-X-X-X-X-X-X-X-X-X-X-X-X-X-X-X-X-X-----,-,-.-.-.-.-,-,-.-.-.-.-.-.-.-.-.-.-,-,-,-.-.-.-,-,-,-X-Xe.EXe------------
------------------,-X---------,-,-,-,-,-,-,-,-.-,-.-,-,-.-,-.-.-.-.-.-.-.-.-.-.-.-.-.-.-.-.-.-.-.-.-.-.-.-.-.-XOXO.-.-.-.-,-,-,-.-.-.-.-.-.-.-.-.-.-,-.-.-.-.-.-,-,-XR,-,-,-,---------------------------------,-,-.-.-.-,-,-,-,-,-,-,-.-,-,-,-,-,---,-,-.-.-,-X-X-,-X-.-X-------------
----------------------X-X-----------,-.-.-,-.-.-,-.-.-,-.-,-,-.-.-.-.-.-.-.-.-.-.-.-.-.-.-.-.-.-.-.-.-.-.-.-.-+O+O.-.-W-.-,-.-.-.-.-.-.-.-.-.-.-.-.-,-,-.-.-.-.-,-,-,2,-.-.-,-----------------------------------,-,-,-,-,-----------,-,-,-------------,-,-,-X-----,-XHtHXH------------
--------------------------X-X-----,-,-.-.-,-,-.-,-,-.-,-,-,-X-X-.-.-.-.-.-.-.-.-.-.-.-.-.-.-.-.-.-.-.-.-.-.-.-+O+O.-.-.-,-,-.-.-.-.-.-.-.-.-.-.-.-.-.-,-,-.-.-.-,-,-,2,-.-.-,-----<---------------------------------,-X-X-------------------------------,-X-------,-X-.-X-------------
------------------------------X-X-,-.-.-.-.-,-.-.-,-,-X-X-X---,-X-X-.-.-.-.-.-.-.-.-.-.-.-.-.-.-.-.-.-.-.-.-.-+O+O.-.-.-,-.-.-.-.-.-.-.-.-.-.-.-.-.-.-.-,-.-.-.-,-,-,2,-,-,-,-------------------------------------X-X-----X-X-X-----------------------X-X---------,-X-X-X-------------
----------------------------------X-X-X-X-.-,-,-X-X-X-------------,-X-X-X-.-.-.-.-.-.-.-.-.-.-.-.-.-.-.-.-.-.-XOXO.-.-.-,-.-.-.-.-.-.-.-.-.-.-.-.-.-.-.-,-.-.-.-.-.-XR,-,-,-,-------------------------------X-X-X---------------X-X-X-------X-X-X-X-X---------------------------------
----------------------------------------,-X-X-X-------------------------,-X-X-X-X-X-X-X-X-X-X-X-X-X-X-X-X[.;X[X-X-.-.-.-,-.-.-.-.-.-.-.-.-.-.-.-.-.-.-.-,-.-.-.-.-.-X-X-XZ,:XZX-X-X-X-X-X-X-X-X-X-X-X-X-X-X---------------------------X-X-X-------------------------------------------
------------------------------------------------------------------------------------------------------,-X-,-X-,-X-.-.-.-,-.-.-.-.-.-.-.-.-.-.-.-.-.-.-A-,-,-.-.-.-.-X---X---X---------------------------------------------------------------------------------------------------------
------------------------------------------------------------------------------------------------------,-X-.-X-,-X-,-,-,-,-.-.-.-.-.-T-.-.-W-.-.-.-.-.-.-.-,-,-,-,-,-X---X---X---------------------------------------------------------------------------------------------------------
------------------------------------------------------------------------------------------------------,-X-,-X---X-----,-.-.-.-.-.-.-.-.-.-.-.-.-.-.-.-.-.-,-.-,-,-X-,---X---X---------------------------------------------------------------------------------------------------------
------------------------------------------------------------------------------------------------------,-X-.-X---X-----,-.-.-.-.-.-.-.-.-.-.-.-.-.-.-.-.-.-,-,-.-.-X---X---X-----------------------------------------------------------------------------------------------------------
------------------------------------------------------------------------------------------------------,-X-.-X-,-X-----,-,-.-.-.-.-.-.-.-.-<-.-.-.-.-.-.-.-,-,-,-,-X---X---X-----------------------------------------------------------------------------------------------------------
------------------------------------------------------------------------------------------------------,-X-,-,-X---X-----,-.-.-.-.-.-.-.-.-.-.-.-.-.-.-.-,-,-.-.-,-X---X---X-----------------------------------------------------------------------------------------------------------
--------------------------------------------------------------------------------------------------------,-X-.-X---X-----,-,-.-.-.-.-.-.-.-.-.-.-.-.-.-,-,-,-,-.-,-X-X---X-------------------------------------------------------------------------------------------------------------
--------------------------------------------------------------------------------------------------------,-X-.-X-,-X-------,-,-.-.-.-.-.-.-.-.-.-.-.-,-,-,-.-,-,-X---X---X-------------------------------------------------------------------------------------------------------------
--------------------------------------------------------------------------------------------------------,-X-,-,-X---X-------,-,-,-.-.-.-.-E-.-.-,-,-,-,-,-,-.-X---X-----X-------------------------------------------------------------------------------------------------------------
----------------------------------------------------------------------------------------------------------,-X-.-X-,-X-----------,-,-,-.-.-.-.-,-,-.-.-,-.-,-X-,---X---X---------------------------------------------------------------------------------------------------------------
----------------------------------------------------------------------------------------------------------,-X-.-.-X---X-X---------,-,-.-.-.-.-,-,-.-.-,-,-,-X---X-----X---------------------------------------------------------------------------------------------------------------
------------------------------------------------------------------------------------------------------------,-X-,-X-,-----X-------,-.-.-.-.-.-,-,-,-.-,-X-X-----X---X-----------------------------------------------------------------------------------------------------------------
------------------------------------------------------------------------------------------------------------,-X-,-.-X-,-,---X-X---,-.-.-.-A-.-,-.-,-X-X-----X-X-----X-----------------------------------------------------------------------------------------------------------------
--------------------------------------------------------------------------------------------------------------,-X-.-.-X-X-,-,---X-X-X-.-.-.-.-X=X-X-------X-------X-------------------------------------------------------------------------------------------------------------------
----------------------------------------------------------------------------------------------------------------,-X-X-,-.-X-X-,-,-,-X-.-.-.-.-X=------X-X-----X-X---------------------------------------------------------------------------------------------------------------------
--------------------------------------------------------------------------------------------------------------------,-X-.-,-,-X-X-X-X-.-.-.-.-X=X-X-X-------X-------------------------------------------------------------------------------------------------------------------------
----------------------------------------------------------------------------------------------------------------------,-X-X-.-.-.-,-.-.-.-.-.-,-,-------X-X---------------------------------------------------------------------------------------------------------------------------
--------------------------------------------------------------------------------------------------------------------------,-X-X-X-,-.-.-.-H-.-.-,---X-X-------------------------------------------------------------------------------------------------------------------------------
------------------------------------------------------------------------------------------------------------------------------,-,-X-X-X-X]+]X]X-X-X-----------------------------------------------------------------------------------------------------------------------------------
--------------------------------------------------------------------------------------------------------------------------------------,-X]+]X]----------------------------------------------------------------------------------------------------------------------------------------
--------------------------------------------------------------------------------------------------------------------------------------,-X-,-X-----------------------------------------------------------------------------------------------------------------------------------------
--------------------------------------------------------------------------------------------------------------------------------------,-X>t>X>----------------------------------------------------------------------------------------------------------------------------------------
--------------------------------------------------------------------------------------------------------------------------------------,-X-tKX-----------------------------------------------------------------------------------------------------------------------------------------
--------------------------------------------------------------------------------------------------------------------------------------,-X-X-X-----------------------------------------------------------------------------------------------------------------------------------------
