------------------------------------------------------------------------------------------------------------------------------------------------------------------------------------------,-X-X-X-----------------------------------------
--------------------------------------------------------------------------------------------------------------------------------------------------------------------------------------,-,-,-X-.-X-,-,-------------------------------------
--------------------------------------------------------------------------------------------------------------------------------------------------------------------------------------,-X-X-X1t1X1X-X-------------------------------------
--------------------------------------------------------------------------------------------------------------------------------------------------------------------------------------,-X-.-.-K-.-.-X-------------------------------------
----------------------------------------------------------------------------------------------------------------------------------------------------------------------------------,-,-,-X-.-.-.-.-.-X-------------------------------------
--------------------------------------------------------------------------------------------------------------------------------------------------------------------,-,-,-,-,-,-,-,-X-X-X-.-.-.-.-.-X-------------------------------------
----------------------------------------------------------------------------------------------------------------------------------------------------------,-,-,-,-,-,-X-X-X-X-X-X-X-.-.-.-.-.-.-.-,-X-------------------------------------
--------------------------------------------------------------------------------------------------------------------------------------------------,-,-,-,-,-X-X-X-X-X-.-.-.-.-.-.-.-.-.-.-.-.-.-.-X---------------------------------------
----------------------------------------------------------------------------------------------------------------------------------------------,-,-,-X-X-X-X-.-,-.-.-.-.-.-.-.-.-.-.-.-.-.-.-E-.-,-X---------------------------------------
----------------------------------------------------------------------------------------------------------------------------------------------,-X-X-.-.-.-.-.-,-.-.-.-.-.-.-.-.-.-.-E-.-.-.-.-.-X-----------------------------------------
----------------------------------------------------------------------------------------------------------------------------------------------,-X-,-.-.-.-.-.-,-.-.-.-.-.-.-.-.-.-.-.-.-.-.-.-,-X-----------------------------------------
--------------------------------------------------------------------------------------------------------------------------------------------,-,-X-,-,-.-.-,-X-X-X-X-X-X-X-X-X-X-.-.-.-.-.-,-X-X-------------------------------------------
--------------------------------------------------------------------------------------------------------------------------------------------,-X-.-.-,-X-X-X-------------------,-X-X-.-,-X-X-----------------------------------------------
--------------------------------------------------------------------------------------------------------------------------------------------,-X-.-.-,-X---------------------------,-X-X---------------------------------------------------
--------------------------------------------------------------------------------------------------------------------------------------------,-X-.-.-X-------------------------------------------------------------------------------------
------------------------------------------------------------------------------------------------------------------------------------------,-,-X-.-.-X-------------------------------------------------------------------------------------
------------------------------------------------------------------------------------------------------------------------------------------,-X-.-.-,-X-------------------------------------------------------------------------------------
--------------------------------------------------------------------------------------------------------------------,-,-,-,---------------,-X-,-.-X-----------,-,-,-,---------------------------------------------------------------------
------------------------------------------------------------------------------------------------------------------,-,-X-X-X-,-------------,-X-,-,-X---------,-,-X-X-X-,-------------------------------------------------------------------
----------------------------------------------------------------------------------------------------------------,-,-X-.-.-.-X-,-,-,-,-,-,-,-X-.-.-X-,-,-,-,-,-X-.-E-.-X-,-----------------------------------------------------------------
----------------------------------------------------------------------------------------------------------------,-X-.-.-E-.-,-X-X-X-X-X-X-X-X-,-,-X-X-X-X-X-X-.-.-.-.-.-X-----------------------------------------------------------------
----------------------------------------------------------------------------------------------------------------,-X-.-.-.-.-,-.-.-.-.-.-.-,-,-,-.-.-.-.-.-,-.-.-.-E-.-.-X-----------------------------------------------------------------
----------------------------------------------------------------------------------------------------------------,-X-.-.-.-.-,-X-X-X-.-.-.-.-.-.-.-.-.-.-.-X-X-.-.-.-.-,-X-----------------------------------------------------------------
------------------------------------------------------------------------------------------------------------------,-X-.-E-,-X---,-X-.-.-.-.-.-.-.-.-.-.-.-X-,-X-,-E-,-X-------------------------------------------------------------------
--------------------------------------------------------------------------------------------------------------------,-X-,-X-----,-X-.-H-.-.-.-.-.-.-.-.-H-X---,-X-.-X---------------------------------------------------------------------
--------------------------------------------------------------------------------------------------------------------,-X-.-X-----,-X-.-.-.-.-.-E-.-.-.-.-.-X---,-X-.-X---------------------------------------------------------------------
--------------------------------------------------------------------------------------------------------------------,-X-.-X-----,-X-.-.-.-.-.-.-.-.-.-.-.-X---,-X-.-X---------------------------------------------------------------------
--------------------------------------------------------------------------------------------------------------------,-X-E-X-----,-X-.-.-.-.-.-.-.-.-.-.-.-X---,-X-E-X---------------------------------------------------------------------
--------------------------------------------------------------------------------------------------------------------,-X-.-X-----,-X-.-.-.-.-.-.-.-.-.-.-.-X---,-X-.-X---------------------------------------------------------------------
--------------------------,-,-,-------------------------------------------------------------------------------------,-X-.-X-----,-X-.-.-.-.-.-.-.-.-.-.-.-X---,-X-.-X---------------------------------------------------------------------
------------------------,-,-X-X-,-,-,-------------------------------------------------------------------------------,-X-.-X-----,-X-.-.-.-.-.-.-.-.-.-.-.-X---,-X-.-X---------------------------------------------------------------------
--------------------,-,-,-X-.-.-X-X-X-,-,-,-------------------------------------------------------------------------,-X-.-X-----,-X-.-.-.-.-.-E-.-.-.-.-.-X---,-X-E-X---------------------------------------------------------------------
------------------,-,-X-X-.-E-.-.-.-.-X-X-X-,-,-,-------------------------------------------------------------------,-X-E-X-,-,-,-X-.-.-.-.-.-.-.-.-.-.-.-X---,-X-.-X---------------------------------------------------------------------
----------------,-,-X-.-.-.-.-.-.-E-.-.-.-.-X-X-X-,-,---------------------------------------------------------------,-X-.-X-X-X-X-XX.-.-.-.-.-.-.-.-.-.-,-X-,-,-X-.-X---------------------------------------------------------------------
--------------,-,-X-.-.-.-E-.-,-,-,-.-.-E-.-E-.-.-X-X---------------------------------------------------------------,-X-.-X-.-.-.-+X.-.-.-.-.-.-.-.-.-.-,-X-X-X8X-.-X---------------------------------------------------------------------
------------,-,-X-.-.-.-.-.-,-,-.-,-,-,-.-.-.-.-.-.-X---------------------------------------------------------------,-X-.-X-K-.-.-+X.-.-.-.-.-.-.-.-.-.-,-.-.-X8X-E-X---------------------------------------------------------------------
--------,-,-,-X-.-.-.-E-,-,-,-.-.-.-.-,-,-,-,-.-.-.-X---------------------------------------------------------------,-X-E-X-.-.-.-+X.-.-.-.-.-.-.-.-.-.-,-X-X-X8X-.-X---------------------------------------------------------------------
------,-,-X-X-.-.-.-.-,-,-.-.-.-.-.-.-.-.-.-,-,-,-.-X---------------------------------------------------------------,-X-.-X-X-X-X-XX.-.-.-.-.-.-.-.-.-.-.-X---,-X-.-X---------------------------------------------------------------------
----,-,-X-.-.-E-.-E-,-,-.-.-.-.-E-.-.-.-.-.-.-.-,-,-X---------------------------------------------------------------,-X-.-X-----,-X-.-.-.-.-.-E-.-.-.-.-.-X---,-X-.-X---------------------------------------------------------------------
----,-X-.-.-.-.-.-,-,-.-.-.-.-.-.-.-.-.-E-.-.-.-.-.-X---------------------------------------------------------------,-X-.-X-----,-X-.-.-.-.-.-.-.-.-.-.-.-X---,-X-E-X-------------,-,-,-,-------------------------------------------------
----,-X-.-.-.-,-,-,-.-.-.-.-.-.-.-.-.-.-.-.-.-E-.-.-X---------------------------------------------------------------,-X-.-X-----,-X-.-.-.-.-.-.-.-.-.-.-.-X---,-X-.-X-,-,-,-,-,-,-,-X4X4X4,-,---------------------------------------------
----,-X-.-.-,-,-.-.-.-.-.-.-.-.-.-.-.-.-.-.-.-.-.-E-,-X-------------------------------------------------------------,-X-E-X-----,-X-.-.-.-.-.-.-.-.-.-.-.-X---,-X-.-X-X-X-X-X-X-X-X-X-.-X-X-X-------,-,-,-,-,-,-,-,-,-,-------------------
----,-X-.-E-,-.-.-.-.-.-.-.-.-.-E-.-.-.-.-.-.-.-.-.-.-X-------------------------------------------------------------,-X-.-X-----,-X-.-.-.-.-.-.-.-.-.-.-.-X---,-X-.-X-X-W-.-.-.-.-.-.-.-.-.-X-------,-X-X-X-X-X-X-X-X-X-,-,---------------
--,-,-X-.-.-,-.-.-.-.-.-.-E-.-.-.-.-.-.-E-.-.-E-.-.-.-X-------------------------------------------------------------,-X-.-X-----,-X-.-.-.-.-E-.-.-.-.-.-.-X---,-X-E-X-X-.-.-.-.-.-.-.-.-.-.-X-------,-X-,-.-.-.-.-.-.-.-X-X-,-------------
--,-X-.-.-.-,-.-.-.-.-.-.-.-.-.-.-.-.-.-.-.-.-.-.-.-.-X-------------------------------------------------------------,-X-.-X-----,-X-.-.-.-.-.-.-.-.-.-.-.-X---,-X-.-X-X-.-.-.-.-.-.-.-.-.-.-X-------,-X-,-.-.-.-.-.-.-.-.-.-X-,-,---------
--,-X-.-.-.-,-.-.-.-.-.-.-.-.-.-.-.-.-.-.-.-.-.-.-.-.-X-------------------------------------------------------------,-X-.-X-----,-X-.-.-.-.-.-.-.-.-.-.-.-X-,-,-X-.-X-X-.-.-.-.-.-.-.-.-E-,-X-,-,-,-,-X-X-.-.-.-.-.-.-.-.-.-.-X-X-,-,-,-,-
--,-X-.-.-.-,-.-.-.-.-.-.-.-.-.-.-E-.-.-.-E-.-.-.-.-.-X-----------------------------------------------------------,-,-X-,-X-,---,-X-.-H-.-.-.-.-.-.-.-.-H-X-,-X-X-,-X-X-.-.-.-.-.-.-.-.-.-,-X4X4X-X-X-X-X-,-,-,-,-,-,-.-.-.-.-.-,-X-X-X-X-
--,-X-.-.-,-,-.-.-.-E-.-.-.-.-.-.-.-.-.-.-.-.-.-.-.-.-,-X-------------------------------------------------------,-,-X-.-.-.-X-,-,-X-.-.-.-.-.-.-.-.-.-.-.-X-,-X-.-,-,-.-.-.-.-.-E-.-.-.-.-,-.4.4.-.-.-.-.-.-.-.-.-.-,-.-.-.-.-.-,-.-.-.-X-
--,-X-.-E-,-.-.-.-.-.-.-.-.-.-.-.-.-.-.-.-.-.-.-.-.-.-.-X-------------------------------------------------------,-X-.-.-.-.-.-X-X-XW+W+W+W+W+W+W+W+W+W+W+WXWX-X-.-,-,-.-.-.-.-.-.-.-.-.-.-,-.4.4.-.-.-E-.-.-E-.-.-E-,-.-:-.-.-E-,-.-t9.-X-
--,-X-.-.-,-.-.-.-.-.-.-.-.-.-.-.-.-E-.-.-.-.-.-.-.-K-.-X-------------------------------------------------------,-X-.-E-.-E-.-,-.-E-.-.-.-.-E-.-.-E-.-.-E-.-.-,-.-,-,-.-.-.-.-.-.-.-.-E-.-,-.4.4.-.-.-,-,-,-,-,-,-,-,-.-.-.-.-.-,-,-,-,-X-
--,-X-.-.-,-.-.-.-.-.-.-.-E-.-.-.-.-.-.-.-.-.-.-.-.-,-,-X-------------------------------------------------------,-X-t1.-.-.-,-X-X-X-X-X-X-X-X-X-X-X-X-X-X-X-X-X-.-,-X-X-.-.-E-.-.-.-.-.-.-,-X4X4X-X-X-X-X-.-.-.-.-.-.-.-.-.-.-.-,-X-X:t:X:
,-,-X-.-.-,-.-.-.-.-.-.-.-.-.-.-.-.-.-.-.-.-.-.-,-,-X-X-----------------------------------------------------------,-X-.-.-,-X-------------------------------,-X-.-.-X-X-.-.-.-.-.-.-.-.-.-.-X---------,-X-.-.-.-.-.-.-.-.-.-,-X-X-,-X-.-X-
,-X-.-.-.-,-.-.-.-E-.-.-.-.-.-.-.-E-.-.-.-.-,-,-X-X-----------------------------------------------------------------,-X-X-X---------------------------------,-X-.-.-X-X-.-.-.-.-.-.-.-.-.-A-X---------,-X-.-.-.-.-.-.-.-.-,-X-----,-X-X-X-
,-X-.-E-.-,-.-.-.-.-.-.-.-.-.-.-.-.-.-.-,-,-X-X-------------------------------------------------------------------------------------------------------------,-X-.-,-X-X-X-X-X-X-X-X-X-X-X-X-X---------,-X-.-.-.-.-.-.-,-X-X---------------
,-X-.-.-.-,-.-.-.-.-.-.-.-.-.-.-.-.-.-.-X-X-----------------------------------------------------------------------------------------------------------------,-X-.-,-X-X-X-X-X-X-X-X-X-X-X-X-X---------,-X-X-.-X-X-X-X-X-------------------
,-X-.-.-.-,-.-.-.-.-.-.-.-.-E-.-.-.-.-,-X-------------------------------------------------------------------------------------------------------------------,-X-.-,-.-,-.-.-.-,-.-.-,-.-.-E-X-----------,-X-A-X---------------------------
,-X-.-.-.-,-.-.-.-.-.-.-.-.-.-.-.-.-.-X---------------------------------------------------------------------------------------------------------------------,-X-.-,-.-,-.-.-.-,-.-.-,-.-.-.-X-----------,-X7X7X7--------------------------
,-X-.-.-.-,-.-.-.-.-.-.-.-.-.-.-.-.-.-X---------------------------------------------------------------------------------------------------------------------,-X-.-,-.-,-.-.-.-,-H-,-,-.-.-E-X---------------------------------------------
,-X-.-.-,-,-.-.-.-.-.-.-.-.-.-.-.-.-,-X---------------------------------------------------------------------------------------------------------------------,-X-.-,-X-X-.-.-.-.-.-.-,-,-,-,-X---------------------------------------------
,-X-.-.-,-.-.-.-.-.-.-.-.-.-.-.-.-.-X-----------------------------------------------,-,-,-,-,-,-,-,-,-,-,-,-,-,-,-,-,-,-,-,-,-,-,-,-,-,-,-,-,-,-,-,-,-------,-X-.-.-X-X-.-.-.-.-.-.-,-.-.-.-X---------------------------------------------
X-.-.-.-,-.-.-.-.-.-.-.-.-.-.-.-.-.-X-----------------------------------------------,-X-X-X-X-X-X-X-X-X-X-X-X-X-X-X-X-X-X-X-X-X-X-X-X-X-X-X-X-X-X-X-X-------,-X-.-E-X-X-.-.-.-.-.-.-,-,-,-,-X---------------------------------------------
X-.-.-.-,-.-.-.-.-.-.-.-.-.-.-.-.-.-,-X-------------------------------,-,-,-,-,-,-,-,-X-.-.-H-.-.-.-A-.-A-.-.-.-.-.-.-.-.-.-.-.-.-A-.-A-.-.-.-.-.-.-X-------,-X-.-.-X-X-.-.-.-.-.-.-.-.-.-.-X---------------------------------------------
X-.-.-.-,-.-.-.-.-.-.-.-.-.-.-.-.-.-.-X-------------------------------,-X-X-X-X-X-X-X-X-.-.-.-.-.-A-.-A-.-.-A-.-.-E-.-.-E-.-.-.-A-.-A-.-.-A-.-.-.-.-X-------,-X-.-.-X-X-.-,-,-,-,-.-.-.-.-.-X---------------------------------------------
X-.-.-.-,-.-.-.-.-.-.-.-.-.-.-.-.-.-.-,-X-,---------------------------,-X-.-.-.-.-.-X-X-.-.-.-.-.-.-.-.-.-.-.-.-.-.-.-.-.-.-.-.-.-.-.-.-.-.-.-.-.-H-X-------,-X-.-.-X-X-.-,-.-.-A-.-.-.-.-.-X---------------------------------------------
X-.-.-.-,-.-.-.-.-.-.-.-.-.-.-.-.-E-.-.-X-,-,-,-----------------------,-X-.-.-E-.-.-X-X-.-.-.-.-.-A-.-A-.-.-A-.-.-E-.-.-E-.-.-.-A-.-A-.-.-A-.-.-.-.-X-------,-X-.-E-X-X-.-,-.-.-,-.-.-.-X-X-X---------------------------------------------
X-.-.-.-,-,-.-.-.-.-.-.-.-E-.-.-.-.-.-.-.-X-X-,-,---------------------,-X-.-.-.-.-,-X-X-.-.-.-.-.-.-.-.-.-.-.-.-.-.-.-.-.-.-,-,-.-.-.-.-.-.-.-.-.-.-X-------,-X-.-.-X-X-.-,-.-t:,-.-E-.-X-------------------------------------------------
,-X-.-.-.-,-.-.-.-.-.-.-.-.-.-.-.-.-.-.-.-.-.-X-X-,-------------------,-X-.-.-.-.-,-X-X-.-.-.-.-,-,-A-.-A-.-.-.-.-.-.-.-.-.-,-.-,-A-.-A-,-,-.-.-.-.-X-------,-X-.-.-X-X-X-X-X-X-X-X-X-X-X-------------------------------------------------
,-X-.-.-.-,-,-.-.-.-E-.-.-.-.-.-.-.-.-.-.-.-.-.-.-X-,-,-,-,-,-,-,-,-,-,-X-.-.-.-.-,-,-.-.-.-.-.-,-,-.-.-.-.-.-.-.-.-.-.-.-.-.-,-,-.-.-.-,-,-.-.-.-.-X-------,-X-.-.-X---------------------------------------------------------------------
--,-X-.-.-.-,-.-.-.-.-.-.-.-.-.-.-E-.-.-E-.-.-.-.-.-X-X-X-X-X-X-X-X-X-X-X-.-E-.-.-,-,-.-.-.-.-.-.-.-.-.-.-.-.-.-.-.-.-.-.-.-.-.-.-.-.-.-.-.-.-.-.-<-X-------,-X-,-,-X---------------------------------------------------------------------
--,-X-.-.-.-,-.-.-.-.-.-.-.-E-.-.-.-.-.-.-.-.-.-.-.-,-.-.-.-.-.-.-.-L-L-.-.-.-.-E-,-,-.-.-.-.-.-.-.-.-.-.-.-.-.-.-.-.-.-.-.-.-.-.-.-.-.-.-.-.-.-.-.-X-------,-X-,-,-X---------------------------------------------------------------------
--,-X-.-.-.-,-,-.-.-.-.-E-.-.-.-.-.-.-.-.-E-.-.-.-.-,-A-.-A-.-A-.-.-L-L-.-.-.-.-.-,-,-.-.-.-.-.-.-.-.-.-.-.-.-.-.-.-.-.-.-.-.-.-.-.-.-.-.-.-.-.-.-.-X-------,-X-.-.-X---------------------------------------------------------------------
----,-X-.-.-.-,-.-.-.-.-.-.-.-.-E-.-.-.-.-.-.-.-.-.-,-.-.-.-.-.-.-.-L-L-.-.-.-.-.-,-,-.-.-.-.-.-.-.-.-.-.-.-.-.-.-.-.-.-.-.-.-.-.-.-.-.-.-.-.-.-.-.-X---,-,-,-X-,-,-X-,-,-,-,-,-,---------------------------------------------------------
----,-X-.-.-.-,-,-.-.-.-.-.-.-.-.-.-.-.-.-.-.-,-X-X-X-X-X-X-X-X-X-X-X-X-X-.-.-.-.-,-X-X-.-.-.-.-.-.-.-.-.-.-.-.-.-.-.-.-.-.-.-.-.-.-.-.-.-.-.-.-.-.-X---,-X-X-X-,-,-X-X-X-X-X-X-X-,-------------------------------------------------------
------,-X-.-.-.-,-.-.-.-.-.-.-.-.-.-.-.-.-.-.-X-----------,-,-,-,-,-,-,-X-.-.-.-.-.-X-X-X-X-X-X-X-X-X-X-X-X-X-X-.-.-.-.-.-.-.-.-.-.-.-.-.-.-.-.-.-.-X---,-X-.-.-.-.-.-.-.-.-.-.-.-X-,-----------------------------------------------------
------,-X-.-.-,-X-X-.-.-.-.-.-.-.-.-.-.-.-.-,-X-----------,-X-X-X9X-X-X-X-.-.-.-.-.-X-X-X-X-X-X-X-X-X-X-X-X-X-X-.-.-.-.-.-.-.-.-.-.-.-.-.-.-.-.-.-.-X---,-X-.-.-.-.-.-.-H-.-.-.-.-.-X-,---------------------------------------------------
--------,-X-X-X---,-X-X-X-.-.-.-.-.-.-.-.-,-X-------------,-X-.-t9E-.-+-+-.-.-.-<-.-.-,-.-,-.-,-.-,-.-.-,-.-.-.-.-.-.-.-.-.-.-.-.-.-.-.-.-.-.-.-.-.-X---,-X-.-.-.-.-.-.-.-.-.-.-.-.-W-X---------------------------------------------------
--------,-X-------------,-X-X-X-.-.-.-.-.-X-,-,-,-,-,-,-,-,-X-X-X9X-X-X-X-.-.-.-.-.-.-,-.-,-.-,-.-,-.-.-,-.-.-.-.-.-.-.-.-.-.-.-.-.-.-.-.-.-.-.-.-.-X-,-,-X-,-,-,-,-.-.-.-X-X-.-.-.-.-X---------------------------------------------------
------------------------------,-X-X-X-.-,-X-X-X-X-X-X-X-X-X-X---------,-X-H-.-.-.-.-.-,-.-,-.-,-.-,-.-.-,-.-.-E-.-.-.-.-.-.-.-.-.-.-.-.-.-.-.-.-.-.-X-X-X-X-,-,-,-,-.-E-.-.-X-X/X/.-.-X---------------------------------------------------
------------------------------------,-X-X-,-X-W-W-.-W-W-.-W-X-,-,-,-,-,-X-X-X-X-X-X-X-X-X-X-X-X-X-X-.-.-,-X-.-.-.-.-.-.-.-.-.-.-.-.-.-.-.-.-.-.-.-.-+-+-.-.-.-.-,-,-.-.-.-.-,-,/./.-.-X---------------------------------------------------
------------------------------------------,-X-,-,-,-,-,-,-,-X-X-X-X-X-X-X-X-X-X-X-X-X-X-X-X-X-X-X-X-.-.-,-X-.-.-.-.-.-.-.-.-.-.-.-.-E-.-.-.-.-E-.-.-+-+-.-E-.-.-E-,-.-E-.-.-H-,/./E-.-X---------------------------------------------------
------------------------------------------,-X-H-.-.-.-.-.-.-.-.-.-,-.-+-.-.-.-.-,-.-,-.-,-.-,-.-.-.-.-.-,-.-.-.-.-.-.-.-.-.-.-.-.-.-.-.-.-.-.-.-.-.-+-+-.-.-.-.-,-,-.-.-.-.-.-X/X/.-.-X---------------------------------------------------
------------------------------------------,-X-.-.-.-.-.-.-.-.-.-.-E-.-+-.-.-.-.-,-.-,-.-,-.-,-.-.-E-E-.-,-.-.-E-.-.-.-.-.-.-.-.-.-.-.-.-.-.-.-.-.-.-X-X-X-X-.-.-.-.-.-E-.-X-X-.-.-.-.-X---------------------------------------------------
------------------------------------------,-X-H-.-.-.-.-.-.-.-.-.-,-.-+-.-.-.-.-,-.-,-.-,-.-,-,-,-,-,-,-,-X-X-.-.-.-.-.-.-.-.-.-.-.-.-.-.-.-.-.-.-.-X---,-X-.-.-.-.-.-.-.-.-.-.-.-.-H-X---------------------------------------------------
------------------------------------------,-X-.-.-.-.-.-.-.-.-.-.-,-X-X-X-X-X-X-X-X-X-X-X-X-X-X-X-.-.-.-X-X-,-X-X-X-X-X-X-X-X-X-X-X-X-X-X-X-X-X-X-X-X---,-X-.-.-.-.-.-.-.-.-.-.-.-,-X-----------------------------------------------------
------------------------------------------,-X-H-.-.-.-.-.-.-B-.-.-,-W-.-X---------------------,-X-,-,-,-X-----------------------------------------------,-X-.-.-.-.-.-.-H-.-.-.-,-X-------------------------------------------------------
------------------------------------------,-X-,-,-,-.-.-.-.-.-.-.-,-.-.-X---------------------,-X-.-.-.-X-----------------------------------------------,-X-X-X-X-.-X-X-X-X-X-X-X---------------------------------------------------------
------------------------------------------,-X-<-.-<-.-.-.-.-.-.-.-,-W-.-X---------------------,-X-,-E-,-X-----------------------------------------------------,-X-X-X---------------------------------------------------------------------
------------------------------------------,-X-.-.-,-.-.-.-.-.-.-.-,-.-.-X---------------------,-X-.-.-.-X---------------------------------------------------------------------------------------------------------------------------------
------------------------------------------,-X-<-,-<-.-.-.-.-.-.-.-,-W-.-X---------------------,-X-,-E-,-X---------------------------------------------------------------------------------------------------------------------------------
------------------------------------------,-X-.-.-.-.-.-.-.-.-.-.-,-W-.-X---------------------,-X-.-.-.-X---------------------------------------------------------------------------------------------------------------------------------
------------------------------------------,-X-H-.-.-.-.-.-.-.-.-.-,-X-X-X---------------------,-X-,-E-,-X-,-,-,-,-,-,-,-,-,-,-,-,-,-,-,-,-,-,-,-,-,-,-,-,-,-,-----------------------------------------------------------------------------
------------------------------------------,-X-.-.-.-.-.-.-.-.-.-.-.-X-------------------------,-X-.-.-.-X-X-X-X-X-X-X-X-X-X-X-X-X-X-X-X-X-X-X-X-X-X-X-X-X-X-X-,-,-,-,---------------------------------------------------------------------
------------------------------------------,-X-H-.-.-.-.-.-.-.-.-.-.-X-------------------------,-X-.-:-.-.-.-.-.-.-.-.-.-.-.-.-.-:-.-.-.-.-.-:-.-.-.-.-.-.-,-X-X-X-X->---------------------------------------------------------------------
------------------------------------------,-X-.-.-.-.-.-.-.-.-.-.-.-X-------------------------,-X-:-.-:-.-.-<-.-.-.-:-.-.-.-.-.-.-.-.-.-.-.-.-.-.-.-E-.-E-,-L-L-E-.->---------------------------------------------------------------------
------------------------------------------,-X-H-,-,-<-,-,-,-,-.-.-E-X-------------------------,-X-.-W-.-.-.-.-.-.-.-.-.-.-.-.-.-.-.-.-.-.-:-.-.-.-.-.-.-.-,-X-X-X-X->---------------------------------------------------------------------
------------------------------------------,-X-W-W-.-W-W-.-W-X-X-X-X-X-------------------------,-X-X-X-X-X-X-X-X-X-X-X-X-X-X-X-X-X-X-X-X-X-X-X-X-X-X-X-X-X-X-X-----------------------------------------------------------------------------
------------------------------------------,-X-X-X-X-X-X-X-X-X-----------------------------------------------------------------------------------------------------------------------------------------------------------------------------
