--------------------------------------------------------------,-,->->->-,-------------------------
--------------------------------------------------------------,-X-.-E-.-X-------------------------
------------------------------------------------------------,-,-X-.-.-.-X-,-----------------------
------------------------------------------------------------,-X-.-.-.-.-.-X-----------------------
------------------------------------------------------------,-X-H-.-.-.-H-X-----------------------
------------------------------------------------------------,-X-X-.-.-,-,-X-----------------------
--------------------------------------------------------------,-.-X-L-X-X-------------------------
--------------------------------------------------------------,-X-X-L-X-X-------------------------
------------------------------------------------------,-,-,-,-,-X-.-.-.-X-,-,-,-,-----------------
------------------------------------------------------,-X-X-X-X-X-,-,-,-X-X-X-X-X-,---------------
------------------------------------------------------,-X-.-.-.-.-.-E-.-.-.-.-.-.-X-,-------------
----------------------------------------------------,-,-X-.-E-.-.-.-.-.-.-.-E-.-.-.-X-,-----------
----------------------------------------------------,-X-.-.-.-.-E-.-.-.-E-.-.-.-.-.-.-X-,---------
----------------------------------------------------,-X-.-.-.-.-.-.-E-.-.-.-.-.-.-.-.-.-X-,-------
----------------------------------------------------,-X-.-.-E-.-.-,-,-,-,-,-E-,-,-.-.-.-.-X-,-----
--------------------------------------------------,-,-X-.-.-.-.-,-,-.~.~.~.~.~.~,~,-.-.-.-.-X-,---
--------------------------------------------------,-X-.-.-.-.-,-,-.~.~.~.~.~.~.~.~,~,-.-.-.-.-X-,-
--------------------------------------------------,-X-.-.-.-,-,-.~.~.~.~.~.~.~.~.~.~,~,-.-.-.-.-X-
--------------------------------------------------,-X-.-.-,-,-.~.~.~.~.~.~.~.~.~.~.~.~,~,-.-.-.-X-
------------------------------------------------,-,-X-.-.-,-.~.~.~.~.~.~.~.~.~.~.~.~.~.~,~.-.-.-X-
------------------------------------------------,-X-.-.-.-,-.~.~.~.~.~,~,~,~,~,~,~.~.~.~,~.-.-.-X-
------------------------------------------------,-X-.-.-.-,-.~.~.~.~.~,~.-.-.-.-,-.~.~.~,~.-.-.-X-
------------------------------------------------,-X-.-.-.-,-.~.~.~.~.~,~.-.-.-.-,-.~.~.~,~.-.-.-X-
----------------------------------------------,-,-X-.-.-.-,-.~.~.~.~.~,~.-.-W-.-,-.~.~.~,~.-.-.-X-
----------------------------------------------,-X-.-.-.-.-,-.~.~.~.~.~,~.-.-.-.-,-.~.~.~,~.-.-.-X-
----------------------------------------------,-X-.-.-.-.-,-.~.~.~.~.~,~,-,-,-,-,-.~.~.~,~.-.-.-X-
----------------------------------------------,-X-.-.-.-.-,-.~.~.~.~.~.~.~.~.~.~.~.~.~.~,~.-.-.-X-
------------------------------------------------,-X-.-.-.-,-,~.~.~.~.~.~.~.~.~.~.~.~.~,~,~.-.-.-X-
------------------------------------------------,-X-.-.-.-.-,-,~.~.~.~.~.~.~.~.~.~.~,~,~.-.-.-.-X-
------------------------------------------------,-X-.-.-.-.-.-,-,~.~.~.~.~.~.~.~.~,~,~.-.-.-.-,-X-
--------------------------------------------------,-X-.-.-.-.-.-,-,~.~.~.~.~.~.~,~,~.-.-.-.-.-X---
--------------------------------------------------,-X-.-.-.-.-.-.-,-,~,~,~,~,~,~,~.-.-.-.-.-,-X---
--------------------------------------------------,-X-.-.-.-.-.-.-.-.-.-.-.-.-.-.-.-.-.-.-.-X-----
----------------------------------------------------,-X-.-.-.-.-.-.-.-.-.-.-.-.-.-.-.-.-.-,-X-----
----------------------------------------------------,-X-.-.-.-.-.-.-.-.-.-.-.-.-.-.-.-.-.-X-------
----------------------------------------------------,-X-.-.-.-.-.-.-.-.-.-.-.-.-.-.-.-.-,-X-------
------------------------------------------------------,-X-,-,-,-,-,-,-.-.-.-.-.-.-.-.-.-X---------
------------------------------------------------------,-X-X-X-.-.-.-X-X-X-.-.-.-.-.-.-,-X---------
----------------------------------------------------------,-X-.-.-.-X---,-X-.-.-.-.-,-X-----------
----------------------------------------------------------,-X-.-.-.-X-----,-X-,-,-,-X-------------
----------------------------------------------------------,-X-.-E-.-X-----,-X-L-L-L-X-------------
----------------------------------------------------------,-X-.-.-.-X-----,-X-L-L-L-X-------------
----------------------------------------------------------,-X-.-K-.-X-----,-X-.-.-.-X-------------
----------------------------------------------------------,-X-X-X-X-X-----,-X-.-.-.-X-------------
--------------------------------------------------------------------------,-X-.-.-.-X-------------
--------------------------------------------------------------------------,-X-.-E-.-X-------------
--------------------------------------------------------------------------,-X-.-.-.-X-------------
--------------------------------------------------------------------------,-X-,-,-,-X-------------
--------------------------------------------------------------------------,-X-.-.-.-X-------------
--------------------------------------------------------------------------,-X-,-,-,-X-------------
------------------------------------------,-,-,-,---,-,-,-,---------------,-X-.-.-.-X-------------
------------------------------------------,-X-X-X---,-X-X-X---------------,-X-,-,-,-X-------------
------------------------------,-,-,-,-,-,-,-X-E-X-,-,-X-E-X-,-,-,-,-,-,-,-,-X-.-.-.-X-------------
----------------------------,-,-X-X-X-X-X-X-X-,-X-X-X-X-,-X-X-X-X-X-X-X-X-,-X-,-,-,-X-------------
------------------------,-,-X-X-.-.-.-.-,-.-.-.-.-.-.-.-.-.-.-.-.-.-.-.-X-,-X-.-.-.-X-------------
----------------------,-,-X-.-<-.-.-.-.-,-.-.-.-.-.-.-.-.-.-.-.-.-.-.-.-X-,-X-.-E-.-X-------------
--------------------,-,-X-.-.-.-.-.-.-,-,-.-.-.-.-.-.-.-.-.-.-.-.-.-.-E-X-,-X-.-.-.-X-------------
----------------,-,-X-X-.-.-.-.-.-.-,-,-.-.-.-.-.-.-.-.-.-.-.-.-.-.-.-.-X-,-X-.-.-.-X-------------
--------------,-,-X-.-.-.-.-.-.-.-,-,-.-.-.-.-.-.-.-.-.-.-.-.-.-.-.-E-.-X-,-X-.-.-.-X-------------
------------,-,-X-.-.-.-.-.-.-,-,-,-.-.-.-.-.-.-.-.-:-.-.-.-.-.-.-.-.-.-X-,-X-E-.-.-X-------------
--------,-,-X-X-.-.-.-A-.-.-,-,-.-.-.-.-.-.-.-.-.-.-.-.-.-.-.-.-.-.-.-.-X-,-X-.-.-.-X-------------
------,-,-X-.-.-.-.-.-.-.-,-,-.-.-.-.-.-.-.-.-.-.-.-.-.-.-.-.-.-.-.-.-.-X-,-X-.-.-.-X-------------
----,-,-X-.-.-.-.-.-.-.-,-,-.-.-.-.-.-.-.-.-.-.-.-.-.-.-.-.-.-.-.-.-.-.-X-,-X-.-E-.-X-------------
,-,-X-X-.-.-.-.-.-.-.-,-,-.-.-.-.-.-.-.-.-.-.-.-.-.-.-.-.-.-.-.-.-.-.-.-X-,-X-.-.-.-X-------------
,-X-.-.-.-.-.-.-.-.-,-,-.-.-.-.-.-.-.-.-.-.-.-.-.-.-.-.-.-.-.-.-.-.-.-.-X-,-X-.-.-.-X-------------
X-.-.-.-.-.-.-.-,-,-,-.-.-.-.-.-.-.-.-.-.-.-.-.-.-.-.-.-.-.-.-.-.-.-.-.-X-,-X-.-.-.-X-------------
X-.-.-.-.-.-.-,-,-.-.-.-.-.-.-.-.-.-.-.-.-.-.-.-.-.-.-.-.-.-.-.-.-.-.-.-X-,-X-.-.-,-X-,-,---------
X-.-.-.-.-.-,-,-.-.-.-.-.-.-.-.-.-.-.-.-,-,-,-,-,-,-,-,-,-,-,-,-,-,-,-,-X-X~X~.-.-,-X-X-X---------
X-.-.-.-.-,-,-.-.-.-.-.-.-.-.-.-.-.-.-.-,-A~.~.~.~.~.~.~.~.~.~.~.~.~.~.~.~A~,~.-.-A-.-.-X---------
X-.-.-.-A-,-.-.-.-.-.-.-.-.-.-.-.-.-.-.-,-.~.~.~.~.~.~.~.~.~.~.~.~.~.~.~,~,~,~.-.-,-,-,-X-,-,-----
X-<-.-.-.-,-.-H-.-.-.-.-.-.-.-.-.-.-.-.-,-.~.~.~.~.~.~.~.~.~.~.~.~.~,~,~,~.-.-.-.-.-.-,-,-X-X-,-,-
X-.-.-.-.-,-.-.-.-.-.-.-.-.-.-.-.-.-.-.-,-.~.~.~,~,~,~,~,~,~,~,~,~,~,~.-.-.-.-.-.-.-E-.-.-,-.-X-X-
X-.-.-.-.-,-.-.-.-.-.-,-,-,-<-,-,-.-.-.-,-.~.~.~,~,-.-,-.-.-.-.-.-.-.-.-.-.-.-.-.-.-.-.-.-,-.-.-X-
X-.-.-.-.-,-.-.-.-.-.-,-.-.-.-.-,-.-.-.-,-.~.~.~,~,-,-,-.-.-.-.-.-.-.-.-.-.-E-.-.-.-.-.-E-,-.-.-X-
X-.-.-.-.-,-.-.-.-.-.-,-.-.-E-.-,-.-.-.-,-.~.~.~,~.-,-,-.-.-.-.-.-,-,-.-.-.-.-.-E-.-.-.-,-,-.-.-X-
X-.-.-.-.-,-.-.-.-.-.-,-.-.-.-.-,-.-.-.-,-.~.~.~,~,-,-,-X-X-X-.-X-X-X-,-,-.-.-.-.-.-,-,-,-.-.-,-X-
X-.-.-.-.-,-.-.-.-.-.-,-.-.-.-.-,-.-.-.-,-.~.~.~,~.-.-A-X-,-X-X-X-,-X-.-,-,-,-,-,-,-,-.-.-,-X-X---
X-.-.-.-.-,-.-.-.-.-.-,-.-.-E-.-,-.-.-.-,-.~.~.~,~,-,-,-X---------,-X-X-.-.-.-.-.-.-.-.-,-X-------
X-.-.-.-.-,-.-.-.-.-.-,-.-.-.-.-,-.-.-.-,-.~.~.~,~.-.-.-X-------------,-X-X-.-.-.-.-,-X-X---------
X-.-.-.-.-,-.-.-.-.-.-,-.-.-.-.-,-.-.-.-,-.~.~.~,~,-,-,-X-----------------,-X-X-X-X-X-------------
X-.-.-.-.-,-.-.-.-.-.-,-.-.-E-.-,-.-.-.-,-.~.~.~,~.-.-.-X-,-,-,-,-,-,-,-,-,-,-,-,-,-,-,-,-,-,-,-,-
X-.-.-.-.-,-.-.-.-.-.-,-.-.-.-.-,-.-.-.-,-.~.~.~,~,-,-,-X-X-X-X-X-X-X-X-X-X-X-X-X-X-X-X-X-X-X-X-X-
X-.-.-.-.-,-.-.-.-.-.-,-.-.-.-.-,-.-.-.-,-.~.~.~,~,-,-,-.-.-,-.-,-.-.-.-.-.-.-.-.-.-.-.-.-.-.-.-X-
X-.-.-.-.-,-.-.-.-.-.-,-.-.-E-.-,-.-.-.-,-.~.~.~,~,-,-,-.-.-,-.-,-.-E-.-.-.-.-.-.-.-.-.-.-.-E-.-X-
X-<-.-.-.-,-.-.-.-.-.-,-.-.-.-.-,-.-.-.-,-A~.~.~.~,~,-,-,-,-,-,-,-,-,-,-,-,-,-,-,-,-,-,-,-.-.-.-X-
X-.-.-.-.-,-.-.-.-.-.-<-.-.-K-.-,-W-.-.-,-,~,~.~.~.~.~.~.~.~.~.~.~.~.~.~.~.~.~.~.~.~.~.~,~.-.-.-X-
X-.-.-.-.-,-.-.-.-.-.-,-.-.-.-.-,-.-.-.-.-.-,~,~.~.~.~.~.~.~.~.~.~.~.~.~.~.~.~.~.~.~.~A~,~.-.-.-X-
X-.-.-.-.-,-.-.-.-.-.-,-.-.-E-.-,-.-.-.-.-.-.-,-,~,~.~.~.~.~.~.~.~.~.~.~.~.~.~.~.~.~.~.~,~.-.-.-X-
X-.-.-.-.-,-.-.-.-.-.-,-.-.-.-.-,-.-.-.-.-.-.-.-.-,~A~,~,~,~,~,~,~,~,~,~,~,~,~,~,~.~.~.~,~.-.-.-X-
X-.-.-.-.-,-.-.-.-.-.-,-.-.-.-.-,-.-.-.-.-.-.-.-.-.-.-.-.-.-.-.-.-.-.-.-........,..~.~.~,~.-E-.-X-
X-.-.-.-.-,-.-.-.-.-.-,-.-.-E-.-,-.-.-.-.-.-.-.-.-.-.-.-.-.-.-.-.-.-.-.-........,..~.~.~,~.-.-.-X-
X-.-.-.-.-,-.-.-.-.-.-,-.-.-.-.-,-.-.-.-.-.-,-,-,-,-.-.-.-.-.-.-.-.-.-.-........,..~.~.~,~.-.-.-X-
X-.-.-.-.-,-.-.-.-.-.-,-.-.-.-.-,-.-.-.-.-.-,-.-.-,-.-.-.-.-.-.-.-.-.-.-........,..~.~.~,~.-.-.-X-
X-.-.-.-.-,-.-.-.-.-.-,-.-.-E-.-,-.-.-.-.-.-,-,-,-,-.-.-.-.-.-.-.-.-.-.-........,..~.~.~,~.-.-.-X-
X-.-.-.-.-,-.-.-.-.-.-,-.-.-.-.-,-.-.-.-.-.-,-.-.-,-.-.-.-.-.-.-.-.-.-.-.-.-.-.-,-.~.~.~,~.-.-.-X-
X-.-.-.-.-,-.-.-.-.-.-,-.-.-.-.-,-.-.-.-.-.-,-,-,-,-.-.-.-.-.-.-.-.-.-.-.-.-.-.-,-.~.~.~,~.-.-.-X-
X-.-.-.-.-,-.-.-.-.-.-,-.-.-E-.-,-.-.-.-.-.-,-.-.-,-.-.-.-.-.-.-.-.-.-.-.-.-.-.-,-.~.~.~,~.-.-.-X-
X-.-.-.-.-,-.-.-.-.-.-,-,-,-,-,-,-.-.-.-.-,-,/,/,/,/,/.-.-.-.-.-.-.-.-.-.-.-.-.-,-,~.~.~,~E-.-.-X-
X-.-.-.-.-,-.-.-.-.-.-.-.-.-<-.-.-.-.-.-,-,-.-.-.-.-,-,-.-.-.-.-.-.-.-.-.-.-.-.-.-,-,~.~,~.-.-.-X-
X-.-.-.-.-,-.-.-.-.-.-.-.-.-.-.-.-.-.-,-,-.-.-.-.-.-.-,-,-.-.-.-.-.-.-.-.-.-.-.-.-.-,-,~,~.-.-.-X-
X-<-.-.-A-,-.-H-.-.-.-.-.-.-.-.-.-.-,-,-.-<-.-.-.-.-.-.-,-,-.-.-.-.-.-.-.-.-.-.-.-.-.-,-,~.-.-.-X-
X-.-.-.-.-,-,-,-,-,-,-,-,-,-,-,-,-,-,-.-.-.-X-X-X-X-X-.-.-,-,-,-,-,-,-,-,-,-,-,-,-,-,-,-,-.-.-.-X-
X-.-.-.-.-.-.-.-.-.-.-.-.-.-.-.-.-.-,-.-.-.-X-.-.-.-X-.-.-.-,-./././././././././././././,/.-.-.-X-
X-.-.-.-.-.-A-.-.-.-.-.-.-.-.-.-.-.-,-.-.-.-X-.-.-.-X-E-.-.-,-./././././././././././././,/.-.-.-X-
X-.-.-.-.-.-.-.-.-.-.-.-.-.-.-.-.-.-,-.-.-.-X-.-.-.-X-.-.-.-,-./././././././././././././,/.-E-.-X-
X-X-X-X-X-X-X-X-X-X-X-X-X-X-X-X-X-X-X-.-.-.-X-X-X-X-X-.-.-,-X-X/X/X/X/X/X/X/X/X/X/X/X/X/X/X-X-X-X-
------------------------------------,-X-.-.-.-.-E-.-.-.-,-X---------------------------------------
--------------------------------------,-X-.-.-.-.-.-.-,-X-----------------------------------------
----------------------------------------,-X-.-.-.-.-,-X-------------------------------------------
------------------------------------------,-X-+-+-+-X---------------------------------------------
----------------------------------------,-,-X-.-.-.-X---------------------------------------------
----------------------------------------,-X-X-.-.-.-X---------------------------------------------
----------------------------------------,-X-.-A-.-A-X---------------------------------------------
----------------------------------------,-X-X-.-.-.-X---------------------------------------------
------------------------------------------,-X-H-.-H-X---------------------------------------------
------------------------------------------,-X-X-X-X-X---------------------------------------------
