------------------------------------------------------------------------,-X~X~X~X~X~X~X~X~X~X~X~X~X~X~X~X~X~X~----------------------------------------------------------------------------------------
------------------------------------------------------------------------,-X~.~.~.~,~,~,~,~,~,~.~.~,~,~,~,~.~X~----------------------------------------------------------------------------------------
------------------------------------------------------------------------,-X~.~,~,~,~.~,-,-,-,~,~,~,~.~,~,-.~X~----------------------------------------------------------------------------------------
------------------------------------------------------------------------,-X~.~,~.-,-,-,~.~,~,-,-K-.-.-,-.~.~X~----------------------------------------------------------------------------------------
------------------------------------------------------------------------,-X~,~,~,-,-.~.~.~.~.~,~,-,-,-.~,~,~X~----------------------------------------------------------------------------------------
------------------------------------------------------------------------,-X~,~,~,-.~.~.~.~.~.~.~.~,~,-,~t5t5X5----------------------------------------------------------------------------------------
------------------------------------------------------------------------,-X~,~,-.~.~.~.~.~.~.~.~.~.~.~,~t5.-X-----------------------------------------------------------------------------------------
------------------------------------------------------------------------,-X~.~.~.~,~,~,~,~,~,~.~.~.~.~,~t5t5X5----------------------------------------------------------------------------------------
------------------------------------------------------------------------,-X~.~.~,~,~.-.-.-.-,~,~.~.~.~.~.~.~X~----------------------------------------------------------------------------------------
------------------------------------------------------------------------,-X~.~,~,~.-,-,-,-,-.-,-.~,~,~.~.~.~X~----------------------------------------------------------------------------------------
------------------------------------------------------------------------,-X~,~,~.-,-,~.~.~,~,-,-.~,~,-.~.~.~X~----------------------------------------------------------------------------------------
------------------------------------------------------------------------,-X~,~.~.-,-.~.~.~.~,~,-,~,~,-.~.~.~X~----------------------------------------------------------------------------------------
------------------------------------------------------------------------,-X~,~,-.-,-.~.~.~.~.~,~,~.-,-.~.~.~X~----------------------------------------------------------------------------------------
------------------------------------------------------------------------,-X~.~,~,~,-.~.~.~.~,~,~.-,-,-.~.~.~X~----------------------------------------------------------------------------------------
------------------------------------------------------------------------,-X~.~.~.~.~.~.~.~.~,~,-,-,-.~.~.~.~X~----------------------------------------------------------------------------------------
------------------------------------------------------------------------,-X~.~.~.~.~.~,~,~.~.~.~.~.~.~.~.~.~X~----------------------------------------------------------------------------------------
------------------------------------------------------------------------,-X~.~.~.~.~.~,~,-,~,~.~.~.~.~.~.~.~X~----------------------------------------------------------------------------------------
------------------------------------------------------------------------,-X~.~.~.~.~.~,~.-,-,-.~.~.~.~.~.~.~X~----------------------------------------------------------------------------------------
------------------------------------------------------------------------,-X~.~.~.~.~,~,~.-,-.~.~.~.~.~.~.~.~X~----------------------------------------------------------------------------------------
------------------------------------------------------------------------,-X~.~.~.~.~,~,-,-,-.~.~.~.~.~.~.~.~X~----------------------------------------------------------------------------------------
------------------------------------------------------------------------,-X~.~.~.~.~.~.~.~.~.~.~.~.~.~.~.~.~X~----------------------------------------------------------------------------------------
------------------------------------------------------------------------,-X~.~.~.~.~.~.~.~,~,~.~.~.~.~.~.~.~X~----------------------------------------------------------------------------------------
------------------------------------------------------------------------,-X~,~,~,~.~.~.~.~,~,-.~.~.~.~.~.~.~X~----------------------------------------------------------------------------------------
------------------------------------------------------------------------,-X~t5t5t5.~.~.~,~,~,-.~.~.~.~.~.~.~X~----------------------------------------------------------------------------------------
------------------------------------------------------------------------,-X~t5.-t5.~.~.~,~.~,-,~.~.~.~.~.~.~X~----------------------------------------------------------------------------------------
------------------------------------------------------------------------,-X~t5t5t5.~.~.~,~,-,-,~.~.~.~.~.~.~X~----------------------------------------------------------------------------------------
------------------------------------------------------------------------,-X~.~.~.~.~.~.~.~.~,~,-.~.~.~.~.~.~X~----------------------------------------------------------------------------------------
------------------------------------------------------------------------,-X~.~.~.~.~.~.~.~.~.~.~.~.~.~.~.~.~X~----------------------------------------------------------------------------------------
------------------------------------------------------------------------,-X~.~.~.~.~.~,~,~.~.~.~.~.~.~.~.~.~X~----------------------------------------------------------------------------------------
------------------------------------------------------------------------,-X~.~.~.~.~.~,~,-,~,~.~.~.~.~.~.~.~X~----------------------------------------------------------------------------------------
------------------------------------------------------------------------,-X~.~.~.~.~.~,~E-,-,-.~.~.~.~.~.~.~X~----------------------------------------------------------------------------------------
------------------------------------------------------------------------,-X~.~.~.~.~.~,~.-,-.~.~.~.~.~.~.~.~X~----------------------------------------------------------,-,-,-,-,-,-,-----------------
------------------------------------------------------------------------,-X~.~.~.~.~.~,~,-,-.~.~.~.~.~.~.~.~X~------------------------------------,-,-,-,-,-,-,-,-,-,---,-X-X-X-X-X-X-,---------------
------------------------------------------------------------------------,-X~.~.~.~.~.~.~.~.~.~.~.~.~.~.~.~.~X~------------------------------------,-X-X-X4X-X-X-X-X-X---,-X2.-.-.-.-.-X-,-------------
------------------------------------------------------------------------,-X~.~.~.~.~.~.~.~.~.~.~.~.~.~.~.~.~X~------------------------------------,-X-t3t4.-.-.-.-E-X---,-X2E-.-.-.-.-.-X-------------
------------------------------------------------------------------------,-X~.~.~.~.~.~.~.~.~.~.~.~.~.~.~.~.~X~------------------------------------,-X4t4t4.-.-E-.-.-X---,-X2.-.-.-.-E-.-X-------------
------------------------------------------------------------------------,-X~X~X~X~X~X~X~,~,~,~,~X~X~X~X~X~X~X~,-,-,-,-,-,-,-,-,-,-,-,-,-,---------,-X-.-.-.-E-.-.-,-X-,-,-X-.-.-.-.-.-.-X-------------
------------------------------------------------------------------------------------,-X-.-.-.-.-X-------,-,-,-X-X~X~X~X~X~X~X~X~X~X~X~X~X~,-,-----,-X-H-E-.-.-.-,-X-,-X-X-X-X-E-.-.-.-.-X-------------
------------------------------------------------------------------------------------,-X-.-<-.-.-X-----,-,-X-X~.~.~.~.~.~.~.~.~.~.~.~.~.~.~X~X~,-,-,-X-X-X-.-.-.-X-,-X-A-.-.-X-X-.-.-.-.-X-------------
------------------------------------------------------------------------------------,-X-.-.-.-.-X-----,-X~.~.~.~.~.~.~.~E~.~.~.~E~.~.~.~.~.~.~X~X~,---,-X-,-,-,-X-X-.-.-E-.-.-XR.-.-.-.-X-------------
------------------------------------------------------------------------------------,-X-.-t5.-.-X---,-,-X~.~.~.~.~.~.~.~.~.~H~.~.~.~.~.~.~.~.~.~.~X---,-X~.~.~,~X~X-.-.-.-.-.-.-.-.-E-.-X-------------
--------------------------------------------------------------------------------,-,-,-X-L-L-L-X-X---,-X~.~.~.~.~.~.~.~,~X~X~X~X~X~X~.~.~.~.~.~.~.~X~,-,-X~.~.~,~X-X-.-H-.-.-.-XR.-.-.-.-X-------------
------------------------------------------------------------,-,-,-,-,-,-,-,-,-,-,-X-X-X-L-L-L-X-X-,-,-X~.~.~.~.~.~,~X~X-X-X-X-X-X-,-X~X~.~.~.~.~.~.~X-,-X~.~.~.~,~.-K-.-.-.-X-.-.-.-.-.-X-------------
------------------------------------------------------------,-X-X-X-X-X-X-X-X-X-X-X-.-E-.-.-.-.-X-,-X~.~.~.~.~,~X~X-X-X-E-.-E-.-.-X-X-,-X~.~.~.~.~.~X~,-X~.~.~.~,~,-.-X-X-X-.-.-.-.-.-.-X-------------
--------------------------------------------------------,-,-,-X-A-.-.-.-.-.-.-.-X-X-.-.-.-.-E-.-X-,-X~.~.~.~.~X~,-X-.-.-.-.-.-.-E-.-.-X-X-.~.~.~.~.~X~,-X~.~.~.~.~,~,~X-X~X-.-.-.-.-.-.-X-------------
--------------------------------------------------------,-X-X-X-.-.-.-.-.-.-.-.-.-L-.-.-.-.-.-.-X-,-X~.~.~.~,~X~.-X-E-.-E-.-E-.-.-.-E-X-,-X~.~.~.~.~X~,-X~.~.~.~.~.~.~.~,~X-.-.-.-.-.-,-X-------------
--------------------------------------------------------,-X-H-.-.-.-.-.-.-E-.-.-.-L-.-.-.-.-.-.-X-,-X~.~.~.~X~,-X-.-.-.-.-.-.-.-E-.-.-.-X-X-.~.~.~.~X~,-X~.~.~.~.~.~.~.~,~X-.-.-.-.-,-X---------------
--------------------------------------------------------,-X-.-.-.-.-.-.-.-.-.-.-.-L-.-.-E-.-.-.-X-,-X~.~.~.~X~,-X-E-E-.-E-.-X-X-X-.-.-.-X-,-X~.~.~.~X~,-X~.~.~.~.~.~.~.~,~X-.-.-.-.-X-----------------
--------------------------------------------------------,-X-.-.-.-E-.-.-.-.-.-.-X-X-X-X-.-.-X-X-X-,-X~.~.~.~X~,-X-+-+-+-X-X-X-X-X-X-E-.-.-X-X~.~.~.~X~,-X~.~.~.~E~.~.~.~,~X-.-.-.-.-X-----------------
--------------------------------------------------------,-X-.-.-.-.-.-.-.-.-E-.-X-X-X~X-,-,-X-X~X~X~X~.~.~.~X~X~X-+-+-+-X-X-,-,-,-X-.-.-./X/X~.~.~.~X~X~X~.~.~.~.~.~.~.~,~.-.-.-.-.-X-----------------
--------------------------------------------------------,-X-.-.-.-.-.-E-.-.-.-,-,-,~.~.-.-.-.~.~.~.~.~.~.~.~.~,-.-.-.-,-.-.-.-E-A-X-.-.-./,/.~.~.~.~.~.~.~.~.~.~.~.~.~.~,~.-H-E-.-.-X-----------------
--------------------------------------------------------,-X-.-.-.-.-.-.-.-E-.-,-,-,~.~.~.-.-.-.~.~.~.~.-.-.-.-,-.-A-.-,-.-.-.-.-.-X-.-.-./,/.~.~.~.~.~.~.~.~.~.~.~.~.~.~,~.-.-.-.-.-X-----------------
--------------------------------------------------------,-X-.-.-.-E-.-E-.-.-,-,-,-.~.~.~.-.-.-.-.-.-.-.-.-.-.-,-X-.-.-,-X-X-,-,-,-X-.-.-./,/.~.~.~.~.~.~.~.~.~.~.~.~.~.~,~X-.-.-.-.-X-----------------
--------------------------------------------------------,-X-.-.-.-.-.-.-.-,-,-,-,-.~.~.~.~.-.-.-.-.-.-.~.~.~.~,~.-.-.-.-X-X-.-.-.-X-.-.-./,/,~,~,~,~,~,~,~,~,~,~,~,~,~,~,~X-.-.-.-.-X-----------------
,-,-,-,-,-,-,-,-,-,-,-,-,-,-,-,-,-,-,-,-,---------------,-X-.-E-.-.-.-,-,-,-,-,-.~.~.~.~.~.~.~.~.~.~.~.~.~.~.~,~.-.-.-.-X-X-,-,-,-X-.-.-A-X-X-.-.-.-.-.-.-.-.-.-.-.-.-.-.-X-.-.-.-.-X-----------------
X-X-X-X-X-X-X-X-X-X-X-X-X-X-X-X-X-X-X-X-X---------------,-X-.-.-.-X-X-,-,-,-,-.~.~.~.~.~.~.~.~.~.~.~.~.~.~.~.~,~.-.-.-.-X-X-,-,-,-X-.-.-.-X-X-.-.-.-.-.-.-.-.-.-.-.-.-.-.-X-.-.-.-.-X-----------------
X-.-.-.-.-.-.-.-X-:-.-X-X-.-.-.-.-.-.-.-X---------------,-X-.-.-.-X-X-,~,~,~,~.~.~.~.~.~.~.~.~.~.~.~.~.~.~.~.~,~.-.-E-.-X-X-.-.-.-X-.-.-.-.-.-.-.-.-.-.-.-.-.-.-.-.-.-.-.-.-.-.-.-.-X-----------------
X-.-E-.-E-.-E-.-X-.-:-X-X-.-E-.-E-.-E-.-X---------------,-X-.-.-.-X-X~,~t3t3t3.~.~.~E~.~.~.~.~.~.~.~.~.~.~.~.~,~.-.-.-.-X-X-,-,-,-X-.-.-.-.-.-.-E-.-E-.-E-.-E-.-E-.-E-.-.-.-H-E-.-.-X-----------------
X-X-X-.-.-.-X-X-X-.-:-X-X-X-X-.-.-.-X-X-X---------------,-X-.-.-.-X-X~,~t3.-t3.~.~.~.~.~.~.~.~.~.~.~.~.~.~.~.~,~.-.-.-E-X-X-,-,-,-X-.-.-.-X-X-X-.-.-.-.-.-.-.-.-.-,-,-,-,-.-.-.-.-.-X-----------------
--,-X-.-.-.-X-X-X-.-.-X-X-X-X-.-.-.-X-------------------,-X-.-.-.-X-X~,~t3t3t3.~.~.~.~.~.~.~.~.~.~.~.~.~.~.~.~,~.-.-.-.-X-X-.-.-.-X-.-.-X-X-X-X-X-.-.-X-X-X-X-X-X-X-.-.-A-X-.-.-.-.-X-----------------
,-,-XW+W+W+WXWX->-.-E-X-X-X-XW+W+W+WXW,-,---------------,-X-.-.-.-X-X~.~.~.~.~.~.~.~,~,~,~,~,~,~,~,~,~,~,~,~,~,~.-.-.-.-X-X-,-,-,-X-.-X-X-.-H-.-X-X-.-X-,-,-,-,-,-X-,-,-,-X-X-.-.-.-X-----------------
X-X-X-.-.-.-X-X->-.-.-X-X-X-X-.-.-.-X-X-X---------------,-X-.-.-.-X-X-.~.~.~.~.~.~.~,~X-,~,~,~,~,~X-X-.-.-.-.-.-X-.-.-E-X-X-,-,-,-X-.-.-.-A-<-.-A-.-.-X-X-X-X-X-X-X-,-,-,-X-X-.-.-.-X-----------------
X-.-.-.-.-.-.-A->-X-.-X-X-A-.-.-.-.-.-.-X---------------,-X-.-.-.-X-,-.~.~.~.~.~.~.~,~,~A-.-.-.-.-L-L-.-.-.-.-.-.-A-.-.-X-X-.-.-.-X-.-.-.-.-.-.-.-.-.-.-,-A-.-A-,-.-.-E-.-X-X-.-.-.-X-----------------
X-A-.-.-.-.-.-.-X-XY+YXYX-.-.-.-.-.-.-.-X---------------,-X-.-.-.-X-,-.~.~.~.~.~.~.~,~,~.-.-.-E-.-L-L-.-E-.-.-.-.-.-.-.-X-X-.-.-.-X-.-.-.-.-.-.-.-.-.-.-,-.-<-,-,-.-.-.-.-.-.-.-.-.-X-----------------
X-.-.-.-.-.-.-.-.-.-.-.-.-.-.-.-.-.-.-.-X-,-,-,-,-,-,-,-,-X-.-.-.-X-,-.~.~.~.~.~.~.~,~,~.-.-.-.-.-L-L-.-.-.-A-E-A-E-.-.-X-X-.-.-.-X-.-.-.-.-E-.-.-.-.-E-,-H-.-A-,-.-.-.-.-.-.-.-.-.-X-----------------
X-.-.-.-.-.-.-.-.-.-.-.-.-.-.-.-.-.-.-.-X-X-X6X-X-XVXVX-,-X-.-.-.-X-X-.~.~.~.~.~.~.~,~,~.-E-.-X-X-X-X-X-.-X-X-X-X-X-X-.-X-X-+-+-+-X-.-X-X-X-X-X-X-.-X-X-X-.-.-,-,-.-E-.-.-E-.-.-.-H-X-----------------
,-X-.-.-.-.-A-.-.-.-.-.-.-.-.-.-.-:-.-.-.-.-.6.-.-+V+VX-,-X-.-.-.-X-X~.~.~.~.~.~.~.~,~,~.-.-.-X---,-,-X-E-X-X-X-X-X-X-E-X-X-+-+-+-X-E-X-X-X-X-X-X-E-X-,-X-.-.-,-,-,-,-,-,-,-X-X-X-X-X-----------------
,-X-.-.-.-.-.-.-.-.-.-.-.-.-A-.-.-.-.-.-.-.-.6.-.-+V+VX-X-X-E-.-.-X-X-.~.~.~.~.~.~.~,~,~.-.-.-X-,-,-X-X-,-X-X-,-,-,-X-,-X-X-.-.-.-X-,-X-X-,-,-,-X-,-X-X-X-.-.-.-.-.-.-H-,-,~X~------------------------
,-X-.-.-.-X7X-X-.-.-.-.-.-X-X-X-.-.-.-.-.-.-.6.-.-+V+V.-L-.-.-.-.-X-,-.~.~.~.~.~.~.~,~,~.-.-E-X-X-X-X-.-.-.-.-.-.-.-.-.-.-.-.-.-.-.-.-.-.-.-.-.-.-.-.-.-.-.-.-.-.-.-,-,-,~.~X~,-----------------------
,-X-H-A-E-X7.-X-A-.-.-A-E-X-.-X-A-.-.-.-.-W-.6.-.-+V+VA-L-.-.-E-.-X-,-.~.~.~.~.~.~.~,~,~.-.-.-+-+-W-,-.-.-.-.-.-.-.-.-.-.-.-.-.-.-.-.-.-.-.-.-.-.-.-.-.-.-.-.-.-.-,-,-.~.~.~.~X-----------------------
,-X-.-.-.-X7X-X-.-.-.-.-.-X-X-X-.-.-.-.-.-.-.6.-.-+V+V.-L-.-.-.-.-X-,-.~.~.~.~.~.~.~,~,~.-.-.-X-X-X-X-.-.-.-.-.-.-.-.-E-.-.-.-.-.-.-.-E-.-.-.-.-.-.-.-.-.-.-.-.-,-,-.~.~.~,~,~X-,-,-------------------
,-X-.-.-.-.-A-.-.-.-.-.-.-.-A-.-.-.-.-.-.-.-.6.-.-+V+VX-X-X-.-.-E-X-X-.~.~.~.~.~.~.~,~,~.-E-.-X-X-X-X-.-.-.-.-.-.-.-.-.-.-.-.-.-.-.-.-.-.-.-.-.-.-.-.-.-.-.-.-,-,~.~.~.~,~,~,~X-X-X-,-----------------
,-X-.-.-.-.-.-.-:-.-.-.-.-.-.-.-.-.-.-.-.-.-.6.-.-+V+VX-,-X-.-.-.-X-X~.~E~.~.~.~.~.~,~,~.-.-.-.-.-<-,-,-.-.-.-.-.-E-.-.-.-.-.-.-.-.-.-.-.-E-.-.-.-.-.-.-.-.-,-,~.~.~.~.~,~,-.-.-E-.-X-,---------------
.-X-.-.-.-.-.-.-.-.-.-.-.-.-.-.-.-.-.-.-X-X-X6X-X-XVXVX-,-X-.-.-.-X-X-.~.~.~.~.~.~.~,~,~.-.-.-.-.-.-.-,-.-.-.-.-.-.-.-.-.-.-.-.-.-.-.-.-.-.-.-.-.-.-.-.-,-,-,~.~.~.~.~.~,~,-.-.-.-.-.-X---------------
X-A-.-.-.-.-.-.-.-.-.-.-.-.-.-.-.-.-.-.-X---------------,-X-.-.-.-X-,-.~.~.~.~.~.~.~,~,~.-.-E-.-.-E-.-,-.-.-.-.-E-.-.-.-.-.-.-E-.-.-.-.-.-.-E-.-.-.-.-,-,-.~.~.~.~.~.~.~,~,-.-E-.-.-E-X---------------
X-.-.-.-.-.-.-.-X9X-.-X-X-.-.-.-.-.-.-.-X---------------,-X-.-.-.-X-,-.~.~E~.~.~E~.~,~,~H-,-,-,-.-.-,-,-.-.-.-.-.-.-.-.-.-.-.-.-.-.-.-.-.-.-.-.-.-.-,-,~.~.~.~.~.~.~.~.~,~,-,-.-E-,-,-X---------------
X-.-.-.-.-.-.-A-X9.-E-X-X-A-.-.-.-.-.-.-X---------------,-X-.-.-.-X-,-.~.~.~.~.~.~.~,~X-.-.-.-X-X-X-,-.-.-.-.-.-.-.-.-.-.-.-H-t4.-.-.-.-.-.-.-.-.-,-,~.~.~.~.~.~.~.~.~.~.~,~,-,-,-X-X-----------------
X-X-X-.-.-.-X-X-X9.-.-X-X-X-X-.-.-.-X-X-X---------------,-X-.-.-.-X-X-.~.~.~.~.~.~.~,~X-,-,-,-X-,-X-X-.-.-.-.-.-.-.-.-.-.-,-,-,-,-.-.-.-.-.-.-,-,-,~.~.~.~.~.~.~.~.~.~.~.~.~,~,-,-X-------------------
,-,-X-.-.-.-X-X-.-.-E-.-.-X-X-.-.-.-X-,-,---------------,-X-.-.-.-X-X~.~E~.~.~.~.~.~.~.~.~.~.~X~--,-X-.-.-.-.-.-.-.-.-,-,-,~.~.~,~,~,-,-,-.-H-,-.~.~.~.~.~.~.~.~.~.~.~.~.~.~.~.~.~X~,-----------------
X-X-X-.-.-.-X-X-X-.-.-X-X-X-X-.-.-.-X8X8X8--------------,-X-.-.-.-X-X~.~.~.~.~.~.~.~.~.~.~.~.~X~--,-X-.-.-.-.-.-<-,-,-,~.~.~.~.~.~.~.~.~,~,~,-.~.~.~.~.~.~.~.~.~.~.~.~.~.~.~.~.~.~.~X-----------------
X-.-.-.-.-.-.-.-X-.-.-X-X-.-.-.-.-.-.-.-X---------------,-X-.-.-.-X-X~.~.~.~.~.~.~.~.~.~.~.~.~X~--,-X-.-.-.-<-.-,-,-.~.~.~.~.~.~.~.~.~.~.~.~.~.~.~.~.~.~.~.~.~.~.~.~.~.~.~.~.~.~.~.~X-----------------
X-.-E-.-E-.-E-.-X-.-.-X-X-.-E-.-E-.-E-.-X---------------,-X-.-.-.-X-X~,~,~.~.~.~.~.~.~.~.~.~.~X~----,-X-A-H-,-,-,~.~.~.~.~.~.~.~.~.~.~.~.~.~.~.~.~.~.~.~.~.~.~.~.~.~.~.~.~.~.~.~.~.~X~----------------
X-X-X-X-X-X-X-X-X-X-X-X-X-X-X-X-X-X-X-X-X---------------,-X-.-.-.-X-X-,~,~,~,~.~.~.~.~.~.~.~.~X~----,-X-,-,-,~.~.~.~.~.~.~.~.~.~.~.~.~.~.~.~.~.~.~.~.~.~.~.~.~.~.~.~.~.~.~.~.~.~.~.~,~X---------------
--------------------------------------------------------,-X-.-.-.-X-X-,-,-,-,-,~.~.~.~.~.~.~.~X~------,-X-.~.~.~.~.~.~.~.~.~.~.~.~.~.~.~.~.~.~.~.~.~.~.~.~.~.~.~.~.~.~.~.~.~.~.~.~.~.~X---------------
--------------------------------------------------------,-X-.-.-.-.-.-.-.-,-,-,-,~.~.~.~.~.~.~X~--------,-X~.~.~.~.~.~.~.~.~.~.~.~.~.~.~.~.~.~.~.~.~.~.~.~.~.~.~.~.~.~.~.~.~.~.~.~.~.~X~--------------
--------------------------------------------------------,-X-.-.-.-.-.-E-.-.-,-,-,-.~.~.~.~.~.~X~--------,-X-.~.~.~.~.~.~.~.~.~.~.~.~.~.~.~.~.~.~.~.~.~.~.~.~.~.~.~.~.~.~.~.~.~.~.~.~.~X~,-------------
--------------------------------------------------------,-X-.-.-.-.-.-.-.-E-.-,-,-.~.~.~.~.~.~X~----------,-X~.~.~.~.~.~.~.~.~.~.~.~.~.~.~.~.~.~.~.~.~.~.~.~.~.~.~.~.~.~.~.~.~.~.~.~.~.~X-------------
--------------------------------------------------------,-X-.-.-.-.-.-.-.-.-.-,-,-,~.~.~.~.~.~X~----------,-X-.~.~.~.~.~.~.~.~.~.~.~.~.~.~.~.~.~.~.~.~.~.~.~.~.~.~.~.~.~.~.~.~.~.~.~.~.~X~------------
--------------------------------------------------------,-X-.-.-.-.-.-.-E-.-E-.-,-,~,~,~,~,~.~X~------------,-X~.~.~.~.~.~.~.~.~.~.~.~.~.~.~.~.~.~.~.~.~.~.~.~.~.~.~.~.~.~.~.~.~.~.~.~.~X~,-----------
--------------------------------------------------------,-X-.-.-E-.-.-.-.-.-.-.-X-X-X-.-.-X-X~X~--------------,-X~.~.~.~.~.~.~.~.~.~.~.~.~.~.~.~.~.~.~.~.~.~.~.~.~.~.~.~.~.~.~.~.~.~.~.~.~X-----------
--------------------------------------------------------,-X-.-.-.-.-.-.-.-.-E-.-X-X-X-.-.-X-------------------,-X-.~.~.~.~.~.~.~.~.~.~.~.~.~.~.~.~.~.~.~.~.~.~.~.~.~.~.~.~.~.~.~.~.~.~.~.~X~,---------
--------------------------------------------------------,-X-H-.-.-.-.-E-.-.-.-.-.-.-.-E-.-X---------------------,-X~.~.~.~.~.~.~.~.~.~.~.~.~.~.~.~.~.~.~.~.~.~.~.~.~.~.~.~.~.~.~.~.~.~.~.~.~X---------
--------------------------------------------------------,-X-X-X-.-.-.-.-.-.-.-.-.-.-.-.-.-X---------------------,-X-.~.~.~.~.~.~.~.~.~.~.~.~.~.~.~.~.~.~.~.~.~.~.~.~.~.~.~.~.~.~.~.~.~.~.~.~X~,-------
------------------------------------------------------------,-X-.-A-.-.-.-.-.-.-X-X-X-X-X-X-----------------------,-X~.~.~.~.~.~.~.~.~.~.~.~.~.~.~.~.~.~.~.~.~.~.~.~.~.~.~.~.~.~.~.~.~.~.~.~.~X-------
------------------------------------------------------------,-X-X-X-X-X-X-X-X-X-X---------------------------------,-X-.~.~.~.~.~.~.~.~.~.~.~.~.~.~.~.~.~.~.~.~.~.~.~.~.~.~.~.~.~.~.~E~.~.~.~.~X~------
------------------------------------------------------------------------------------------------------------------,-X-.~.~.~.~.~.~.~.~.~.~.~.~.~.~.~.~.~.~.~.~.~.~.~.~.~.~.~.~.~.~.~.~.~.~.~.~X~,-----
--------------------------------------------------------------------------------------------------------------------,-X~.~.~.~.~.~.~.~.~.~.~.~.~.~.~.~.~.~.~.~.~.~.~.~.~.~.~.~.~.~.~.~.~.~.~.~.~X-----
--------------------------------------------------------------------------------------------------------------------,-X~.~.~.~.~.~.~.~.~.~.~.~.~.~.~.~.~.~.~.~.~.~.~.~.~.~.~.~.~.~.~.~.~.~.~.~.~X~,---
--------------------------------------------------------------------------------------------------------------------,-X~.~.~.~.~.~.~.~.~.~.~.~.~.~.~.~.~.~.~.~.~.~.~.~.~.~.~.~.~.~.~.~.~.~.~.~.~.~X---
--------------------------------------------------------------------------------------------------------------------,-X-.~.~.~.~.~.~.~.~.~.~.~.~.~.~.~.~.~.~.~.~.~.~.~.~.~.~.~.~.~.~.~.~.~.~.~.~.~X~,-
--------------------------------------------------------------------------------------------------------------------,-X-.~.~.~.~.~.~.~.~.~.~.~.~.~.~.~.~.~.~.~.~.~.~.~.~.~.~.~.~.~.~.~.~.~E~.~.~.~.~X-
----------------------------------------------------------------------------------------------------------------------,-X~.~.~.~.~.~.~.~.~.~.~.~.~.~.~.~.~.~.~.~.~.~.~.~.~.~.~.~.~.~.~.~.~.~.~.~.~.~X~
----------------------------------------------------------------------------------------------------------------------,-X~.~.~.~.~.~.~.~.~.~.~.~.~.~.~.~.~.~.~,~,~,~,~.~.~.~.~.~,~,~.~.~.~.~.~.~.~X~,-
----------------------------------------------------------------------------------------------------------------------,-X~.~.~.~.~.~.~.~.~.~.~.~.~.~.~.~.~.~.~,~.~.~,~,~.~.~.~,~,~,~,~.~.~.~.~.~.~X~--
------------------------------------------------------------------------------------------------------------------------,-X~.~.~.~.~.~.~.~.~.~.~.~.~.~.~.~.~,~,~.~.~.~,~,~,~,~,~.~.~,~.~.~.~.~.~X~,---
------------------------------------------------------------------------------------------------------------------------,-X-.~.~.~.~.~.~.~.~.~.~.~.~.~.~.~.~,~.~.~.~.~.~.~,~,~.~.~.~,~.~.~.~.~.~X~----
--------------------------------------------------------------------------------------------------------------------------,-X~.~.~.~.~.~.~.~.~.~.~.~.~.~.~,~,~.~.~.~.~.~.~.~.~.~.~.~,~.~.~.~.~X~,-----
--------------------------------------------------------------------------------------------------------------------------,-X-.~.~.~.~.~.~.~.~.~.~.~.~.~.~,~.~.~.~.~.~.~.~.~.~.~.~.~,~.~.~.~.~X~------
----------------------------------------------------------------------------------------------------------------------------,-X~.~.~.~.~.~.~.~.~.~.~.~.~,~,~.~.~.~.~.~.~.~.~.~.~.~.~,~.~.~.~X~,-------
------------------------------------------------------------------------------------------------------------------------------,-X~A~.~A~.~.~.~.~.~.~.~.~,~.~.~.~.~.~.~.~.~.~.~.~.~.~,~,~.~.~X~--------
------------------------------------------------------------------------------------------------------------------------------,-X-.~.~.~A~.~.~.~.~.~.~,~,~.~.~.~.~.~.~.~.~.~.~.~.~.~.~,~.~X~,---------
--------------------------------------------------------------------------------------------------------------------------------,-X~A~.~,~,~X~X~.~.~.~,~.~.~.~.~.~.~.~.~.~.~.~.~.~.~.~,~.~X~----------
--------------------------------------------------------------------------------------------------------------------------------,-X-,~,~X~X-,-,-X~X~,~,~.~.~.~.~.~.~.~.~.~.~.~.~.~.~.~,~X~,-----------
----------------------------------------------------------------------------------------------------------------------------------,-X~X---------,-,-X~.~.~.~.~.~.~.~.~.~.~.~.~.~.~.~.~,~X~------------
--------------------------------------------------------------------------------------------------------------------------------------------------,-X-.~.~.~.~.~.~.~.~.~.~.~.~.~.~.~.~,~X-------------
----------------------------------------------------------------------------------------------------------------------------------------------------X-.~.~.~.~.~.~.~.~.~.~.~.~.~.~.~.~X~--------------
----------------------------------------------------------------------------------------------------------------------------------------------------,-X~.~.~.~.~.~.~.~.~.~.~.~.~.~.~.~X~--------------
----------------------------------------------------------------------------------------------------------------------------------------------------,-X~.~.~.~.~.~.~.~.~.~.~.~.~.~.~,~X---------------
----------------------------------------------------------------------------------------------------------------------------------------------------,-X-.~.~.~.~.~.~.~.~.~.~.~.~.~.~X~----------------
------------------------------------------------------------------------------------------------------------------------------------------------------X-.~.~.~.~.~.~.~.~.~.~.~.~.~,~X~----------------
------------------------------------------------------------------------------------------------------------------------------------------------------,-X~.~.~.~.~.~.~.~.~.~.~.~,~X~------------------
------------------------------------------------------------------------------------------------------------------------------------------------------,-X~.~.~.~.~.~.~.~.~.~.~.~X~--------------------
------------------------------------------------------------------------------------------------------------------------------------------------------,-X~.~.~.~.~.~.~.~.~.~.~.~X---------------------
------------------------------------------------------------------------------------------------------------------------------------------------------,-X~.~.~.~.~.~.~.~.~.~.~.~X---------------------
----------------------------------------------------------------------------------------------------------------------------------------------------,-,-X~.~.~.~.~.~.~.~.~.~.~X~,---------------------
----------------------------------------------------------------------------------------------------------------------------------------------------,-X-.~.~.~.~.~.~.~.~.~.~.~X~----------------------
----------------------------------------------------------------------------------------------------------------------------------------------------,-X-.~.~.~.~.~.~.~.~.~.~.~X~----------------------
----------------------------------------------------------------------------------------------------------------------------------------------------,-X-.~.~.~.~.~.~.~.~.~.~.~X~----------------------
----------------------------------------------------------------------------------------------------------------------------------------------------,-X~.~.~.~.~.~.~.~.~.~.~.~X-----------------------
----------------------------------------------------------------------------------------------------------------------------------------------------,-X~.~.~.~.~.~.~.~.~.~.~.~X-----------------------
----------------------------------------------------------------------------------------------------------------------------------------------------,-X~.~.~.~.~.~.~.~.~.~.~X~,-----------------------
--------------------------------------------------------------------------------------------------------------------------------------------------,-,-X~.~.~.~.~.~.~.~.~.~.~X~------------------------
--------------------------------------------------------------------------------------------------------------------------------------------------,-X-.~.~.~.~.~.~.~.~.~.~.~X~------------------------
--------------------------------------------------------------------------------------------------------------------------------------------------,-X-.~.~.~.~.~.~.~.~.~.~,~X~------------------------
--------------------------------------------------------------------------------------------------------------------------------------------------,-X-,~,~.~.~.~.~.~.~.~,~X~--------------------------
--------------------------------------------------------------------------------------------------------------------------------------------------,-X-.~,~,~,~,~,~.~.~,~X~----------------------------
----------------------------------------------------------------------------------------------------------------------------------------------------,-X-<-.-A-.~,~,~,~X~------------------------------
------------------------------------------------------------------------------------------------------------------------------------------------------,-X-.-H-<-,-,-X---------------------------------
--------------------------------------------------------------------------------------------------------------------------------------------------------,-X-W-,-X-X-----------------------------------
----------------------------------------------------------------------------------------------------------------------------------------------------------,-X-X---------------------------------------
