--------------------------------------------------------------------------------------------------------------,-X-X-X-X-X-X-X-X-X-X-X-X-X-X-X-X-X-X-X-------------------------
--------------------------------------------------------------------------------------------------------------,-X-.-.-.-.-.-.-.-.-.-.-.-.-.-.-.-.-.-X-------------------------
--------------------------------------------------------------------------------------------------------------,-X-.-.-.-.-.-.-.-.-.-.-.-.-.-.-.-.-.-X-------------------------
--------------------------------------------------------------------------------------------------------------,-X-.-.-t6t6t6t6t6t6t6t6t6t6t6t6t6.-.-X-------------------------
--------------------------------------------------------------------------------------------------------------,-X-.-.-t6E-.-E-.-E-.-E-.-E-.-E-t6.-.-X-------------------------
--------------------------------------------------------------------------------------------------------------,-X-.-.-t6.-.-.-.-.-.-.-.-.-.-,-t6.-.-X-------------------------
--------------------------------------------------------------------------------------------------------------,-X-.-.-t6E-.-E-.-E-.-E-.-E-.-E-t6.-.-X-------------------------
--------------------------------------------------------------------------------------------------------------,-X-.-.-t6.-.-.-.-.-.-.-.-.-.-,-t6.-.-X-------------------------
------------------------------------------------------------------------------------,-,-,-,-,-,-,-,-,-,-,-,-,-,-X-.-.-t6E-.-.-E-.-.-E-.-.-E-,-t6.-.-X-------------------------
------------------------------------------------------------------------------------,-X-X-X-X-X-X-X-X-X-X-,->->-X-X-X-t6.-.-.-.-.-.-.-.-.-.-,-t6.-.-X-------------------------
------------------------------------------------------------------------------------,-X-.-.-.-.-.-.-.-.-X-X-.-A-.-X-,-X6.-.-.-.-.-.-.-.-.-.-,-t6.-.-X-------------------------
------------------------------------------------------------------------------------,-X-.-.-.-.-.-.-.-.-X-X-.-.-.-X-,-X-.-.-E-.-.-.-.-E-.-.-,-t6.-.-X-------------------------
------------------------------------,-,-,-,-,-,-------------------------------------,-X-,-,-,-,-.-.-.-.-X-X-.-.-,-X-,-X-.-.-.-.-.-.-.-.-.-.-,-t6.-.-X-,-,-,-,-,-,-,-,-,-,-,-,-
------------------------------------,-X~X~X~X~X~------------------------------------,-X-.-.-.-X-X-.-.-.-X-,-X-L-X-,-,-X-.-.-.-.-.-.-.-.-.-.-,-t6.-.-X-X-X-X-X-X-X-X-X-X-X-X-X-
------------------------------------,-X~.~.~.~X~------------------------------------,-X-.-.-.-X-X-.-.-.-X-X-X-.-X-X-X-X-.-.-.-.-E-.-.-.-.-.-,-t6.-.-X-X-.-.-.-.-.-.-.-.-.-.-X-
----------------------------------,-,-X~.~.~.~X~,-----------------------------------,-X-,-,-,-X-X-.-.-.-.-.-.-.-.-A-X-X-.-.-.-.-.-.-.-.-E-.-,-t6.-.-X-X-.-t9t9t9t9t9t9t9t9.-X-
----------------------------------,-X~X~.~.~.~X~X~----------------------------------,-X-.-.-.-X-X-.-.-.-.-.-.-.-.-A-X-X-.-E-.-.-.-.-.-.-.-.-,-t6.-.-X-X-.-t9.-.-.-.-.-,-t9.-X-
----------------------------------,-X~.~.~.~.~.~X~----------------------------------,-X-,-,-,-X-X-.-.-E-.-.-.-.-.-A-X-X-.-.-.-,-,-,-,-,-,-,-,-t6.-.-X-X-.-t9.-E-.-.-.-,-t9.-X-
----------------------------------,-X~.~.~E~.~.~X~----------------------------------,-X-.-.-.-X-X-.-.-.-.-.-.-.-.-.-X-X-X-X-X-X-X6t6t6t6t6t6t6t6.-.-X-X-.-t9.-.-.-.-E-,-t9.-X-
--------------,-,-,-,-,-,-,-,-,-,-,-X~.~.~.~.~.~X~----------------------------------,-X-,-,-,-X-X-.-.-.-.-t9.-.-.-.-X-,-,-X---,-X-.-.-.-.-.-.-.-.-.-X-X-.-t9.-.-E-.-.-,-t9.-X-
--------------,-X-X-X-X-X-X-X-X-X-X-X~.~.~.~.~.~X~----------------------------------,-X-.-.-.-X-X-.-.-.-.-.-.-.-.-.-X-X-X-X-,-,-X-.-.-.-.-.-.-.-.-.-X-X-X-X9.-.-.-.-.-E-t9.-X-
--------------,-X-.-E-.-.-.-.-.-.-,-.~.~.~E~.~.~X~----------------------------------,-X-,-,-,-X-X-,-.-.-.-.-.-E-.-,-X-,-,-X-X-X-X-X-X-X-X-X-X-X-X-X-X-X-X-X-.-.-.-E-.-,-t9.-X-
--------------,-X-.-.-.-.-E-.-.-E-,-.~.~.~.~.~.~X~----------------------------------,-X-.-.-.-X-X-,-.-.-.-.-.-.-.-,-X-X-X-X8X-X-X-X-X-X-X-X-X-X8X-X-X-X-X-X-.-E-.-.-.-,-t9.-X-
--------------,-X-.-.-E-.-.-.-.-.-,-.~.~.~.~.~.~X~----------------------------------,-X-.-.-.-X-X-,-.-.-.-.-.-.-.-,-X-.-.-t8.-.-.-.-.-.-.-.-,-t8.-.-X-X-X-X9.-.-.-.-E-,-t9.-X-
--------------,-X-.-.-.-X-X-X-X-X-X-X~,~,~,~,~,~X~----------------------------------,-X-.-.-.-X-X-H-.-.-.-.-.-.-.-,-X-.-.-t8E-.-E-.-E-.-E-.-E-t8.-.-X-X-.-t9.-.-.-.-.-,-t9.-X-
--------------,-X-.-.-.-X-,-,-,-,-,-X~,~,~,~,~,~X~,-,-,-,-,-,-,-,-,-,-,-,-,-,-,-,-,-,-X-X-.-X-X-X-A-.-.-.-.-.-.-.-,-X-.-.-t8.-.-.-.-.-.-.-.-,-t8.-.-X-X-.-t9.-.-E-.-.-E-t9.-X-
--------------,-X-,-,-,-X-X-X-X-X-X-X~.~.~.~.~,~X~X/X/X-X-X-X-X-X-X-X-X-X-X-X-X-X-X-X-,-X-L-X-,-X-X-X-X-X-X-X-,-,-,-X-.-.-t8E-.-E-.-E-.-E-.-E-t8.-.-X-X-.-t9.-.-.-.-.-,-t9.-X-
--------------,-X-,-,-,-,-.-.-.-.-.-,-.~.~.~.~,~./././.-.-.-.-.-.-.-.-.-.-.-.-.-.-.-X-X-X-,-X-X-X-X-X-X-X-X-X-.-.-,-X-.-.-t8.-.-.-.-.-.-.-.-,-t8.-.-X-X-.-t9,-E-,-E-,-,-t9.-X-
--------------,-X-,-,-,-,-.-.-.-.-.-,-.~.~.~.~,~./././.-.-.-.-.-.-.-E-.-.-.-.-.-.-.-.-.-.-.-.-A-.-,-.-,-.-X-X-.-.-,-X-.-.-t8.-.-E-.-E-.-E-.-,-t8.-.-X-X-.-t9t9t9t9t9t9t9t9.-X-
--------------,-X-,-,-,-,-.-.-.-.-.-,-.~.~.~.~,~./././.-.-.-.-.-.-.-.-.-.-.-.-.-.-.-.-.-.-.-.-,-.-,-.-,-.-X-X-.-.-,-X-.-.-t8.-.-.-.-.-.-.-.-,-t8.-.-X-X-.-.-.-.-.-.-.-.-.-.-X-
,-,-,-,-,-,-,-,-X-,-,-,-,-.-.-.-.-.-,-.~.~.~.~,~,/././<-.-.-E-.-.-.-.-.-.-.-.-.-.-.-.-.-.-.-.-,-.-,-.-,-.-X-X-.-.-,-X-.-.-t8.-E-.-.-E-.-.-E-,-t8.-.-X-X-.-.-.-.-.-.-.-.-.-.-X-
X-X-X-X-X-X-X-,-X-,-,-,-,-.-.-.-.-.-,-.~.~.~.~.~,~H-.-.-.-.-,-,-,-,-,-,-.-.-.-.-.-.-.-.-.-.-.-,-.-,-.-E-.-X-X-.-.-,-X-.-.-t8.-.-.-.-.-.-.-.-,-t8.-.-X-X-X-X-X-X-X-X-X-X-X-X-X-
X-.-.-.-.-,-X-X-X-,-,-,-,-.-.-.-.-.-,-.~.~.~.~.~X~X-X-X-X-X-X-X-X-X-X-X-X-X-X-.-.-.-.-.-.-.-.-,-.-,-.-,-.-X-X-.-.-,-X-.-.-t8.-.-.-.-.-.-.-.-,-t8.-.-X-------------------------
X-.-.-.-.-,-.-.-,-.-.-.-.-.-.-.-.-.-,-.~.~.~.~.~X~----------,-X-A-A-W-X---,-X-.-.-.-.-.-.-.-.-,-.-,-.-,-.-.-.-.-.-,-X-.-.-t8.-.-.-.-.-.-.-.-,-t8.-.-X-------------------------
X-.-.-.-.-,-.-.-,-.-.-.-.-.-.-.-.-.-,-.~.~.~.~,~X~,-,-,-,-,-,-X-.-.-.-X-,-,-X-.-.-.-.-.-.-.-.-,-.-,-.-,-.-.-.-.-.-,-X-.-.-t8.-.-E-.-.-.-E-.-,-t8.-.-X-------------------------
X-.-.-.-.-,-.-.-,-.-.-.-.-.-.-.-.-.-,-.~.~.~.~,~X-X-X-X-X-X-X-X3.3.3.3X3X-,-X-.-.-.-.-.-.-.-.-,-.-,-.-,-.-.-.-.-.-,-X-.-.-t8.-.-.-.-.-.-.-.-,-t8.-.-X-------------------------
X-.-.-E-.-,-.-.-,-.-.-.-.-.-.-.-.-.-,-.~.~.~.~,~X-.-.-.-.-.-.-.-.-.-.-.-X-,-X-.-.-.-.-.-.-.-.-,-.-,-.-,-.-E-.-.-.-,-X-.-.-t8E-.-.-.-E-.-.-E-,-t8.-.-X-------------------------
X-.-.-.-.-,-.-.-,-.-.-.-.-.-.-.-.-.-,-.~.~.~.~,~X-X-.-.-E-.-.-.-.-.-.-.-X-X-X-.-.-.-.-.-.-.-.-,-,-,-.-E-.-.-.-.-.-,-X-.-.-t8,-,-,-,-,-,-,-,-,-t8.-.-X-------------------------
X-.-.-.-.-,-.-.-,-.-.-.-.-.-.-.-.-.-,-.~.~.~.~.~X~X-.-X-X-X-X-X-X-X-.-.-.-+-,-.-.-.-.-.-.-.-.-,-.-.-.-,-.-.-.-.-.-,-X-.-.-t8t8t8t8t8t8t8t8t8t8t8.-.-X-------------------------
X-.-.-.-.-,-.-.-,-.-.-.-.-.-.-.-.-.-,-.~.~.~.~.~X~X-.-X-X-X-X-X-X-X-.-.-.-+-,-.-.-.-.-.-.-.-.-,-,-,-.-,-.-.-.-.-.-,-X-.-.-.-.-.-.-.-.-.-.-.-.-.-.-.-X-------------------------
X-.-.-.-.-,-.-.-,-.-.-.-.-.-.-.-.-.-,-.~.~.~.~.~X~X-.-.-.-.-E-,-E-,-,-,-,-+-,-.-.-.-.-.-.-.-.-,-.-,-.-,-.-.-E-.-.-,-X-.-.-.-.-.-.-.-.-.-.-.-.-.-.-.-X-------------------------
X-.-.-.-.-,-.-.-,-.-.-.-.-.-.-E-.-.-,-.~.~.~.~.~X~X-.-.-.-.-.-,-.-.-.-.-X-X-X-.-.-.-.-.-.-.-.-,-.-,-.-,-.-.-.-.-.-,-X-X-X-X-X-X-X-X-X-X-X-X-X-X-X-X-X-------------------------
X-.-.-.-.-,-.-.-,-.-.-.-.-.-.-.-.-.-,-.~.~.~.~,~X~X-E-.-.-.-.-,-:-.-.-.-X-,-X-.-.-.-.-.-.-.-.-,-.-,-.-,-.-.-.-.-.-.-X---------------------------------------------------------
X-.-.-.-.-,-.-.-,-.-.-.-.-.-.-.-.-.-,-.~.~.~.~,~X-X-X-X-X-X-.-,-.-,-,-,-X-,-X-.-.-.-.-.-.-.-.-,-.-,-.-E-.-.-.-.-.-.-X---------------------------------------------------------
X-.-.-.-.-,-.-.-,-.-.-.-.-.-.-.-.-.-,-.~.~.~.~,~X-K-.-.-.-X-.-,-.-,-.-E-X-,-X-<-E-.-.-.-.-.-.-,-.-,-.-,-.-.-.-E-.-.-X---------------------------------------------------------
X-.-.-.-.-,-.-.-,-.-.-E-.-.-.-.-.-.-,-.~.~.~.~,~X-<-.-.-:-+-.-,-.-,-.-.-X-,-X-X-X-X-.-.-.-.-.-,-.-,-.-,-.-.-.-.-.-.-X---------------------------------------------------------
X-.-.-.-.-,-.-.-,-.-.-.-.-.-.-.-.-.-,-.~.~.~.~,~X-,-,-,-,-X-.-,-,-,-.-.-X-.-X-.-E-X-X-.-.-.-.-,-.-,-.-,-,-,-,-,-,-,-X---------------------------------------------------------
X-.-.-.-.-,-.-.-,-.-.-.-.-.-.-.-.-.-,-.~.~.~.~,~X-X-,-.-X-X-X-X-X-X-X-X-X-X-.-.-.-.-X-X-.-.-.-,-.-,-.-.-.-.-E-.-.-.-X---------------------------------------------------------
X-.-.-.-.-,-X-X-X-X-X-X-X-X-X-X-X-X-X-.~.~.~.~.~X~X-,-,-X-X-X-X-X-X-X-X-X-X-E-E-.-E-X-X-.-.-.-,-.-,-,-,-,-,-,-,-,-,-X---------------------------------------------------------
X-.-.-.-.-.-X---------------------,-X-.~.~.~.~.~,~.-.-.-.-.-.-.-.-.-.-W-X-X-E-.-E-,-X-X-.-.-.-,-K-.-.-.-.-.-.-.-.-.-X---------------------------------------------------------
X-.-.-.-.-.-X---------------------,-X-.~.~.~.~.~,~,-.-.-,-,-<-,-<-,-.-.-X-,-X-.-X-X-,-X-.-.-.-,-,-,-,-,-,-,-,-,-,-,-X---------------------------------------------------------
X-.-.-.-.-.-X---------------------,-X-,~.~.~.~.~.~,-.-.-,-...-.-.-,-.-.-.-X-X-L-X-,-X-.-.-.-.-.-.-.-.-.-.-.-.-.-.-A-X---------------------------------------------------------
X-.-.-.-.-.-X---------------------,-X-,~.~.~.~.~.~,-.-.-,-..<-<-<-,-.-.-.-,-X-,-X-X-.-.-.-.-.-.-.-.-.-.-.-.-.-.-H-.-X---------------------------------------------------------
X-.-.-.-.-.-X---------------------,-X-,~.~.~.~.~.~,~.-.-,-,.:-H-W-,-.-.-.-.-.-.-.-.-.-.-.-.-.-.-.-.-.-.-.-.-.-.-.-.-X---------------------------------------------------------
X-.-.-.-.-.-X---------------------,-X-,-.~.~.~.~.~,~.-.-,-,.,.,.,.,..-.-.-.-.-.-.-.-.-.-.-.-.-.-.-.-.-.-.-.-.-.-.-.-X---------------------------------------------------------
X-.-.-.-.-.-X---------------------,-X-,-.~.~.~.~.~,~,-.-.-:-.-.-.-.-.-.-.-.-.-.-.-.-.-.-.-.-.-.-.-.-.-.-.-.-.-.-.-.-X---------------------------------------------------------
X-.-.-.-.-.-X---------------------,-X-,-.~.~.~.~.~.~,-.-.-.-.-.-.-.-.-E-.-.-.-.-.-.-.-.-.-.-.-.-.-.-.-.-.-.-.0.0.0.0X0--------------------------------------------------------
X-.-.-.-.-.-X---------------------,-X-,-,~.~.~.~.~.~,-.-.-.-.-.-.-.-.-.-.-.-.-.-.-.-.-.-.-.-.-.-.-.-,-,-,-,-.0.0.0.0X0--------------------------------------------------------
X-.-.-.-.-.-X---------------------,-X-.-,~.~.~.~.~.~,~,-.-.-.-.-.-.-.-.-.-.-.-.-.-.-.-t6.-.-.-,-,-,-,-.-.~,~,0,0,0,0X0--------------------------------------------------------
X-.-.-.-.-.-X---------------------,-X-.-,~.~.~.~.~.~.~,~,-.-.-.-.-.-.-E-.-.-.-.-.-.-.-.-,-,-,-,-.-.~.~.~.~.~.~.~.~.~X~--------------------------------------------------------
X-.-.-.-.-.-X---------------------,-X-.-,-.~.~.~.~.~.~.~,~,-,-.-.-.-.-.-.-.-.-.-.-.-,-,-,-.-.~.~.~.~.~.~.~.~.~.~.~.~X~--------------------------------------------------------
X-.-.-.-.-.-X---------------------,-X-.-,-,~.~.~.~.~.~.~.~.~,~,-,-,-,-,-,-,-,-,-,-,-,-.-.~.~.~.~.~.~.~.~.~.~.~.~.~.~X~--------------------------------------------------------
X-.-.-.-.-.-X---------------------,-X-.-.-,-.~.~.~.~.~.~.~.~.~.~.~.~.~.~.~.~.~.~.~.~.~.~.~.~.~.~.~.~.~.~.~.~.~.~.~.~X~--------------------------------------------------------
X-.-.-.-.-.-X---------------------,-X-.-.-,-,~.~.~.~.~.~.~.~.~.~.~.~.~.~.~.~.~.~.~.~.~.~.~.~.~.~.~.~.~,~,~,~,~,~,~,~X~--------------------------------------------------------
X-.-.-.-.-.-X---------------------,-X-E-.-.-,-,~.~.~.~.~.~.~.~.~.~.~.~.~.~.~.~.~.~.~.~.~.~.~.~.~.~,~,~,~.~.-.-.-.-.-X---------------------------------------------------------
X-.-.-.-.-.-X---------------------,-X-.-.-.-.-,-,~,~.~.~.~.~.~.~.~.~.~.~.~.~.~.~.~.~.~.~.~.~,~,~,~,~.~.-.-.-.-.-,-,-X-,-,-,-,-,-,-,-,-,-,-,-,-,-------------------------------
X-.-.-.-.-.-X---------------------,-X-.-.-.-.-.-.-,~,~,~,~.~.~.~.~.~.~.~.~.~.~.~.~.~.~,~,~,~,~.~.-.-.-.-.-.-.-.-,-,-X-X-X-X-X-X-X-X-X-X-X-X-X-X-------------------------------
X-.-.-.-.-.-X---------------------,-X-.-.-.-.-.-.-.-.-.-,~,~,~.~.~.~.~.~.~.~.~.~.~,~,~,~.~.-.-.-.-.-.-.-.-.-.-.-,-,-.-.-.-.-.-:-,-,-.-.-.-.-.-X-------------------------------
X-.-.-E-.-.-X---------------------,-X-.-.-.-.-.-.-.-.-.-.-.-X-X~X~X~X~X~X~X~X~.~X~X~X-.-.-.-.-.-.-.-.-.-.-.-.-.-,-,-,-,-.-.-.-.-,-,-,-.-.-:-.-X-------------------------------
X-.-.-.-.-.-X---------------------,-X-.-.-.-.-.-E-.-.-.-.-.-X-,-,-,-,-,-,-,-X~A~X~,-X-.-.-.-.-.-.-.-.-.-.-.-.-.-,-,-.-,-,-,-.-.-,-,-,-,-,-.-.-X-------------------------------
X-.-.-.-.-.-X---------------------,-X-.-.-.-.-.-.-.-.-.-.-.-X-,-X-X-X-X-X-X-X-.-X-,-X-.-.-.-E-.-.-.-.-.-.-.-.-.-,-,-.-.-:-,-,-.-:-,-,-,-,-.-,-X-------------------------------
X-.-.-.-.-.-X---------------------,-X-.-.-.-.-.-.-.-.-.-.-.-X-,-X-A-.-.-.-.-.-.-X-,-X-.-.-.-.-.-.-.-.-.-E-.-.-.-,-,-.-,-,-.-,-,-.-,-,-.-,-,-,-X-------------------------------
X-.-.-.-.-.-X---------------------,-X-.-.-.-E-.-.-.-.-.-.-.-X-,-X-A-H-E-.-.-.-.-X-,-X-.-.-.-.-.-.-.-.-.-.-.-.-.-,-,-.-,-.-.-.-,-.-:-,-.-.-.-.-X-------------------------------
X-.-.-.-.-.-X---------------------,-X-.-.-.-.-.-.-.-.-.-.-.-X-,-X-X-X-.-.-.-X-X-X-,-X-.-.-.-.-.-.-.-.-.-.-.-.-.-,-,-.-,-,-.-E-,-,-.-,-,-,-,-.-X-------------------------------
X-.-.-.-.-.-X---------------------,-X-.-.-.-.-.-.-.-.-.-.-.-X-----,-X-.-H-H-X-----,-X-.-.-.-.-.-.-.-.-.-.-.-.-.-,-,-.-.-,-.-.-.-,-.-.-,-,-,-,-X-------------------------------
X-.-.-.-.-.-X---------------------,-X-.-.-.-.-.-.-.-E-.-.-.-X-,-,-,-X-X-X-X-X-,-,-,-X-.-.-.-E-.-.-.-.-.-.-.-.-.-,-,-.-,-,-.-.-.-:-,-.-.-.-.-,-X-------------------------------
X-.-.-.-.-.-X---------------------,-X-.-.-.-.-.-.-.-.-.-.-.-X-X-X-X-X-X-X-X-X-X-X-X-X-.-.-.-.-.-.-.-.-.-.-.-.-.-,-,-,-,-.-.-.-.-,-,-.-.-.-:-,-X-------------------------------
X-.-.-.-.-.-X---------------------,-X-.-.-.-.-.-.-.-.-.-.-.-.-.-.-.-.-.-.-.-.-.-.-.-.-.-.-.-.-.-.-.-.-.-.-.-.-.-,-,-,-.-.-.-.-,-,-.-K-.-.-.-.-X-------------------------------
X-.-.-.-.-.-X---------------------,-X-.-.-.-.-.-.-.-.-.-.-.-.-.-.-.-E-.-t8.-.-.-.-.-.-.-.-.-.-.-.-.-.-.-E-.-.-.-H-,-X-X-X-X-X-X-X-X-X-X-X-X-X-X-------------------------------
X-.-.-.-.-.-X-,-,-,-,-,-,-,-,-,-,-,-X-A-A-,-,-,-,-,-,-,-,-,-,-.-.-.-.-.-.-.-.-.-.-,-,-,-,-,-,-,-,-,-,-,-,-,-,-,-,-,-X---------------------------------------------------------
X-.-.-.-.-.-X-X-X-X-X-X-X-X-X-X-X-X-X-.-.-.-.-.-.-.-.-.-.-.-X-X-X-X-X-.-.-.-X-X-X-X-X-.-.-.-.-.-.-.-.-.-.-.-.-.-.-.-X---------------------------------------------------------
X-.-.-.-.-.-,-.-.-.-.-.-.-E-.-.-.-,-,-,-,-,-,-,-,-,-,-,-,-,-X-----,-X-.-.-.-X-----,-X-,-,-,-E-,-,-,-,-,-,-,-,-,-,-,-X---------------------------------------------------------
X-.-.-.-.-.-X-X-X-X-X-X-X-X-X-X-X-X-X-.-.-.-.-.-.-.-.-.-.-.-X-----,-X-.-.-.-X-----,-X-.-.-.-.-.-.-.-.-.-.-.-.-.-.-.-X---------------------------------------------------------
X-.-.-.-.-.-X---------------------,-X-.-.-.-.-.-.-.-.-.-.-.-X-,-,-,-X-.-.-.-X-,-,-,-X-.-.-.-.-.-.-.-.-.-.-.-.-.-.-.-X---------------------------------------------------------
X-.-.-.-.-.-X---------------------,-X-.-.-.-.-.-.-.-.-.-.-.-X-X-X-X-X-.-.-.-X-X-X-X-X-.-.-.-.-.-.-.-.-.-.-.-.-.-.-.-X---------------------------------------------------------
X-.-.-.-.-.-X---------------------,-X-.-.-E-.-.-.-.-.-.-.-.-.-.-.-E-.-.-.-.-E-.-.-.-.-.-.-.-.-.-.-.-.-.-.-.-.-.-.-.-X---------------------------------------------------------
X-.-.-.-.-.-X---------------------,-X-.-.-.-.-.-.-.-.-.-.-.-.-.-.-.-.-.-.-.-.-.-.-.-.-.-.-.-.-.-.-.-.-.-.-.-.-.-.-.-X---------------------------------------------------------
X-.-.-.-.-.-X---------------------,-X-.-.-.-.-.-.-.-.-.-.-.-.-.-.-.-.-.-.-.-.-.-.-.-.-.-.-.-.-.-.-.-.-.-.-.-.-.-.-.-X---------------------------------------------------------
X-.-.-.-.-.-X---------------------,-X-.-.-.-.-.-.-.-.-.-.-.-.-.-.-.-.-.-.-.-.-.-.-.-.-.-.-.-.-.-.-.-.-.-.-.-.-.-A-A-X---------------------------------------------------------
X-.-.-.-.-.-X---------------------,-X-.-.-.-.-.-.-.-.-.-.-.-.-.-.-.-.-X-X-X-X-X-X-X-X-X-X-X-X-X-X-X-X-X-X-X-X-X-A-H-X---------------------------------------------------------
X-.-.-.-.-.-X---------------------,-X-.-.-.-.-.-.-.-.-.-.-.-.-.-.-.-.-X-------------------------------------,-X-X-X-X---------------------------------------------------------
X-.-.-.-.-.-X---------------------,-X-.-.-.-.-.-.-.-.-.-.-.-.-.-.-.-.-X-------------------------------------------------------------------------------------------------------
X-.-.-.-.-.-X---------------------,-X-.-.-.-.-.-.-.-,-,-,-,-,-,-,-,-,-X-------------------------------------------------------------------------------------------------------
X-.-.-.-.-.-X---------------------,-X-.-.-.-.-.-.-.-,-.-.-.-.-.-.-.-.-X-------------------------------------------------------------------------------------------------------
X-.-.-.-.-.-X-----------------,-,-,-X-.-.-.-.-.-.-.-,-.-.-.-.-.-.-.-.-X-------------------------------------------------------------------------------------------------------
X-.-.-.-.-.-,-X---------------,-X-X-X-.-.-.-.-.-.-.-,-.-.-E-.-.-.-E-.-X-------------------------------------------------------------------------------------------------------
X-.-.-.-.-.-.-X---------------,-X-,-,-,-,-,-,-,-,-,-A-.-.-.-.-.-.-.-.-X-------------------------------------------------------------------------------------------------------
X-.-.-.-.-.-.-X---------------,-X-,-.-.-.-.-.-.-.-.-.-X-X-X-X-X-X-X-X-X-------------------------------------------------------------------------------------------------------
X-.-.-.-.-.-.-,-X-,-,-,-,-,-,-,-X-,-.-.-.-.-.-.-.-.-.-X-----------------------------------------------------------------------------------------------------------------------
X-.-.-.-.-.-.-.-X-X-X-X-X-X-X-X-X-,-,-,-,-,-,-,-,-,-,-X-----------------------------------------------------------------------------------------------------------------------
X-.-.-.-.-.-.-.-.-.-.-.-.-.-.-.-.-.-.-.-.-.-.-.-.-.-A-X-----------------------------------------------------------------------------------------------------------------------
,-X-.-.-.-.-.-.-.-.-.-.-.-.-.-.-.-.-.-.-.-.-.-.-.-.-.-X-----------------------------------------------------------------------------------------------------------------------
,-X-.-.-.-.-.-.-.-.-.-.-.-.-.-.-.-.-.-.-.-.-E-.-.-.-A-X-----------------------------------------------------------------------------------------------------------------------
--,-X-.-.-.-.-.-.-.-.-.-.-.-.-.-.-.-.-.-.-.-.-.-.-.-.-X-----------------------------------------------------------------------------------------------------------------------
--,-X-X-.-.-.-.-.-.-.-.-.-.-.-.-.-.-.-.-.-.-.-.-.-.-W-X-----------------------------------------------------------------------------------------------------------------------
----,-.-X-X-X-X-X-X-X-X-X-X-X-X-X-X-X-X-X-X-X-X-X-X-X-X-----------------------------------------------------------------------------------------------------------------------
