----------------------------------------------------------------------,-X-X-X-X-X-X-X-X-X-----------------------------------------------------------------------------------------------------------------
----------------------------------------------------------------------,-X-.-.-.-.-.-.-.-X-----------------------------------------------------------------------------------------------------------------
----------------------------------------------------------------------,-X-.-A-.-E-.-A-.-X-----------------------------------------------------------------------------------------------------------------
----------------------------------------------------------------------,-X-.-.-.-.-.-.-.-X-----------------------------------------------------------------------------------------------------------------
----------------------------------------------------------------------,-X-.-E-.-E-.-E-.-X-----------------------------------------------------------------------------------------------------------------
----------------------------------------------------------------------,-X-.-.-.-.-.-.-.-X-----------------------------------------------------------------------------------------------------------------
----------------------------------------------------------------------,-X-.-E-.-E-.-E-.-X-----------------------------------------------------------------------------------------------------------------
----------------------------------------------------------------------,-X-.-.-.-.-.-.-.-X-----------------------------------------------------------------------------------------------------------------
----------------------------------------------------------------------,-X-.-E-.-E-.-E-.-X-----------------------------------------------------------------------------------------------------------------
----------------------------------------------------------------------,-X-.-.-.-.-.-.-.-X-----------------------------------------------------------------------------------------------------------------
----------------------------------------------------------------------,-X-.-E-.-E-.-.-.-X-----------------------------------------------------------------------------------------------------------------
----------------------------------------------------------------------,-X-.-.-.-.-.-.-.-X-----------------------------------------------------------------------------------------------------------------
----------------------------------------------------------------------,-X-.-E-.-.-.-.-.-X-----------------------------------------------------------------------------------------------------------------
----------------------------------------------------------------------,-X-.-.-.-.-.-.-.-X-----------------------------------------------------------------------------------------------------------------
----------------------------------------------------------------------,-X-.-.-.-.-.-.-.-X-----------------------------------------------------------------------------------------------------------------
--------------,-,-,-,-,-,-,-,-,-,-,-,-,-,-,-,-,-,-,-,-,-,-,-,-,-,-,-,-,-X-.-.-.-.-.-.-.-X-,-,-,-,-,-,-,-,-,-,-,-,-,-,-,-,-,-,-,-,-,-,-,-,-,-,-,-,---------------------------------------------------------
--------------,-X-X-X-X-X-X-X-X-X-X-X-X-X-X-X-X-X-X-X-X-X-X-X-X-X-X-X-X-X-.-.-.-.-.-.-.-X-X-X-X-X-X-X-X-X-X-X-X-X-X-X-X-X-X-X-X-X-X-X-X-X-X-X-X-X---------------------------------------------------------
--------------,-X-.-.-.-.-<-.-.-.-.-.-.-.-.-.-.-.-.-.-.-.-.-.-.-.-.-.-.-.-.-.-.-.-.-.-.-.-.-.-.-.-.-.-.-.-.-.-.-.-.-.-.-.-.-.-.-.-.-.-.-.-.-.-.-X---------------------------------------------------------
--------------,-X-.-E-.-.-.-.-.-.-.-.-.-.-.-.-.-.-.-.-.-.-.-.-.-.-.-.-.-.-.-.-.-.-.-.-.-.-.-.-.-.-.-.-.-.-.-.-.-.-.-.-.-.-.-.-.-.-.-.-.-.-.-.-.-X---------------------------------------------------------
--------------,-X-.-.-.-.-.-.-.-.-.-.-.-.-.-.-.-.-.-.-.-.-.-.-.-.-.-.-.-.-.-.-.-.-.-.-.-.-.-.-.-.-.-.-.-.-.-.-.-.-.-.-.-.-.-.-.-.-.-.-.-.-.-.-.-X---------------------------------------------------------
--------------,-X-.-E-.-.-.-.-.-.-.-.-.-.-.-.-.-.-.-.-.-.-.-.-.-.-.-.-.-.-.-.-.-.-.-.-.-.-.-.-.-.-.-.-.-.-.-.-.-.-.-.-.-.-.-.-.-.-.-.-.-.-.-.-.-X---------------------------------------------------------
--------------,-X-.-.-.-.-.-.-.-.-.-.-.-.-.-.-.-.-.-.-.-.-.-.-.-.-.-.-.-.-.-.-.-.-.-.-.-.-.-.-.-.-.-.-.-.-.-.-.-.-.-.-.-.-.-.-.-.-.-.-.-.-.-.-.-X---------------------------------------------------------
--------------,-X-.-E-.-.-.-.-.-.-.-.-.-.-.-.-.-.-.-.-.-.-.-.-.-.-.-.-.-.-.-.-.-.-.-.-.-.-.-.-.-.-.-.-.-.-.-.-.-.-.-.-.-.-.-.-.-.-.-.-.-.-.-.-.-X---------------------------------------------------------
--------------,-X-.-.-.-.-.-.-.-.-.-.-.-.-.-.-.-.-.-.-.-.-.-.-.-.-.-.-.-.-.-.-.-.-.-.-.-.-.-.-.-.-.-.-.-.-.-.-.-.-.-.-.-.-.-.-.-.-.-.-.-.-.-.-.-X-----,-,-,-,-,-,-,-,-,-,-,-,-,-,-,-,-,-,-,-,-,-,-,-,-,-,-
--------------,-X-.-.-.-.-.-.-.-.-.-.-.-.-.-.-.-.-.-.-.-.-.-.-.-.-.-.-.-.-.-.-.-.-.-.-.-.-.-.-.-.-.-.-.-.-.-.-.-.-.-.-.-.-.-.-.-.-.-.-.-.-.-.-.-X-----,-X-X-X-X-X-X-X-X-X-X-X-X-X-X-X-X-X-X-X-X-X-X-X-X-X-
--------------,-X-.-.-.-.-.-.-.-.-.-.-.-.-.-.-.-.-.-.-.-.-.-.-.-.-.-.-.-.-.-.-.-.-.-.-.-.-.-.-.-.-.-.-.-.-.-.-.-.-.-.-.-.-.-.-.-.-.-.-.-.-.-.-.-X-----,-X-.-.-.-.-.-.-.-.-.-.-.-.-.-.-.-.-.-.-.-.-.-.-.-X-
--------------,-X-.-.-.-.-.-.-.-.-.-.-.-.-.-.-.-.-.-.-.-.-.-.-.-.-.-.-.-.-.-.-.-.-.-.-.-.-.-.-.-.-.-.-.-.-.-.-.-.-.-.-.-.-.-.-.-.-.-.-.-.-.-.-.-X-----,-X-.-.-.-.-.-.-.-.-.-.-.-.-.-.-.-.-.-.-.-.-.-E-.-X-
--------------,-X-.-.-.-.-.-.-.-.-.-.-.-.-.-.-.-.-.-.-.-.-.-.-.-.-.-.-.-.-.-.-.-.-.-.-.-.-.-.-.-.-.-.-.-.-.-.-.-.-.-.-.-.-.-.-.-.-.-.-.-.-.-.-.-X-,-,-,-X-.-.-.-.-.-.-,-,-,-,-,-,-,-,-,-,-.-.-.-.-.-.-.-X-
--------------,-X-.-.-.-.-.-.-.-.-.-.-.-.-.-.-.-.-.-.-.-.-.-.-.-.-.-.-.-.-.-.-.-.-.-.-.-.-.-.-.-.-.-.-.-.-.-.-.-.-.-.-.-.-.-.-.-.-.-.-.-.-.-.-.-X-X-X-X-X-.-.-.-E-.-,-,-.-,-,-,-,-,-,-.-,-,-.-.-E-.-.-.-X-
--------------,-X-.-.-.-.-.-.-.-.-.-.-.-.-.-.-.-.-.-.-.-.-.-.-.-.-.-.-.-.-.-.-.-.-.-.-.-.-.-.-.-.-.-.-.-.-.-.-.-.-.-.-.-.-.-.-.-.-.-.-.-.-.-.-.-.-+-+-.-.-.-.-.-.-,-,-.-.-,-.-.-.-.-,-.-.-,-,-.-.-.-.-.-X-
--------------,-X-.-.-.-.-.-.-.-.-.-.-.-.-.-.-.-.-.-.-.-.-.-.-.-.-.-.-.-.-.-.-.-.-.-.-.-.-.-.-.-.-.-.-.-.-.-.-.-.-.-.-.-.-.-.-.-.-.-.-.-.-.-.-.-.-+-+-.-.-.-.-.-,-,-.-.-.-,-.-.-.-.-,-.-.-.-,-,-.-.-.-.-X-
,-,-,-,-,-,-,-,-X-.-.-.-.-.-.-.-.-.-.-.-.-.-.-.-.-.-.-.-.-.-.-.-.-.-.-.-.-.-.-.-.-.-.-.-.-.-.-.-.-.-.-.-.-.-.-.-.-.-.-.-.-.-.-.-.-.-.-.-.-.-.-.-.-+-+-.-.-.-.-,-,-.-.-.-.-,-.-.-.-.-,-.-.-.-.-,-,-.-.-.-X-
X-X-X-X-X-X-X-X-X-.-.-.-.-.-.-.-.-.-.-.-.-.-.-.-X-X-X-X-X-X-X-X-X-X-X-X-X-X-X-X-X-X-X-X-X-X-X-X-X-X-X-X-X-X-X-X-X-.-.-.-.-.-.-.-.-.-.-.-.-.-.-.-X-X-X-X-X-.-.-,-.-.-.-.-.-,-.-.-E-.-,-.-.-.-.-.-,-.-E-.-X-
X-<-.-.-.-.-.-.-.-.-.-.-.-.-.-.-.-.-.-.-.-.-.-.-X-.-.-.-.-.-.-.-.-.-.-.-.-.-.-.-.-.-.-.-.-.-.-.-.-.-.-.-.-.-.-.-X-.-.-.-.-.-.-.-.-.-.-.-.-.-.-.-X-----,-X-.-.-,-,-,-,-,-,-,-.-.-.-.-,-,-,-,-,-,-,-.-.-.-X-
X-.-W-.-.-.-H-.-.-.-.-.-.-.-.-.-.-.-.-.-.-.-.-.-X-.-.-.-.-.-.-.-.-.-.-.-.-.-.-.-.-.-.-.-.-.-.-.-.-.-.-.-.-.-.-.-X-.-.-.-.-.-.-.-.-.-.-.-.-.-.-.-X-----,-X-.-.-,-,-.-.-.-.-.-.-.-.-.-.-.-.-.-.-,-,-.-.-.-X-
X-.-.-.-.-.-.-.-.-.-.-.-.-.-.-.-.-.-.-.-.-.-.-.-X-.-.-.-.-.-.-.-.-.-.-.-.-.-.-.-.-.-.-.-.-.-.-.-.-.-.-.-.-.-.-.-X-.-.-.-.-.-.-.-.-.-.-.-.-.-.-.-X-----,-X-.-.-,-,-.-.-.-.-.-.->->->-.-.-.-.-.-,-,-.-.-.-X-
X-<-.-<-<-.-.-.-.-.-.-.-.-.-.-.-.-.-.-.-.-.-A-<-X-.-.-.-.-.-.-.-.-.-.-.-.-.-.-.-.-.-.-.-.-.-.-.-.-.-.-.-.-.-.-.-X-.-A-.-E-.-.-.-.-.-.-.-.-.-.-.-X-----,-X-.-.-,-,-.-.-.-E-.-.->-.->-.-.-E-.-.-,-,-.-E-.-X-
X-.-.-.-.-.-.-.-.-.-.-.-.-.-.-.-.-.-.-.-.-.-.-.-X-.-.-.-.-.-.-.-.-.-.-.-.-.-.-.-.-.-.-.-.-.-.-.-.-.-.-.-.-.-.-.-X-.-.-.-.-.-.-.-.-.-.-.-.-.-.-.-X-----,-X-.-.-,-,-.-.-.-.-.-.->->->-.-.-.-.-.-,-,-.-.-.-X-
X-.-W-.-.-.-W-.-.-.-.-.-.-.-.-.-.-.-.-.-.-.-.-.-X-.-.-.-.-.-.-.-.-.-.-.-.-.-.-.-.-.-.-.-.-.-.-.-.-.-.-.-.-.-.-.-X-.-.-.-.-.-.-.-.-.-.-.-.-.-.-.-X-----,-X-.-.-,-,-,-,-,-,-,-.-.-.-.-,-,-,-,-,-,-,-.-.-.-X-
X-<-.-.-.-.-.-.-.-.-.-.-.-.-.-.-.-.-.-.-.-.-.-.-X-.-.-.-.-.-.-.-.-.-.-.-.-.-.-.-.-.-.-.-.-.-.-.-.-.-.-.-.-.-.-.-X-.-.-.-.-.-.-.-.-.-.-.-.-.-.-.-X-,-,-,-X-.-.-,-.-.-.-.-.-,-.-.-.-.-,-.-.-.-.-.-,-.-.-.-X-
X-X-X-X-X-X-X-X-X-.-.-.-.-.-.-.-.-.-.-.-.-.-.-.-X-X-X-X-X-X-X-X-X-X-X-X-X-X-X-X-X-X-X-X-X-X-X-X-X-X-X-X-X-X-X-X-X-.-.-.-.-.-.-.-.-.-.-.-.-.-.-.-X-X-X-X-X-.-.-,-,-.-.-.-.-,-.-.-E-.-,-.-.-.-.-,-,-.-E-.-X-
--------------,-X-.-.-.-.-.-.-.-.-.-.-.-.-.-.-.-.-.-.-.-.-.-.-.-.-.-.-.-.-.-.-.-.-.-.-.-.-.-.-.-.-.-.-.-.-.-.-.-.-.-.-.-.-.-.-.-.-.-.-.-.-.-.-.-.-+-+-.-.-.-.-.-,-,-.-.-.-,-.-.-.-.-,-.-.-.-,-,-.-.-.-.-X-
--------------,-X-.-.-.-.-.-.-.-.-.-.-.-.-.-.-.-.-.-.-.-.-.-.-.-.-.-.-.-.-.-.-.-.-.-.-.-.-.-.-.-.-.-.-.-.-.-.-.-.-.-.-.-.-.-.-.-.-.-.-.-.-.-.-.-.-+-+-.-.-.-.-.-.-,-,-.-.-,-.-.-.-.-,-.-.-,-,-.-.-.-.-.-X-
--------------,-X-.-.-.-.-.-.-.-.-.-.-.-.-.-.-.-.-.-.-.-.-.-.-.-.-.-.-.-.-.-.-.-.-.-.-.-.-.-.-.-.-.-.-.-.-.-.-.-.-.-.-.-.-.-.-.-.-.-.-.-.-.-.-.-.-+-+-.-.-.-.-.-.-.-,-,-.-,-,-,-,-,-,-.-,-,-.-.-.-.-.-.-X-
--------------,-X-.-.-.-.-.-.-.-.-.-.-.-.-.-.-.-.-.-.-.-.-.-.-.-.-.-.-.-.-.-.-.-.-.-.-.-.-.-.-.-.-.-.-.-.-.-.-.-.-.-.-.-.-.-.-.-.-.-.-.-.-.-.-.-X-X-X-X-X-.-.-.-E-.-.-,-,-,-,-,-,-,-,-,-,-.-.-.-E-.-.-.-X-
--------------,-X-.-.-.-.-.-.-.-.-.-.-.-.-.-.-.-.-.-.-.-.-.-.-.-.-.-.-.-.-.-.-.-.-.-.-.-.-.-.-.-.-.-.-.-.-.-.-.-.-.-.-.-.-.-.-.-.-.-.-.-.-.-.-.-X-----,-X-.-.-.-.-.-.-.-.-.-.-.-.-.-.-.-.-.-.-.-.-.-.-.-X-
--------------,-X-.-.-.-.-.-.-.-.-.-.-.-.-.-.-.-.-.-.-.-.-.-.-.-.-.-.-.-.-.-.-.-.-.-.-.-.-.-.-.-.-.-.-.-.-.-.-.-.-.-.-.-.-.-.-.-.-.-.-.-.-.-.-.-X-----,-X-.-.-.-.-.-.-.-.-.-.-.-.-.-.-.-.-.-.-.-.-.-E-.-X-
--------------,-X-.-.-.-.-.-.-.-.-.-.-.-.-.-.-.-.-.-.-.-.-.-.-.-.-.-.-.-.-.-.-.-.-.-.-.-.-.-.-.-.-.-.-.-.-.-.-.-.-.-.-.-.-.-.-.-.-.-.-.-.-.-.-.-X-----,-X-.-.-.-.-.-.-.-.-.-.-.-.-.-.-.-.-.-.-.-.-.-.-.-X-
--------------,-X-.-.-.-.-.-.-.-.-.-.-.-.-.-.-.-.-.-.-.-.-.-.-.-.-.-.-.-.-.-.-.-.-.-.-.-.-.-.-.-.-.-.-.-.-.-.-.-.-.-.-.-.-.-.-.-.-.-.-.-.-.-.-.-X-----,-X-X-X-X-X-X-X-X-X-X-X-X-X-X-X-X-X-X-X-X-X-X-X-X-X-
--------------,-X-.-.-.-.-.-.-.-.-.-.-.-.-.-.-.-.-.-.-.-.-.-.-.-.-.-.-.-.-.-.-.-.-.-.-.-.-.-.-.-.-.-.-.-.-.-.-.-.-.-.-.-.-.-.-.-.-.-.-.-.-.-.-.-X---------------------------------------------------------
--------------,-X-.-E-.-.-.-.-.-.-.-.-.-.-.-.-.-.-.-.-.-.-.-.-.-.-.-.-.-.-.-.-.-.-.-.-.-.-.-.-.-.-.-.-.-.-.-.-.-.-.-.-.-.-.-.-.-.-.-.-.-.-.-.-.-X---------------------------------------------------------
--------------,-X-.-.-.-.-.-.-.-.-.-.-.-.-.-.-.-.-.-.-.-.-.-.-.-.-.-.-.-.-.-.-.-.-.-.-.-.-.-.-.-.-.-.-.-.-.-.-.-.-.-.-.-.-.-.-.-.-.-.-.-.-.-.-.-X---------------------------------------------------------
--------------,-X-.-E-.-.-.-.-.-.-.-.-.-.-.-.-.-.-.-.-.-.-.-.-.-.-.-.-.-.-.-.-.-.-.-.-.-.-.-.-.-.-.-.-.-.-.-.-.-.-.-.-.-.-.-.-.-.-.-.-.-.-.-.-.-X---------------------------------------------------------
--------------,-X-.-.-.-.-.-.-.-.-.-.-.-.-.-.-.-.-.-.-.-.-.-.-.-.-.-.-.-.-.-.-.-.-.-.-.-.-.-.-.-.-.-.-.-.-.-.-.-.-.-.-.-.-.-.-.-.-.-.-.-.-.-.-.-X---------------------------------------------------------
--------------,-X-.-E-.-.-.-.-.-.-.-.-.-.-.-.-.-.-.-.-.-.-.-.-.-.-.-.-.-.-.-.-.-.-.-.-.-.-.-.-.-.-.-.-.-.-.-.-.-.-.-.-.-.-.-.-.-.-.-.-.-.-.-.-.-X---------------------------------------------------------
--------------,-X-.-.-.-.-<-.-.-.-.-.-.-.-.-.-.-.-.-.-.-.-.-.-.-.-.-.-.-.-.-.-.-.-.-.-.-.-.-.-.-.-.-.-.-.-.-.-.-.-.-.-.-.-.-.-.-.-.-.-.-.-.-.-.-X---------------------------------------------------------
--------------,-X-X-X-X-X-X-X-X-X-X-X-X-X-X-X-X-X-X-X-X-X-X-X-X-X-X-X-X-X-.-.-.-.-.-.-.-X-X-X-X-X-X-X-X-X-X-X-X-X-X-X-X-X-X-X-X-X-X-X-X-X-X-X-X-X---------------------------------------------------------
----------------------------------------------------------------------,-X-.-.-.-.-.-.-.-X-----------------------------------------------------------------------------------------------------------------
----------------------------------------------------------------------,-X-.-.-.-.-.-.-.-X-----------------------------------------------------------------------------------------------------------------
----------------------------------------------------------------------,-X-.-.-.-.-.-.-.-X-----------------------------------------------------------------------------------------------------------------
----------------------------------------------------------------------,-X-.-E-.-.-.-.-.-X-----------------------------------------------------------------------------------------------------------------
----------------------------------------------------------------------,-X-.-.-.-.-.-.-.-X-----------------------------------------------------------------------------------------------------------------
----------------------------------------------------------------------,-X-.-E-.-E-.-.-.-X-----------------------------------------------------------------------------------------------------------------
----------------------------------------------------------------------,-X-.-.-.-.-.-.-.-X-----------------------------------------------------------------------------------------------------------------
----------------------------------------------------------------------,-X-.-E-.-E-.-E-.-X-----------------------------------------------------------------------------------------------------------------
----------------------------------------------------------------------,-X-.-.-.-.-.-.-.-X-----------------------------------------------------------------------------------------------------------------
----------------------------------------------------------------------,-X-.-E-.-E-.-E-.-X-----------------------------------------------------------------------------------------------------------------
----------------------------------------------------------------------,-X-.-.-.-.-.-.-.-X-----------------------------------------------------------------------------------------------------------------
----------------------------------------------------------------------,-X-.-E-.-E-.-E-.-X-----------------------------------------------------------------------------------------------------------------
----------------------------------------------------------------------,-X-.-.-.-.-.-.-.-X-----------------------------------------------------------------------------------------------------------------
----------------------------------------------------------------------,-X-.-A-.-E-.-A-.-X-----------------------------------------------------------------------------------------------------------------
----------------------------------------------------------------------,-X-.-.-.-.-.-.-.-X-----------------------------------------------------------------------------------------------------------------
----------------------------------------------------------------------,-X-X-X-X-X-X-X-X-X-----------------------------------------------------------------------------------------------------------------
