--------------------------------------------------------------------------------------------------------------------------,-,-X-X-X-X-X-X-X-X-X-X-,-------------------------------------------------------------------------------------------------------------------------
----------------------------------------------------------------------------------------------------------------------,-,-X-X-.-.-.-.-.-.-.-.-.-.-X-,-----------------------------------------------------------------------------------------------------------------------
------------------------------------------------------------------------------------------------------------------,-,-X-X-.-.-.-.-.-.-.-.-.-.-.-.-.-X-,---------------------------------------------------------------------------------------------------------------------
--------------------------------------------------------------------------------------------------------------,-,-X-X-.-.-.-.-.-.-.-.-.-.-.-.-.-.-.-.-X-,-,-,-,-,-,-,-------------------------------------------------------------------------------------------------------
------------------------------------------------------------------------------------------------------------,-,-X-.-.-.-.-.-.-.-.-.-.-.-.-.-.-.-.-.-.-.-X-X-X-X-X-X-X-------------------------------------------------------------------------------------------------------
------------------------------------------------------------------------------------------------------------,-.-X-.-.-.-.-.-.-.-.-.-.-.-.-.-.-.-.-.-.-.-.-.-.-.-.-.-,-X-----------------------------------------------------------------------------------------------------
----------------------------------------------------------------------------------------------------------,-,-X-.-.-.-.-.-.-.-.-.-.-.-.-.-.-.-.-.-.-X-X-X-.-.-.-t2t2t2X-------------------,-,-,-,---------------------------------------------------------------------------
----------------------------------------------------------------------------------------------------------,-.-X-.-.-.-.-.-.-.-.-.-.-.-.-.-.-.-.-.-.-.-X---X-X-.-t2.-t2,-X-------------,-,-,-X-X-X-------------,-,-,-,-,-,---------------------------------------------------
--------------------------------------------------------------------------------------------------------,-,-X-.-.-.-.-.-.-.-.-.-.-.-.-.-.-.-.-.-.-.-.-.-X-,-,-X-t2t2t2,-X-----------,-,-X-X-X-.-X-,-----------,-X-X-X-X-X---------------------------------------------------
--------------------------------------------------------------------------------------------------------,-.-X-.-.-.-.-.-.-.-.-.-.-.-.-.-.-.-.-.-.-.-.-.-.-X-,---X-X-,-X-----------,-,-X-.-,-X-.-.-X-----------,-X-.-.-.-X---------------------------------------------------
------------------------------------------------------------------------------------------------------,-,-X-.-.-.-.-.-.-.-.-.-.-.-.-.-.-.-.-.-.-.-.-.-.-.-.-X-X-,-,-X-----------,-,-X-.-.-,-X-W-.-X-,---------,-X-.-E-.-X---------------------------------------------------
------------------------------------------------------------------------------------------------------,-.-X-.-.-.-.-.-.-.-.-.-.-.-.-.-.-.-.-.-.-.-.-.-.-.-.-.-.-X-X-X-,-,-,-,-,-,-X-.-.-.-,-X-.-.-,-X-,-,-,-,-,-X-.-.-.-X-,-,-,-,-,-,-,-,-,-,-,-,---------------------------
----------------------------------------------------------------------------------------------------,-,-X-.-.-.-.-.-.-.-.-.-.-.-.-.-.-.-.-.-.-.-.-.-.-.-.-.-.-.-.-.-.-X-X-X-X-X-X-.-.-.-.-.-X-X-.-,-X-X-X-X-X-X-X-,-,-,-X-X-X-X-X-X-X-X-X-X-X-X-X---------------------------
--------------------------------------------------------------------------------------------------,-,-X-.-.-.-.-.-.-.-.-.-.-.-.-.-.-.-.-.-.-.-.-.-.-.-.-.-.-.-.-.-.-.-.-.-.-.-.-.-.-.-.-.-.-.-X-X-,-.-,-.-A-.-.-.-.-.-.-.-.-.-,-.-.-.-.-.-.-.-H-X---------------------------
------------------------------------------------------------------------------------------------,-,-X-.-.-.-.-.-.-.-.-.-.-.-.-.-.-.-.-.-.-.-.-.-.-.-.-.-.-.-.-.-.-.-.-.-.-.-.-.-.-.-.-.-.-.-.-,-X-,-.-,-.-.-.-.-.-.-.-.-.-.-.-,-.-.-.-.-.-.-.-.-X---------------------------
--------------------------------------,-,-,-,-,-,-,-,-,-,-----------------------------,-,-,-,-,-,-X-.-.-.-.-.-.-.-.-.-.-.-.-.-.-.-.-.-.-.-.-.-.-.-.-.-.-.-.-.-.-.-.-.-.-.-.-.-.-.-.-.-.-.-.-.-,-.-,-.-,-.-W-.-.-.-.-.-.-.-.-.-,-.-.-.-.-.-.-.-.-X-,-,-,-,-------------------
--------------------------------------,-X-X-X-X-X-X-X-X-X---------------------------,-,-X-X-X-X-X-.-.-.-.-.-.-.-.-.-.-.-.-.-.-.-.-.-.-.-.-.-.-.-.-.-.-.-.-.-.-.-.-.-.-.-.-.-.-.-.-.-.-.-.-.-,-,-,-,-,-,-.-.-.-.-.-.-.-.-.-.-.-,-.-.-.-.-.-.-.-.-X-X-X-X-X-------------------
--------,-,-,-,-----------------------,-X-.-.-.-.-.-.-.-X---------------------------,-X-.-.-.-.-.-.-.-.-.-.-.-.-.-.-.-.-.-.-.-.-.-.-.-.-.-.-.-.-.-.-.-.-.-.-.-.-.-.-.-.-.-.-.-.-.-.-.-.-.-,-,-,-,-,-,-.-A-.-.-.-.-.-.-.-.-.-.-,-.-.-.-E-.-.-.-.-.-.-.-,-X-------------------
----,-,-,-X-X~X-,-,-,-----------------,-X-.-.-.-E-.-.-.-X-------------------------,-,-X-.-.-.-.-.-.-.-.-.-.-.-.-.-.-.-.-.-.-.-.-.-.-.-.-.-.-.-.-.-.-.-.-.-.-.-.-.-.-.-.-.-.-.-.-.-.-.-.-,-,-,-,-,-,-.-.-.-.-.-.-.-.-.-.-.-.-.-,-.-.-.-.-.-.-E-.-.-.-.-,-X-,-,-,-,-,---------
--,-,-X-X~.~.~.~X~X~X-,-,-,-,-,-,-,-,-,-X-.-.-.-.-.-.-.-X-,-,-,-,-,-,-,-,-------,-,-X-.-.-.-.-.-.-.-.-.-.-.-.-.-.-.-.-.-.-.-.-.-.-.-.-.-.-.-.-.-.-.-.-.-.-.-.-.-.-.-.-.-.-.-.-.-.-.-.-,-,-,-,-,-,-.-.-.-.-.-.-.-.-.-.-.-.-.-.-,-.-.-.-.-.-.-.-.-.-.-.-,-.-X-X-X-X-X-,-------
--,-X~.~.~.~.~.~.~.~.~X~X~X-X-X-X-X-X-X-X-,-,-,-,-,-,-,-X-X-X-X-X-X-X-X-X-------,-X-.-.-.-.-.-.-.-.-.-.-.-.-.-.-.-.-.-.-.-.-.-.-.-.-.-.-.-.-.-.-.-.-.-.-.-.-.-.-.-.-.-.-.-.-.-.-.-.-.-,-.-,-.-,-.-.-.-.-.-.-.-.-.-.-.-.-.-.-.-,-.-.-.-.-.-.-.-.-.-.-.-,-.-.-,-.-.-.-X-------
--,-X~.~.~.~.~.~.~.~.~,~,-.-.-.-.-.-.-.-.-.-.-.-.-.-.-.-.-.-.-.-.-.-.-.-X-----,-,-X-.-.-.-.-.-.-.-.-.-.-.-.-.-.-.-.-.-.-.-.-.-.-.-.-.-.-.-.-.-.-.-.-.-.-.-.-.-.-.-.-.-.-.-.-.-.-.-.-.-,-.-<-.-,-.-.-.-.-.-.-.-.-.-.-.-.-.-.-.-,-.-.-.-.-.-.-.-E-.-.-.-,-.-,-X-X-X-.-,-X-----
,-,-X~.~.~.~.~.~.~.~.~,~A-.-.-.-.-.-.-.-.-.-.-.-.-.-.-.-E-.-.-.-.-.-A-.-X-----,-X-,-.-.-.-.-.-.-.-.-.-.-.-.-.-.-.-.-.-.-.-.-.-.-.-.-.-.-E-.-.-.-.-.-.-.-.-.-.-.-.-.-.-.-.-.-.-.-.-.-.-,-.-,-.-,-.-.-.-.-.-.-.-.-.-.-.-.-.-.-.-,-.-.-.-.-.-.-.-.-.-.-.-,-X-X-----,-X-.-X-,---
,-X-.~.~.~.~.~.~.~.~.~,~.-.-.-.-.-.-.-.-.-.-.-.-.-.-.-.-.-.-.-.-.-.-.-.-X-----,-X-,-,-,-.-.-.-.-.-.-.-.-.-.-.-.-.-.-.-.-.-.-.-.-.-.-.-.-.-.-.-.-.-.-.-.-.-.-.-.-.-.-.-.-.-.-.-.-.-.-.-,-.-,-.-E-.-.-.-.-.-.-.-.-.-.-.-.-.-.-.-,-.-.-.-.-.-.-.-.-.-.-.-.-X---------X-.-.-X---
,-X~.~.~.~.~.~.~.~.~,~,-.-.-.-.-E-.-.-.-.-.-.-.-.-.-.-.-.-.-.-.-.-.-.-.-X-,---,-X-,-,-,-,-.-.-.-.-.-.-.-.-.-.-.-.-.-.-.-.-.-.-.-.-.-.-.-.-.-.-.-.-.-.-.-.-.-.-.-.-.-.-.-.-.-.-.-.-.-.-,-.-,-.-,-.-.-.-.-.-.-.-.-.-.-.-.-.-.-.-,-,-,-,-,-,-,-,-,-,-,-,-,-X-----,-,-X-X-.-X---
,-X~.~.~.~.~.~.~.~.~,~.-.-.-.-.-.-.-.-.-.-.-.-.-.-.-.-.-.-.-.-.-.-.-.-.-.-X-,-,-X-.-,-,-,-,-.-.-.-.-.-.-.-.-.-.-.-.-.-,-,-,-,-,-,-,-,-,-,-,-,-,-,-,-,-,-,-,-,-,-,-,-,-,-,-.-.-.-.-.-.-,-.-,-.-,-.-.-.-.-.-.-.-.-.-.-.-.-.-.-.-.-.-.-.-.-.-.-.-.-.-.-.-.-X---,-,-X-.-.-,-X---
,-X~.~.~.~.~.~.~.~,~,~.-.-.-.-.-.-.-.-.-.-.-.-.-H-.-.-.-.-.-.-.-.-.-.-.-.-.-X-X-X-,-.-.-,-,-,-,-.-.-.-.-.-.-.-.-.-.-.-,-.-.-.-.-.-.-.-.-.-.-.-.-.-.-.-.-.-.-.-.-.-.-.-.-,-.-.-.-.-.-.-,-.-,-.-,-.-.-.-.-.-.-.-.-.-.-.-.-.-.-.-.-.-.-.-.-.-.-.-.-.-.-.-.-X-,-,-X-.-,-X-X-----
X-.~.~.~.~.~.~.~.~,~.-.-.-.-.-.-.-.-.-.-.-.-.-.-.-.-.-.-.-.-.-.-.-.-.-.-.-.-.-.-.-,-,-E-.-,-,-,-,-.-.-.-.-.-.-.-.-.-.-,-.-:-.-.-.-,-,-,-,-<-,-,-,-,-.-,-,-,-,-.-.-.-.-:-,-.-.-.-.-.-.-,-.-,-.-E-.-.-.-.-.-.-.-.-.-.-.-,-,-,-,-,-,-,-,-,-,-.-.-.-.-.-.-.-X-,-X-.-.-X---------
X~.~.~.~.~.~.~.~,~,-E-.-.-.-.-.-.-.-.-.-.-.-E-.-A-.-.-.-.-.-.-.-.-.-.-.-E-.-.-.-.-.-.-,-,-.-,-,-,-,-.-.-.-.-.-.-.-.-.-,-.-.-X-X-X-X-X-X-X-X-X-X-X-X-X-X-X-X-X-X-X-X-X-.-,-.-.-.-.-.-.-,-,-,-,-,-,-.-.-.-.-.-.-.-E-.-.-,-.-.-.-.-.-.-.-.-X-X-X-X-X-.-.-.-X-,-X-.-W-X---------
X~.~.~.~.~.~.~,~,~.-.-.-.-.-.-.-.-.-,-,-,-,-,-,-,-,-,-,-,-,-,-,-,-,-,-,-.-.-.-.-.-.-.-.-,-,-.-,-,-,-.-.-.-.-.-.-.-.-.-,-.-.-X-,-X-X-X-.-X-X-X-X-.-X-X-X-X-.-X-X-X-,-X-.-,-.-.-.-.-.-.-.-,-,-,-,-,-,-.-.-.-.-.-.-.-.-.-,-.-.-.-.-.-.-.-.-X-----,-X-.-.-.-X---X-.-.-X---------
X~.~.~.~.~.~.~,~.-.-.-.-.-.-.-.-.-,-,-.-.-.-.-.-.-.-.-.-.-.-.-.-.-.-.-,-,-.-.-.-.-.-.-.-.-,-,-.-,-,-,-.-.-.-.-.-.-.-.-,-.-.-X-X-.-.-.-.-E-.-.-.-.-.-.-.-.-.-.-.-.-X-X-.-,-.-.-.-.-.-.-.-.-,-,-,-,-,-,-.-.-.-.-.-.-.-.-,-.-.-.-.-.-.-.-.-X-----,-X-.-.-.-X---,-X-E-,-X-------
X~.~.~.~.~.~,~,-.-.-.-.-.-.-.-.-.-,-.-.-.-.-.-.-.-.-.-.-.-.-.-.-.-.-.-.-,-.-.-.-.-.-.-.-.-.-,-E-,-,-,-.-.-.-.-.-.-.-.-,-.-,-X-X-.-.-.-.-.-.-.-.-.-.-.-.-.-.-.-.-E-X-X-.-,-,-,-,-,-,-,-.-.-.-,-,-,-,-,-,-.-.-.-.-.-.-.-,-.-.-.-.-E-.-,-,-X-,---,-X-.-.-.-X---,-X-.-.-X-------
X~,~,~,~,~,~,~.-.-.-H-.-.-.-.-.-.-,-.-.-.-.-.-.-E-.-.-.-E-.-.-.-E-.-.-.-,-.-.-.-.-.-.-.-.-.-,-,-.-,-,-,-.-.-.-.-.-.-.-,-.-,-X-X-.-E-.-.-.-.-.-.-.-.-.-.-.-.-E-.-.-X-X-.-.-.-.-.-.-.-,-.-.-.-.-,-X-X-X-,-.-.-.-.-.-.-.-,-.-.-.-.-.-.-X-X-X1X1,-,-X-.-.-.-X-----,-X-E-,-X-----
X~,~.-.-.-.-.-.-.-.-.-.-.-.-.-.-.-,-.-.-.-.-.-.-.-.-.-.-.-.-.-.-.-.-.-.-,-.-.-.-.-.-.-.-.-.-.-,-.-,-,-,-.-.-.-.-.-.-.-,-.-,-X-.-.-.-.-,-X-X-X-X-X-X-X-X-X-.-.-.-.-X-X-.-.-.-.-,-,-,-,-,-,-,-,-,-X-,-X-,-.-.-.-.-.-.-.-,-.-.-.-.-.-.-X-X-.1.1X1X-X-.-.-.-X-------X-.-.-X-----
X~.-.-.-.-.-A-.-.-.-.-.-.-.-.-.-.-,-.-.-.-.-.-.-.-.-.-.-,-X-X-X-X-X-X-X-X-.-.-.-.-.-.-.-.-.-.-,-,-.-,-,-,-.-.-.-.-.-.-,-.-,-X-X-.-.-.-X---------------,-,-X-.-.-.-X-X-X-X-X-X-X-X/X/X-X-X-.-.-.-X-,-X-X-X-.-.-.-.-.-.-,-.-E-.-H-.-.-+-+-.1.1,1+-+-.-.-.-X-------,-X-.-,-X---
X-,-,-,-,-,-,-,-,-,-,-,-,-,-,-.-.-,-.-.-.-.-X-X-X-.-.-,-X-X-X-X-X-X-X-.-X-.-.-.-.-.-.-.-.-.-.-.-,-.-,-,-,-.-.-.-.-.-.-,-.-.-X-X-.-.-.-X---------------,-X-X-.-.-.-.-X-X-X-X-,-,-X-X-X-X-X-.-.-A-X-,-,-X-X-.-.-.-.-.-.-,-.-.-.-.-.-.-X-X-.1,1X1X1X-.-.-.-X---------,-X-.-X---
X-.-.-.-.-.-.-.-.-.-.-.-.-.-,-.-.-,-.-.-.-X-X7X7X7X-X-X-X-.-E-.-E-.-X-X-X-.-.-.-H-.-.-.-.-,-,-X-X-X-X-X-X-.-.-.-.-.-.-,-.-.-X-X-.-.-.-X---------------,-X-.-.-.-.-.-.-.-.-,-XOX-X-H-W-X-X-.-.-.-X-X-X-.-.-.-.-.-.-.-.-,-.-.-.-.-.-.-.-X-X1X1--,-X-.-.-.-X---------,-X-.-X---
X-.-.-.-.-.-.-.-.-.-.-.-.-.-,-.-.-,-.-.-X-X-.7.7.7X7X-X-.-.-.-.-.-.-+-+-.-.-.-.-.-.-.-.-.-X-X-X-X-X-,-X-X-.-.-.-.-.-.-,-.-.-X-X-.-.-.-X---------------,-X-X-.-E-.-.-.-.-E-,-+O.-H-H-W-X-X-.-.-.-+-+-.-.-.-.-.-.-.-.-.-,-.-.-.-.-E-.-.-.-X-----,-X-.-.-.-X-----------,-X-,-X-
X-.-E-.-E-.-E-.-E-.-E-.-.-.-,-.-.-,-.-.-+-+-.7.7.7,7+-.-E-.-E-.-E-.-+-+-.-.-E-.-.-.-.-.-.-X-X-.-.-.-X-.-.-.-.-.-.-.-.-,-,-,-X-X-.-.-.-X-----------------,-X-.-.-.-.-.-.-.-,-XOX-H-H-W-X-X-.-.-,-X-X-X-X-.-.-.-.-E-.-.-,-.-.-.-.-.-.-.-.-X-----,-X-.-.-.-X-------,-,-,-X-.-X-
X-K-.-.-.-.-.-.-.-.-.-.-.-.-,-.-.-,-.-.-X-X-.7.7.7X7X7X-.-.-.-.-.-.-+-+-.-.-.-.-.-.-.-.-.-L-L-E-.-.6,6.-.-.-.-.-.-.-.-.-.-.-X-X-.-E-.-X---------,-,-,-,-,-,-X-X-X-X-X-.-.-,-X-,-X-W-X-X-X-.-.-,-X-X5X5X5X-.-.-.-.-.-.-,-.-.-.-.-.-.-.-.-X-,-,-,-X-.-.-.-X-----,-,-X-X-.-,-X-
X-X-X-X-X-X-X-X-X-X-X-.-.-.-,-.-.-,-.-.-.-X-X7X7X7X-X-X-X-.-E-.-E-.-X-X-X-.-.-.-A-.-.-.-.-X-X-.-.-,-X-.-.-.-.-.-.-.-.-.-.-.-X-X-,-,-,-X-------,-,-X-X-X-,-X-X-X-,---,-X-+-X---,-X-X.X.,-X-.-.-,-X-.-H-X-X-.-.-.-.-.-.-,-,-,-,-,-,-,-,-,-X-X-X-X-X-.-.-.-X-----,-X-.-,-X-X---
------------------,-X-.-.-.-,-.-.-,-.-.-.-.-X-X-X-.-.-.-X-X-X-X-X-X-X-,-X-.-.-.-.-.-.-.-.-X-.-X6X6X-,-X6X6.-.-.-.-.-.-,-,-,-X-,-XU+UXU------,-,-X-X-.-X-X-X-.-X-X-,-,-X-+-X-,-,-X.X-X-,-X-.-.-,-X-.-.-X-X-.-.-.-.-.-.-.-.-.-.-.-.-.-.-.-.-.-.-.-.-.-.-.-X-----,-X-E-X-------
------------------,-X-.-E-.-,-.-.-,-.-.-.-.-.-.-.-.-.-.-.-X-X-X-X-X-X-X-X-.-.-.-.-.-.-.-.-.-X-X-X-X-X-X-X-.-.-.-.-.-.-,-.-.-X-,-X-.-X-,-,-,-,-X-.-.-.-.-.-.-.-.-.-X-X-A-.-.-X-X-....X.X-X-.-.-,-X-.-.-X-X-.-.-.-.-.-.-.-.-.-.-.-.-.-.-.-.-.-.-.-.-.-.-.-X---,-,-X-,-X-,-----
------------------,-X-.-.-.-,-.-.-,-.-.-.-.-.-.-.-.-.-.-.-.-.-.-.-.-.-W-,-.-.-.-.-.-.-.-.-.-.-,-.-.-,-,-.-.-.-.-.-.-.-,-.-.-X-X-.-.-.-X0X0X0,-X-.-.-E-.-.-.-.-E-.-+-+-.-E-.-+-,-..E.,.+-.-.-.-,-X-.-.-.-X-X-.-.-.-.-.-.-.-.-.-.-.-.-.-.-.-.-.-.-.-.-,-,-X-,-,-X-.-.-.-X-,---
------------------,-X-.-.-.-,-.-.-,-.-.-.-.-.-.-E-.-.-.-E-.-.-.-E-.-.-.-,-.-.-.-.-.-.-.-.-.-,-,-.-,-,-,-.-.-.-.-.-.-.-,-.-.-X-X-.-.-.-.-.-.-X-X-.-.-.-.-.-.-.-.-,-X-X-A-.-,-X-X.....X.X-X-.-.-,-X-A-.-.-X-X-.-.-.-.-.-.-.-.-.-.-.-.-.-.-.-.-.-.-.-.-,-.-X-X-X-.-.-.-.-.-X---
------------------,-X-.-.-.-,-.-.-,-,-.-.-.-.-.-.-.-.-.-.-.-.-.-.-.-.-,-,-.-.-.-.-.-.-.-.-,-,-.-.-,-,-.-.-.-.-.-.-.-.-,-.-.-X-X-.-.-.-.-.-,-X-,-X-XP+PXPX-X-X-X-X-,-,-X-X-X-,-,-X.X.X.,-X-,-,-A-X-X-X-+-X-X-.-.-.-.-.-.-.-.-.-.-.-.-.-.-.-.-.-.-.-.-,-.-.-.-.-.-E-H-.-.-X---
------------------,-X-.-E-.-,-.-.-.-,-,-,-,-,-,-,-,-,-,-,-,-,-,-,-,-,-,-.-.-.-.-.-.-.-.-,-,-.-.-,-,-,-.-.-.-.-.-.-.-.-,-.-.-X-X-.-.-E-.-.-,-X-X-,-X-.-X-,---------,-X-X-X-X-X-X-X-X-X-X-X-.-.-,-X-,-X-+-X-.-.-.-.-.-.-.-.-.-.-.-.-.-.-.-.-.-.-.-.-.-,-.-X-X-X-.-.-.-.-,-X---
------------------,-X-.-.-.-,-.-.-.-.-.-.-.-.-.-.-.-.-.-.-.-.-.-.-.-.-.-.-.-.-.-.-.-.-,-,-.-.-,-,-,-.-.-.-.-.-.-.-.-.-,-.-.-X-X-.-.-.-.-.-,-W-X-X-,-,-,-X---------,-X-.-.-.-.-.-.-,-,-,-,-.-.-,-X-,-X-,-.-.-.-.-.-.-.-.-.-.-.-.-.-.-.-.-.-.-.-.-.-.-,-.-X---,-X-.-.-,-X-----
------------------,-X-.-E-.-,-.-A-.-.-.-.-.-E-.-.-.-.-.-.-.-.-.-.-.-.-.-.-.-.-.-.-,-,-,-.-,-,-,-,-.-.-.-.-.-.-.-.-.-.-,-.-.-X-X-.-.-.-.-.-,-W-X-X-.-.-.-X---------,-X-.-,-,-,-,-,-,-,-,-,-,-,-,-X-X-X-,-.-.-.-.-.-.-E-.-.-.-.-.-.-.-.-.-.-.-.-.-.-,-,-.-X-----,-X-X-X-------
------------------,-X-.-.-.-,-.-.-.-.-.-.-.-.-.-.-.-.-.-.-.-.-.-.-.-.-.-.-.-.-.-,-,-.-.-,-,-,-,-.-.-.-.-.-.-.-.-.-.-.-,-.-E-X-X-.-E-.-.-E-,-W-X-X-.-.-:-X---------,-X-.-,-.-.-.-.-.-.-.-.-.-.-,-.-,-.-,-.-.-.-.-.-.-.-.-.-.-.-.-.-.-.-.-.-.-.-.-.-,-.-.-X-------------------
------------------,-X-.-E-.-,-.-.-.-.-.-.-.-.-.-.-.-H-.-.-.-.-.-A-.-.-.-.-,-X-X-X-.-E-,-,-,-.-.-.-.-.-.-.-.-.-.-.-.-.-,-.-.-X-X-.-.-.-.-.-,-X-X-X-X-X-X-X---------,-X-.-,-.-.-.-.-.-.-.-.-.-.-,-.-,-.-,-.-.-.-.-.-.-.-.-.-.-.-.-.-.-.-.-.-.-.-.-,-,-,-.-X-------------------
------------------,-X-.-.-.-,-.-.-.-.-.-.-,-,-,-,-,-,-,-,-,-,-.-.-.-.-.-,-X---,-X-,-,-,-,-.-.-.-.-.-.-.-.-.-.-.-.-.-.-,-.-.-X-,-X-X-X-X-X-X-,-,-,-,-,-,-,-,-,-,-,-,-X-.-,-.-.-.-.-.-.-.-.-.-.-,-.-,-.-,-.-.-.-.-.-.-.-.-.-.-.-.-.-.-.-.-.-.-.-,-,-.-,-,-X-------------------
------------------,-X-.-E-.-,-.-.-.-E-.-,-,-.~.~.~.~.~.~.~.~E~,-,-.-.-.-X-----,-X-,-,-,-.-.-.-.-.-.-.-.-.-.-.-.-.-.-.-,-.-.-X-X-X-X-X-X-X-X-X-X-X-X-X-X-X-X-X-X-X-X-X-.-,-.-.-.-.-.-.-.-.-.-.-,-.-,-.-,-.-.-.-.-.-.-.-.-.-.-.-.-.-.-.-.-.-.-.-,-,-.-.-,-X-------------------
------------------,-X-.-.-.-,-.-.-.-.-,-,-.~.~.~.~.~.~.~.~.~.~.~,-,-.-.-X-----,-X-,-.-.-.-.-.-.-.-.-.-.-.-.-.-.-.-.-.-,-.-:-.-.-.-.-.-.-.-E-.-.-.-.-.-E-.-.-.-A-H-.-A-:-,-.-.-.-.-.-.-.-.-.-.-,-.-,-.-,-.-.-.-.-.-.-.-.-.-.-.-.-.-.-.-.-.-.-,-,-,-,-,-.-X-------------------
------------------,-X-.-.-.-,-.-.-.-,-,-.~.~.~.~.~.~.~.~.~.~.~.~.~,~,-,-X-----,-X-,-.-.-.-.-.-.-.-.-.-.-.-.-.-.-.-.-.-,-,-,-,-,-,-,-,-,-,-,-,-,-,-,-,-,-,-,-,-,-,-,-,-,-,-.-.-.-.-.-.-.-.-.-.-,-.-,-.-,-.-.-.-.-.-.-.-.-.-.-.-.-.-.-.-.-.-.-,-.-.-.-,-,-X-------------------
------------------,-X-.-.-.-,-.-.-,-,-.~.~.~.~.~.~.~.~.~.~.~.~.~.~.~.~,-X-----,-X-,-,-,-.-.-.-.-.-.-.-.-.-.-.-.-.-.-.-.-.-.-.-.-.-.-.-.-.-.-.-.-.-.-.-.-.-.-.-.-.-.-.-.-.-.-.-.-.-.-.-.-.-.-.-,-.-,-.-E-.-.-.-.-.-.-.-.-.-.-.-.-.-.-.-.-.-,-,-.-.-E-.-X---------------------
------------------,-X-X-X-X-X-X-X-X-X~.~.~.~.~.~.~.~.~.~.~.~.~.~.~.~,~,~X~----,-X-.-.-,-,-.-.-.-.-.-.-.-.-.-.-.-.-.-.-.-.-.-.-.-.-.-.-.-.-.-.-.-.-.-.-.-.-.-.-.-.-.-.-.-.-.-.-.-.-.-.-.-.-.-.-,-.-,-.-,-.-.-.-.-.-.-.-.-.-.-.-,-,-,-,-,-,-,-.-.-.-.-,-X---------------------
------------------------------------,-X~.~.~.~.~.~.~.~.~.~.~.~.~,~,~X~X-------,-X-X-.-.-,-.-.-.-.-.-.-.-.-.-.-.-.-.-.-.-.-.-.-.-.-.-.-.-.-.-.-.-.-.-.-.-.-.-.-.-.-.-.-.-.-.-.-.-.-.-.-.-.-.-.-,-.-,-.-,-.-.-.-.-.-.-.-.-.-.-.-,-.-.-.-.-.-,-,-,-,-,-X-----------------------
--------------------------------------,-X~X~X~X~X~X~X~X~X~X~X~X~X~X---------------,-X-.-,-,-,-.-.-.-.-.-.-.-.-.-.-.-.-.-.-.-.-.-.-.-.-.-.-.-.-.-.-.-.-.-.-.-.-.-.-.-.-.-.-.-.-.-.-.-.-.-.-.-.-,-.-,-.-,-.-.-.-.-.-.-.-.-.-.-.-,-.-A-.-.-.-.-.-.-.-.-X-----------------------
----------------------------------------------------------------------------------,-X-.-.-.-,-,-,-.-.-.-.-.-.-.-.-.-.-.-.-.-.-.-.-.-.-.-.-.-.-.-.-.-.-.-.-.-.-.-.-.-.-.-.-.-.-.-.-.-.-.-.-.-.-,-.-<-.-,-.-.-.-.-.-.-.-.-.-.-.-,-.-.-.-.-E-.-.-.-.-.-X-----------------------
--------------------------------------------------------------------------------,-,-X-X-X-.-E-.-,-,-.-.-.-.-.-.-.-.-.-.-.-.-.-.-.-.-.-.-.-.-.-.-.-.-.-.-.-.-.-.-.-.-.-.-.-.-.-.-.-.-.-.-.-.-,-,-,-,-,-,-.-.-.-.-.-.-.-.-.-.-.-,-.-.-.-.-.-.-.-.-.-.-X-----------------------
--------------------------------------------------------------------------------,-X-.-X-X-.-.-.-.-,-.-.-.-.-.-.-.-.-.-.-.-.-.-.-.-.-.-.-.-.-.-.-.-.-.-.-.-.-.-.-.-.-.-.-.-.-.-.-.-.-.-.-.-,-,-,-,-,-,-.-.-.-.-.-.-.-.-.-.-.-.-,-.-.-.-.-.-.-.-.-.-.-X-----------------------
----------------------------------------------------------------------,-,-,-,---,-X-.-X-,-X-E-.-E-,-,-.-.-.-.-.-.-.-.-.-.-.-.-.-.-.-.-.-.-.-.-.-.-.-.-.-.-.-.-.-.-.-.-.-.-.-.-.-.-.-.-.-,-,-,-,-,-,-.-.-.-.-.-.-.-.-.-.-E-.-.-,-.-.-.-.-.-E-.-.-.-.-X-----------------------
------------------------------------------------------------------,-,-,-X-X-X-,-,-X-.-X---X-.-.-.-.-,-.-.-.-.-.-.-.-.-.-.-.-.-.-.-.-.-.-.-.-.-.-.-.-.-.-.-.-.-.-.-.-.-.-.-.-.-.-.-.-.-,-,-,-,-,-,-.-.-.-.-.-.-.-.-.-.-.-.-.-.-,-.-.-.-.-.-.-.-.-.-.-X-----------------------
------------------------------------------------------------------,-X-X-.-.-.-X-,-,-X-.-X-,-X-.-E-.-,-,-.-.-.-.-.-.-.-.-.-.-.-.-.-.-.-.-.-.-.-.-.-.-.-.-.-.-.-.-.-.-.-.-.-.-.-.-.-.-,-,-,-,-,-,-.-.-.-.-.-,-,-,-,-,-,-,-,-,-,-,-.-.-.-.-.-.-.-.-.-.-X-----------------------
------------------------------------------------------------------,-X-.-.-.-E-.-X-,-X-.-X-,-X-.-.-.-.-,-.-.-.-.-.-.-.-.-.-.-.-.-.-.-.-.-.-.-.-.-.-.-.-.-.-.-.-.-.-.-.-.-.-.-.-.-.-,-,-,-,-,-,-.-.-.-.-.-.-,-.-.-.-.-.-.-.-.-.-.-.-.-.-.-.-.-X-X-X-X-X-----------------------
----------------------------------------------------------------,-,-X-,-X-X-.-.-.-X-X-.-X---,-X-E-.-E-,-,-.-.-.-.-.-.-.-.-.-.-.-.-.-.-.-.-.-.-.-.-.-.-.-.-.-.-.-.-.-.-.-.-.-.-.-,-,-,-,-,-,-.-.-.-.-.-.-.-,-.-A-.-.-.-.-.-.-.-.-.-A-.-.-.-.-X-------------------------------
----------------------------------------------------------------,-X-.-X---,-X-.-.-X-.-,-X---,-X-.-.-.-.-,-.-.-.-.-.-.-.-.-.-.-.-.-.-.-.-.-.-.-.-.-.-.-.-.-.-.-.-.-.-.-.-.-.-.-,-,-,-,-,-,-.-.-.-.-.-.-.-.-,-.-.-.-.-.-.-.-.-.-.-.-.-.-.-.-.-X-------------------------------
----------------------------------------------------------------,-X-H-X-----,-X-X-X-.-X-------,-X-.-E-.-,-,-.-.-.-.-.-.-.-.-.-.-.-.-.-.-.-.-.-.-.-.-.-.-.-.-.-,-X-X-X-X-X-X-X-X-X-,-,-,-.-.-.-.-.-.-.-.-.-,-.-.-.-.-.-.-.-.-.-.-.-.-E-.-.-.-X-------------------------------
----------------------------------------------------------------,-X-X-------------,-X-X-------,-X-.-.-.-.-,-,-.-.-.-.-.-.-.-.-.-.-.-.-.-.-.-.-.-.-.-.-.-.-,-X-X---------,-,-,-,-X-,-,-.-.-.-.-.-.-.-.-.-.-,-.-.-.-.-.-E-.-.-.-.-.-.-.-.-.-.-X-------------------------------
------------------------------------------------------------------------------------------------,-X-E-.-E-.-,-,-.-.-.-.-.-.-.-.-.-.-.-.-.-.-.-.-.-.-.-.-,-X-----------,-,-X-X-X-X-,-.-.-.-.-.-.-.-.-.-.-.-,-.-.-.-.-.-.-.-.-.-.-.-.-.-.-.-A-X-------------------------------
------------------------------------------------------------------------------------------------,-X-.-.-.-.-.-,-,-.-.-.-.-.-.-.-.-.-.-.-.-.-.-.-.-.-,-X-X-------------,-X-.-.-.-,-.-.-A-.-.-.-.-.-.-.-.-.-,-.-.-.-.-.-.-.-.-.-.-X-X-X-X-X-X-X-------------------------------
--------------------------------------------------------------------------------------------------,-X-.-.-t2<-.-,-,-.-.-.-.-.-.-.-.-.-.-.-.-.-.-.-,-X-----------------,-X-.-,-X-X-W-.-.-.-.-.-.-.-.-.-.-.-,-.-.-.-.-.-.-.-.-.-.-X-------------------------------------------
--------------------------------------------------------------------------------------------------,-X-.-.-.-.-<-.-,-,-.-.-.-.-.-.-.-.-.-.-.-.-,-X-X-------------------,-X-E-X-,-X-.-.-.-.-.-.-.-.-.-.-.-.-,-.-.-.-.-.-.-.-.-.-.-X-------------------------------------------
----------------------------------------------------------------------------------------------------,-X-.-.-.-.-<-.-,-,-.-.-.-.-.-.-.-.-.-.-,-X-----------------------,-X4.4X4,-X-,-,-,-,-,-,-,-.-.-.-.-.-,-.-.-.-.-.-.-.-.-.-.-X-------------------------------------------
----------------------------------------------------------------------------------------------------,-X-.-.-E-.-.-<-.-,-,-.-.-.-,-,-,-,-,-X-X-------------------------,-X4.4X4,-X-X-.-.-.-.-.-X-X-X-X-X-X-X-X-X-X-X-X-X-X-+-X-X-X-------------------------------------------
------------------------------------------------------------------------------------------------------,-X-.-.-.-.-.-<-,-X-X-X-X-X-X-.-X-X-----------------------------,-X4.4X4,-,-X-.-H-H-.-H-X-X---------------------,-X-+-X-----------------------------------------------
--------------------------------------------------------------------------------------------------------,-X-X-.-.-.-.-X-,-------,-X-.-X-------------------------------,-X-E-.-X4X4.-.-E-.-E-.-.-X---------------------,-X-.-X-----------------------------------------------
------------------------------------------------------------------------------------------------------------,-X-X-X-.-.-X-----,-,-X-W-X-------------------------------,-X-.-.-.-.-.-,-X-X-X-.-E-X-------,-,-,---------,-X-.-X-----------------------------------------------
------------------------------------------------------------------------------------------------------------------,-X-.-X-,-,-,-X-.-X-,---------------------------------,-X-X-X-X-X-X-----,-X-.-X-,-,-,-,->->-,-------,-X-E-X-----------------------------------------------
--------------------------------------------------------------------------------------------------------------------X-.-.-X-X-X-A-.-X-----------------------------------------------------,-X-.-X-X-X-X-X-H-H-X-------,-X-.-X-----------------------------------------------
--------------------------------------------------------------------------------------------------------------------,-X-.-.-.-.-.-X-,-----------------------------------------------------,-X-.-X-X-.-.-.-H-H-X-------,-X-.-X-----------------------------------------------
----------------------------------------------------------------------------------------------------------------------,-X-X-X-X-X-X-------------------------------------------------------,-X-.-X-X-.-X-X-.-.-X-,-,-,-,-X-.-X-----------------------------------------------
------------------------------------------------------------------------------------------------------------------------------------------------------------------------------------------,-X-.-X-X-.-X-X-.-.-X-X-X-X-,-X-.-X-----------------------------------------------
------------------------------------------------------------------------------------------------------------------------------------------------------------------------------------------,-X-.-X-X-.-.-.-.-.-.-.-.-X-,-X-.-X-----------------------------------------------
------------------------------------------------------------------------------------------------------------------------------------------------------------------------------------------,-X-.-X-X-X-X-X-.-.-X-X-X-X-,-X-.-X-----------------------------------------------
------------------------------------------------------------------------------------------------------------------------------------------------------------------------------------------,-X-.-X-,-,-,-X-L-X-X-,-,-,-,-X-.-X-----------------------------------------------
------------------------------------------------------------------------------------------------------------------------------------------------------------------------------------------,-X-.-.-X-X-X-X-L-X-X-X-X-X-X-.-E-X-----------------------------------------------
------------------------------------------------------------------------------------------------------------------------------------------------------------------------------------------,-X-.-.-.-E-.-.-.-.-.-.-.-.-.-.-,-X-----------------------------------------------
--------------------------------------------------------------------------------------------------------------------------------------------------------------------------------------------,-X-X-X-X-X-X-X-X-X-X-X-X-X-X-X-------------------------------------------------
