--------------------------------------------------------------,-X-X-X-X-X-------------------------------------------------------
--------------------------------------------------------------,-X-.-K-.-X-------------------------------------------------------
--------------------------------------------------------------,-X-.-.-.-X-------------------------------------------------------
--------------------------------------------------------------,-X-.-E-.-X-------------------------------------------------------
--------------------------------------------------------------,-X-.-.-.-X-------------------------------------------------------
--------------------------------------------------------------,-X-.-E-.-X-------------------------------------------------------
--------------------------------------------------------------,-X-.-.-.-X-,-,-,-,-,-,-,-----------------------------------------
--------------------------------------------------------------,-X-.-E-.-X-X-X-X-X-X-X-X-----------------------------------------
--------------------------------------------------------------,-X-.-.-.-X-X-H-E-.-E-.-X-----------------------------------------
--------------------------------,-,-,-,-,-,-,-,-,-,-,-,-,-,-,-,-X-.-E-.-X-X-.-.-.-.-.-X-----------------------------------------
--------------------------------,-X-X-X-X-X-X-X-X-X1X1X1X1X-X-X-X/./././X/X-,-,-.-.-.-X-----------------------------------------
--------------------------------,-X-.-.-.-.-.-.-.-.1.1.1,1.-.-,-././W/./,/.-.-,-.-E-.-X-----------------------------------------
--------------------------------,-X-.-.-.-.-.-.-.-.1.1.1,1.-.-,-././././,/.-.-,-.-.-.-X-----------------------------------------
--------------------------------,-X-E-.-E-.-E-.-E-.1.1.1,1.-.-,-,/,/,/,/,/.-.-,-.-E-.-X-----------------------------------------
--------------------------------,-X-.-.-.-.-.-.-.-.1.1.1,1.-.-.-.-.-.-.-.-.-.-,-.-.-.-X-----------------------------------------
--------------------------------,-X-.-.-.-.-.-X-X-X1X1X1X1.-.-.-.-.-E-.-.-.-.-,-.0.0.0X0----------------------------------------
----,-,-,-,-,-------------------,-X-.-.-.-.-.-X-------,-X-.-.-.-.-.-.-.-.-.-.-,-.0.0.0X0----------------------------------------
----,-X3X3X3X3------------------,-X-.-.-.-.-.-X-------,-X-.-.-.-E-.-E-.-E-.-.-,-.0.0.0X0----------------------------------------
----,-X3.3.3X3------------------,-X-.-.-.-.-.-X-------,-X-.-.-.-.-.-.-.-.-.-.-,-.0.0.0X0----------------------------------------
----,-X3.3.3X3------------------,-X-.-.-.-.-.-X-------,-X-.-.-.-.-.-E-.-.-.-.-,-.-E-.-X-----------------------------------------
----,-X3,3H3X3------------------,-X-.-.-.-.-.-X-------,-X-.-.-.-.-.-.-.-.-.-.-,-.-.-.-X-----------------------------------------
----,-X-.-.-X-----,-,-,---------,-X-.-.-.-.-.-X-------,-X-.-.-.-.-.-.-.-.-.-.-,-.-.-H-X-----------------------------------------
----,-X-.-H-X---,-,-X~X-,-,-,-,-,-X-E-.-E-.-.-X-------,-X-X-X-X-.-.-.-.-.-X-X-X-X-X-X-X-----------------------------------------
----,-X-.-H-X-,-,-X~.~.~X~X~X-X-,-X-.-.-.-.-.-X-------,-,-,-,-X-X-L-L-L-X-X-,-,-,-,-,-,-----------------------------------------
----,-X-.-.-X-,-X~.~.~.~.~.~.~.~X~X-.-.-.-.-,-X-,-,---,-X-X-X-X-.-.-.-.-.-X-X-X-X-X-X-X-,-,-------------------------------------
----,-X-.-W-X-X~.~.~.~.~.~.~.~.~.~,~,-.-.-,-,-.~X~X-,-,-X-.-.-.-.-.-.-.-.-.-.-.-,-,-,-.-X-X-,-----------------------------------
----,-X-,-,-X-X~.~.~.~.~.~.~.~.~.~.~,~.-E-,-.~.~.~.~X~X-X-.-.-.-.-.-.-.-.-.-.-.-,-,-,-.-,-,-X-,-,-------------------------------
----,-X~.~.~X~X~.~.~.~.~.~.~.~.~.~.~,~.-.-,-.~.~.~.~.~.~X~.-E-.-.-E-.-.-E-.-.-E-,-,-<-.-,-,-,-X-X-,-----------------------------
----,-X~.~.~X~X~.~.~.~.~.~.~.~.~.~.~,~.-.-,-.~.~.~.~.~.~.~.-.-.-.-.-.-.-.-,-,-,-,-,-,-.-,-.-,-,-,-X-------,-,-,-,-,-,-,-,-,-,-,-
,-,-,-X~.~.~X~X~.~.~.~.~.~.~.~.~.~.~,~.-K-,-.~.~.~.~.~.~.~.-.-.-.-X-X-X-X-X-X-.-X-X-X-X-X-X-,-,-,-,-X---,-,-X-X-X-X-X-X-X-X-X-X-
X~X~X~X~.~.~X~X~.~.~.~.~.~.~.~.~.~.~,~,-,-,-.~.~.~.~.~.~.~.-.-<-.-X-------,-X4X4X4--------,-X-.-.-.-X-,-X-X-.-,-,-.-.-,-.-.-.-X-
X~.~.~.~.~.~.~.~.~.~.~.~.~.~.~.~.~.~.~.~.~.~.~.~.~.~.~.~.~.-.-.-.-X-----------------------,-X-,-,-K-X-X-.-.-,-:-.-.-.-,-.-.-.-X-
X~.~.~.~.~.~.~.~.~.~.~.~.~.~.~.~.~.~.~.~.~.~.~.~.~.~.~.~X~.-.-<-.-X-----------------------,-X-.-.-,-X-.-.-.-,-.-.-.-,-,-.-.-.-X-
X~X~X~X~.~.~.~.~.~.~.~.~.~.~.~.~.~.~.~.~.~.~.~.~.~.~,~X~X~.-.-.-.-X-----------------------,-X-.-<-,-.-.-:-,-,-.-.-,-,-.-.-.-.-X-
------,-X~.~.~.~.~.~.~.~.~.~.~.~.~.~.~.~.~.~.~.~,~X~X-,-X-.-H-.-.-X-----------------------,-X-.-.-,-.-.-.-,-.-.-.-,-,-.-.-.-.-X-
------,-X-.~.~.~.~.~.~.~.~.~.~.~.~.~.~.~.~.~.~X~X-,-,-,-X-.-.-.-.-X-----------------------,-X-.-W-,-.-.-.-,-,-.-.-.-,-,-.-.-.-X-
--------,-X-.~.~.~.~.~.~.~.~.~.~.~.~.~,~,~X~X~X-X-X-X-X-X-.-H-.-.-X-----------------------,-X-.-.-,-.-.-.-.-,-.-.-.-.-,-.-.-.-X-
----------,-X~.~.~.~.~.~.~.~.~.~.~,~X~X-X-X-X-.-.-.-.-.-.-.-.-.-.-X-----------------------,-X-.-<-,-.-.-.-E-,-.-.-.-,-,-.-E-.-X-
------------,-X~.~.~.~.~.~.~.~.~.~,~X2X2X2H-,-<-,-H-.-.-.-A-.-W-.-X-----------------------,-X-,-,-,-X-X-X-,-,-.-.-,-,-.-.-.-.-X-
------------,-X-.~.~.~.~.~.~.~.~.~,~.2<2.2.-.-.-X-X-X-X-X-.-.-.-.-X-----------------,-,-,-,-X-,-.-.-X-,-,-X-X-X-.-,-.-.-.-.-:-X-
--------------,-X~.~.~.~.~.~.~.~.~,~.2.2.2H-.-.-X-----,-X-.-H-.-.-X---------------,-,-X-X-X-,-,-,-,-X---------,-X-X-X-X-X-X-X-X-
----------------X-.~.~.~.~.~.~.~.~,~X2X2X2X-X-X-X-,-,-,-X-.-.-.-.-X-,-,-,-,-,-,-,-,-X-.-,-,-,-,-,-X-,---------------------------
----------------,-X~.~.~.~.~.~.~,~X~----,-X~X~X~X~X~X~X~X~.-H-.-.-X-X-X-X-X-X-X-X-X-,-,-,-.-,-.-,-X-----------------------------
------------------X-.~.~,~,~X~X~X~------,-X~.~.~.~.~.~.~,~.-.-.-.-.-.-.-E-.-.-E-,-,-.-,-,-.-,-X-X-------------------------------
------------------,-X~X-X-X-------------,-X~.~.~.~.~.~.~,~.-E-.-.-E-.-.-.-.-.-.-,-,-.-,-,-X-X-----------------------------------
----------------------------------------,-X~.~.~.~.~.~.~,~,-,-,-.-.-.-.-E-,-,-E-,-,-X-X-X---------------------------------------
----------------------------------------,-X~.~.~.~.~.~.~,~,-,-X-XT+T+T+TXT,-,-,-,-X-,-,-,-,-,-----------------------------------
----------------------------------------,-X~.~.~.~.~.~.~.~.~.~X~X-.-.-,-X~.~.~.~.~X~X~X~X~X~X~,-,-------------------------------
----------------------------------------,-X~.~.~.~.~.~.~.~.~.~X~X-E-.-,-X~.~.~.~.~.~.~.~.~.~.~X~,-,-----------------------------
----------------------------------------,-X~.~.~.~.~.~.~.~.~.~X~X-.-.-,-X~.~.~.~.~.~.~.~.~.~.~.~X~X-,---------------------------
----------------------------------------,-X~.~.~.~.~.~.~.~.~.~,~,-E-.-,-.~.~.~.~.~.~.~.~.~.~.~.~.~.~X~--------------------------
----------------------------------------,-X~.~.~.~.~.~.~.~.~.~,~,-.-.-<-.~.~.~.~.~.~.~.~.~.~.~.~.~.~X~--------------------------
----------------------------------------,-X~.~.~.~.~.~.~.~.~.~,~,-E-.-,-.~.~.~.~.~.~.~.~.~.~.~.~.~.~X~--------------------------
----------------------------------------,-X~.~.~.~.~.~.~.~.~.~,~,-.-.-,-.~.~.~.~.~.~.~.~.~.~.~.~.~.~X~--------------------------
----------------------------------------,-X~.~.~.~.~.~.~.~.~.~,~,-E-.-,-.~.~.~.~.~.~.~.~.~.~.~.~.~.~X~--------------------------
------------------------------------------,-X~.~.~.~.~.~.~.~,~X~X-.-.-,-X~.~.~.~.~.~.~.~.~.~.~.~.~.~X~--------------------------
--------------------------------------------,-X~.~.~.~.~.~,~X~,-X-E-,-,-X~.~.~.~.~.~.~.~.~.~.~.~.~.~X~--------------------------
--------------------------------------------,-X-.~.~.~.~.~X~,-,-X-.-.-.-X-.~.~.~.~.~.~.~.~.~.~.~.~.~X~--------------------------
----------------------------------------------,-X-.~.~.~,~X-,-X-X-X-L-X-X-.~.~.~.~.~.~.~.~.~.~.~.~.~X~--------------------------
------------------------------------------------,-X~X~X~X~,-,-X-.-.-E-.-X-X~.~.~.~.~.~.~.~.~.~.~,~X~X~--------------------------
--------------------------------------------------,-X-X-X-X-X-X-E-.-.-.-X-X-.~.~.~.~.~.~.~.~,~X~X-------------------------------
--------------------------------------------------,-X-W-.-.-.-+-.-E-.-E-X-,-X~X~X~X~X~X~X~X~X-----------------------------------
--------------------------------------------------,-X-X-X-X-X-X-.-.-.-.-X-------------------------------------------------------
------------------------------------------------------------,-X-E-.-.-E-X-------------------------------------------------------
------------------------------------------------------------,-X-X-X...X.X-------------------------------------------------------
----------------------------------------------------------------,-X.,.X.--------------------------------------------------------
----------------------------------------------------------------,-X...X.--------------------------------------------------------
----------------------------------------------------------------,-X-E-X---------------------------------------------------------
----------------------------------------------------------------,->->->---------------------------------------------------------
