----------------------------------------------------------------------------------------,-X-X-X-X-X-X-X-------------------------------------------------------------------------------------
----------------------------------------------------------------------------------------,-X-A-.-<-.-A-X-------------------------------------------------------------------------------------
----------------------------------------------------------------------------------------,-X-.-.-.-.-.-X-------------------------------------------------------------------------------------
----------------------------------------------------------------------------------------,-X-.-.-.-.-.-X-------------------------------------------------------------------------------------
----------------------------------------------,-,-,-,-,-,-,-,-,-,-,-,-,-,-------,-,-,-,-,-X-.-.-.-.-.-X---------------,-,-,-,-,-,-,-,-,-,-,-,-,-,-------------------------------------------
----------------------------------------------,-X~X~X~X~X~X~X~X~X~X~X~X~X~------,-X-X-X-X-X-.-.-.-.-.-X---------------,-X~X~X~X~X~X~X~X~X~X~X~X~X~------------------------------------------
----------------------------------------------,-X~.~.~.~.~.~.~.~.~.~.~.~X~------,-X-.-.-.-X-.-.-.-.-.-X---------------,-X~.~.~.~.~.~.~.~.~.~.~.~X~------------------------------------------
----------------------------------------------,-X~.~.~.~.~.~.~.~.~.~.~.~X~------,-X-.-.-.-X-.-.-.-.-.-X---------------,-X~.~.~.~.~.~.~.~.~.~.~.~X~------------------------------------------
----------------------------------------------,-X~.~.~.~.~.~.~.~.~.~.~.~X~------,-X-.-E-.-X-X-+-+-+-X-X---------------,-X~.~.~.~.~.~.~.~.~.~.~.~X~------------------------------------------
----------------------------------------------,-X~.~.~.~.~.~.~.~.~.~.~.~X~------,-X-.-.-.-X-X-+-+-+-X-X---------------,-X~.~.~.~.~.~.~.~.~.~.~.~X~------------------------------------------
----------------------------------------------,-X~.~.~.~.~.~.~.~.~.~.~.~X~------,-X-.-.-.-+-.-.-.-.-.-X---------------,-X~.~.~.~.~.~.~.~.~.~.~.~X~------------------------------------------
----------------------------------------------,-X~.~.~.~.~.~.~.~.~.~.~.~X~------,-X-.-E-.-+-.-.-.-.-.-X---------------,-X~.~.~.~.~.~.~.~.~.~.~.~X~------------------------------------------
------------------------------,-,-,-,-,-,-,-,-,-X~.~.~.~.~.~.~.~.~.~.~.~X~,-,-,-,-X-X-X-X-X-.-.-.-.-.-X-,-,-,-,-,-,-,-,-X~.~.~.~.~.~.~.~.~.~.~.~X~,-,-,-,-,-,-,-,---------------------------
------------------------------,-X~X~X~X~X~X~X~X~X~.~.~.~.~.~.~.~.~.~.~.~X~X~X~X~X~X~X~X~X~X-.-.-.-.-.-X-X-X~X~X~X~X~X~X~X~.~.~.~.~.~.~.~.~.~.~.~X~X~X~X~X~X~X~X~X~--------------------------
------------------------------,-X~.~.~.~.~.~.~.~.~.~.~.~.~.~.~.~.~.~.~.~.~.~.~.~.~.~.~.~,~,-.-.-.-.-.-,-,-.~.~.~.~.~.~.~.~.~.~.~.~.~.~.~.~.~.~.~.~.~.~.~.~.~.~.~X~--------------------------
------------------------------,-X~.~.~.~.~.~.~.~.~.~.~.~.~.~.~.~.~.~.~.~.~.~.~.~.~.~.~.~,~,-.-.-.-.-.-,-,-.~.~.~.~.~.~.~.~.~.~.~.~.~.~.~.~.~.~.~.~.~.~.~.~.~.~.~X~--------------------------
------------------------------,-X~.~.~.~.~.~.~.~.~.~.~.~.~.~.~.~.~.~.~.~.~.~.~.~.~.~.~.~,~,-.-.-.-.-.-,-,-.~.~.~.~.~.~.~.~.~.~.~.~.~.~.~.~.~.~.~.~.~.~.~.~.~.~.~X~--------------------------
------------------------------,-X~.~.~.~.~.~.~.~.~.~.~.~.~.~.~.~.~.~.~.~.~.~.~.~.~.~.~.~,~,-.-.-.-.-.-,-,-.~.~.~.~.~.~.~.~.~.~.~.~.~.~.~.~.~.~.~.~.~.~.~.~.~.~.~X~--------------------------
------------------------------,-X~.~.~.~.~.~.~.~.~.~.~.~.~.~.~.~.~.~.~.~.~.~.~.~.~.~.~.~,~,-.-.-.-.-.-,-,-.~.~.~.~.~.~.~.~.~.~.~.~.~.~.~.~.~.~.~.~.~.~.~.~.~.~.~X~--------------------------
------------------------------,-X~.~.~.~.~.~.~.~.~.~.~.~.~.~.~.~.~.~.~.~.~.~.~.~.~.~.~.~,~,-.-.-E-.-.-,-,-.~.~.~.~.~.~.~.~.~.~.~.~.~.~.~.~.~.~.~.~.~.~.~.~.~.~.~X~--------------------------
------------------------------,-X~.~.~.~.~.~.~.~.~.~.~.~.~.~.~.~.~.~.~.~.~.~.~.~.~.~.~.~,~,-.-.-.-.-.-,-,-.~.~.~.~.~.~.~.~.~.~.~.~.~.~.~.~.~.~.~.~.~.~.~.~.~.~.~X~--------------------------
------------------------------,-X~.~.~.~.~.~.~.~.~.~.~.~.~.~.~.~.~.~.~.~.~.~.~.~.~.~.~.~,~,-.-.-.-.-.-,-,-.~.~.~.~.~.~.~.~.~.~.~.~.~.~.~.~.~.~.~.~.~.~.~.~.~.~.~X~--------------------------
------------------------------,-X~.~.~.~.~.~.~.~.~.~.~.~.~.~.~.~.~.~.~.~.~.~.~.~.~.~.~.~,~,-.-.-.-.-.-,-,-.~.~.~.~.~.~.~.~.~.~.~.~.~.~.~.~.~.~.~.~.~.~.~.~.~.~.~X~--------------------------
------------------------------,-X~.~.~.~.~.~.~.~.~.~.~.~.~.~.~.~.~.~.~.~.~.~.~.~.~.~.~.~,~,-.-.-E-.-.-,-,-.~.~.~.~.~.~.~.~.~.~.~.~.~.~.~.~.~.~.~.~.~.~.~.~.~.~.~X~--------------------------
------------------------------,-X~.~.~.~.~.~.~.~.~.~.~.~.~.~.~.~.~.~.~.~.~.~,~,~,~,~,~,~,~,-.-.-.-.-.-,-,-,~,~,~,~,~,~.~.~.~.~.~.~.~.~.~.~.~.~.~.~.~.~.~.~.~.~.~X~--------------------------
------------------------------,-X~X~X~X~X~X~X~X~X~.~.~.~.~.~.~.~.~.~.~.~X~X~X~X-X2X2X2X-X-X-E-.-E-.-E-X-X-X-X1X1X1X-X-X~X~.~.~.~.~.~.~.~.~.~.~.~X~X~X~X~X~X~X~X~X~--------------------------
----------------------------------------------,-X~.~.~.~.~.~.~.~.~.~.~.~X~,-X-.-.-.-.-.-.-X-.-.-.-.-.-X-X-.-.-.-.-.-.-X-X~.~.~.~.~.~.~.~.~.~.~.~X~------------------------------------------
----------------------------------------------,-X~.~.~.~.~.~.~.~.~.~.~.~X~,-X-.-.-A-.-.-.-X-E-.-E-.-E-X-X-.-.-A-.-.-.-X-X~.~.~.~.~.~.~.~.~.~.~.~X~------------------------------------------
----------------------------------------------,-X~.~.~.~.~.~.~.~.~.~.~.~X~,-X-.-.-.-.-.-.-X-.-.-W-.-.-X-X-.-.-.-.-.-.-X-X~.~.~.~.~.~.~.~.~.~.~.~X~------------------------------------------
----------------------------------------------,-X~.~.~.~.~.~.~.~.~.~.~.~X~,-X-.-.-.-E-.-.-X-X-+-+-+-X-X-X-.-E-.-.-.-.-X-X~.~.~.~.~.~.~.~.~.~.~.~X~------------------------------------------
----------------------------------------------,-X~.~.~.~.~.~.~.~.~.~.~.~X~,-X-.-.-.-.-.-.-X-.-.-.-.-.-X-X-.-.-.-.-.-.-X-X~.~.~.~.~.~.~.~.~.~.~.~X~------------------------------------------
----------------------------------------------,-X~.~.~.~.~.~.~.~.~.~.~.~X~,-X-.-E-.-.-.-.-X-.-.-.-.-.-X-X-.-.-.-E-.-.-X-X~.~.~.~.~.~.~.~.~.~.~.~X~------------------------------------------
----------------------------------------------,-X~,~,~,~,~,~,~,~,~,~,~,~X~,-X-.-.-.-.-.-.-X-.-.-.-.-.-X-X-.-.-.-.-.-.-X-X~,~,~,~,~,~,~,~,~,~,~,~X~------------------------------------------
--------------------------------------------,-,-X-,-,-,-,-,-,-,-,-,-,-,-X---X-.-.-.-E-.-.-X-.-.-.-.-.-X-X-.-E-.-.-.-.-X-X-,-,-,-,-,-,-,-,-,-,-,-X-,-----------------------------------------
--------,-,-,-,-,-,-,-,-,-,-,-,-,-,-,-,-,-,-,-X-.-.-.-.-.-.-.-.-.-.-.-.-.-X-,-X-.-.-.-X-X-X-.-.-.-.-.-X-,-X-.-.-.-X-X-X-.-.-.-.-.-.-.-.-.-.-.-.-.-X-,-,-,-,-,-,-,-,-,-,-,-,-,-,-,-,-,-,-,---
------,-,-X-X-X-X-X-X-X-X-X-X-X-X-X-X-,-X-X-X-.-.-.-.-.-.-.-.-.-.-.-.-.-.-.-X-XQ+Q+Q+QXQX-X-.-.-.-.-.-X-X-XP+P+P+PXPX-.-.-.-.-.-.-.-.-.-.-.-.-.-.-.-X-X-X-,-X-X-X-X-X-X-X-X-X-X-X-X-X-X-X-,-
------,-X-.-.-.-.-.-.-.-.-.-.-.-.-.-.-X-XS.-.-.-.-.-.-.-.-.-.-.-.-.-.-.-.-.-.-.-.-.-.-.-.-.-.-.-.-.-.-.-.-.-.-.-.-.-.-.-.-.-.-.-.-.-.-.-.-.-.-.-.-.-.-.-X-X-.-.-.-.-.-.-.-.-.-.-.-.-.-.-.-X-
------,-X4.-.-.-.-.-E-.-.-.-E-.-E-.-E-.-+S.-.-.-.-.-.-.-.-.-.-.-.-.-.-.-.-.-.-.-E-.-.-.-.-.-.-.-t/.-.-.-.-.-.-.-E-.-.-.-.-.-.-.-.-.-.-.-.-.-.-.-.-.-.-.-.-.-.-.-E-.-.-.-E-.-.-.-E-.-.-.-.-X3
------,-X4.-.-.-.-.-.-.-.-.-.-.-.-.-.-.-+S.-.-.-.-.-.-.-.-.-.-.-.-.-.-.-.-.-.-.-.-.-.-.-.-.-.-.-.-.-.-.-.-.-.-.-.-.-.-.-.-.-.-.-.-.-.-.-.-.-.-.-.-.-.-.-.-.-.-.-.-.-.-.-.-.-.-.-.-.-.-.-.-X3
------,-X4.-E-.-.-.-.-.-.-.-E-.-E-.-E-.-+S.-.-.-.-.-.-.-.-.-.-.-.-.-.-.-.-.-.-.-.-.-E-.-.-.-.-.-.-.-.-.-.-.-E-.-.-.-.-.-.-.-.-.-.-.-.-.-.-.-.-.-.-.-.-.-.-.-.-.-.-.-E-.-.-.-E-.-.-.-E-A-.-X3
------,-X-.-.-.-.-.-.-.-.-.-.-.-.-.-,-X-XS.-.-.-.-.-.-.-.-.-.-.-.-.-.-.-.-.-.-.-.-.-.-.-.-.-.-.-.-.-.-.-.-.-.-.-.-.-.-.-.-.-.-.-.-.-.-.-.-.-.-.-.-.-.-.-X-X-.-.-.-.-.-.-.-.-.-.-.-.-.-.-,-X-
--------,-X-X-X-X-X-X-X-X-X-X-X-X-X-X-,-X-.-.-.-.-.-.-.-.-.-.-.-.-.-.-.-.-.-.-.-.-.-.-.-.-.-.-.-.-.-.-.-.-.-.-.-.-.-.-.-.-.-.-.-.-.-.-.-.-.-.-.-.-.-.-.-X-,-X-X-X-X-X-X-X-X-X-X-X-X-X-X-X---
--------,-,-,-,-,-,-,-,-,-,-,-,-,-,-,-,-X-.-.-.-.-.-.-.-.-.-.-.-.-.-.-.-.-.-.-.-.-.-.-.-.-.-.-.-.-.-.-.-.-.-.-.-.-.-.-.-.-.-.-.-.-.-.-.-.-.-.-.-.-.-.-.-X-,-,-,-,-,-,-,-,-,-,-,-,-,-,-,-,---
------,-,-X-X-X-X-X-X-X-X-X-X-X-X-X-X-,-X-.-.-.-.-.-.-.-.-.-.-.-.-.-.-.-.-.-.-.-.-.-.-.-.-.-.-.-.-.-.-.-.-.-.-.-.-.-.-.-.-.-.-.-.-.-.-.-.-.-.-.-.-.-.-.-X-,-X-X-X-X-X-X-X-X-X-X-X-X-X-X-X-,-
------,-X-.-.-.-.-.-.-.-.-.-.-.-.-.-.-X-XU.-.-.-.-.-.-.-.-.-.-.-.-.-.-.-.-.-.-.-.-.-.-.-.-.-.-.-.-.-.-.-.-.-.-.-.-.-.-.-.-.-.-.-.-.-.-.-.-.-.-.-.-.-.-.-X-X-.-.-.-.-.-.-.-.-.-.-.-.-.-.-.-X-
------,-X..-E-.-.-.-.-.-.-.-E-.-E-.-E-.-+U.-.-.-.-.-.-.-.-.-.-.-.-.-.-.-.-.-.-.-.-.-.-.-.-.-.-.-.-.-.-.-.-.-.-.-.-.-.-.-.-.-.-.-.-.-.-.-.-.-.-.-.-.-.-.-.-.-.-.-.-.-E-.-.-.-E-.-.-.-E-.-.-X5
------,-X..-.-.-.-.-.-.-.-.-.-.-.-.-.-.-+U.-.-.-.-.-.-.-.-.-.-.-.-.-.-.-.-.-.-.-.-.-.-.-.-.-.-.-.-.-.-.-.-.-.-.-.-.-.-.-.-.-.-.-.-.-.-.-.-.-.-.-.-.-.-.-.-.-.-.-.-.-.-.-.-.-.-.-.-.-.-.-.-X5
------,-X.A-.-.-.-.-E-.-.-.-E-.-E-.-E-.-+U.-.-.-.-.-.-.-.-.-.-.-.-.-.-.-.-.-.-.-.-.-.-.-.-.-.-.-A-.-.-.-.-.-.-.-.-.-.-.-.-.-.-.-.-.-.-.-.-.-.-.-.-.-.-.-.-.-.-.-E-.-.-.-E-.-.-.-E-.-.-.-.-X5
------,-X-.-.-.-.-.-.-.-.-.-.-.-.-.-,-X-XUA-,-,-,-,-,-.-.-.-.-.-.-.-.-.-.-.-.-.-.-.-.-.-.-.-.-.-.-.-.-.-.-.-.-.-.-.-.-.-.-.-.-.-.-.-.-.-.-,-,-,-,-,-,-A-X-X-.-.-.-.-.-.-.-.-.-.-.-.-.-A-,-X-
--------,-X-X-X-X-X-X-X-X-X-X-X-X-X-X-,-X-X-X-.-.-.-X-X-X-.-H-.-.-.-.-.-.-.-.-.-.-.-.-.-.-.-.-.-.-.-.-.-.-.-.-.-.-.-.-.-.-.-.-.-.-.-H-,-X-X-X-.-.-.-X-X-X-,-X-X-X-X-X-X-X-X-X-X-X-X-X-X-X---
--------,-,-,-,-,-,-,-,-,-,-,-,-,-,-,-----,-X-.-A-.-X---,-X-.-.-.-.-.-.-.-.-.-.-.-.-.-.-.-.-.-.-.-.-.-.-.-.-.-.-.-.-.-.-.-.-.-.-.-.-,-X---,-X-.-A-.-X---------------------------------------
------,-,-X-X-X-X-X-X-X-X-X-X-X-X-X-X-,-,-,-X-.-E-.-X-,---,-X-.-.-.-.-.-.-.-.-.-.-.-.-.-.-.-.-.-.-.-.-.-.-.-.-.-.-.-.-.-.-.-.-.-.-.-X---,-,-X-.-E-.-X-,-------------------------------------
----,-,-X-.-.-.-.-.-.-.-.-.-.-.-.-.-.-X-,-X-.-.-.-.-.-X-,-,-X-.-.-.-.-.-.-.-.-.-.-.-.-.-.-.-.-.-.-.-.-.-.-.-.-.-.-.-.-.-.-.-.-.-.-,-X-,-,-X-.-.-.-.-.-X-,-,-,-,-,-,-,-,-,-,-,-,-,-,---------
----,-X-.-.-.-.-.-.-.-.-.-.-.-.-.-.-.-.-X-.-.-.-.-.-.-.-X-X-X-.-.-.-.-.-.-.-.-.-.-.-.-.-.-.-.-.-.-.-.-.-.-.-.-.-.-.-.-.-.-.-.-.-.-,-X-X-X-.-.-.-.-.-.-.-X-X-X-X-X-X-X-X-X-X-X-X-X-X-,-------
,-,-,-X-.-.-.-.-.-.-.-.-.-.-.-.-.-.-.-.-+-.-.-.-.-.-.-.-.-.-,-.-.-.-.-.-.-.-.-.-.-.-.-.-.-.-.-.-.-.-.-.-.-.-.-.-.-.-.-.-.-.-.-.-.-,-.-.-.-.-.-.-.-.-.-.-+-+-.-.-.-.-.-.-.-.-.-.-.-.-X-------
X-X-X-XV.-E-.-.-.-.-.-.-.-E-.-.-.-.-.-.-+-.-.-.-.-.-.-.-E-A-,-.-.-.-.-.-.-.-.-.-.-.-.-.-.-.-.-.-.-.-.-.-.-.-.-.-.-.-.-.-.-.-.-.-.-,-.-A-E-.-.-.-.-.-.-.-+-+-.-.-.-.-E-.-E-.-E-.-E-.-X-------
X-.-.-+V.-.-.-.-.-.-.-.-.-.-.-.-.-.-.-.-+-.-.-.-.-.-.-.-.-.-,-.-.-.-.-.-.-.-.-.-.-.-.-.-.-.-.-.-.-.-.-.-.-.-.-.-.-.-.-.-.-.-.-.-.-,-.-.-.-.-.-.-.-.-.-.-+-+-.-.-.-.-.-.-.-.-.-.-.-.-X-------
X-E-.-+V.-.-.-.-.-.-.-.-.-.-.-.-.-.-.-,-X-.-.-.-E-.-.-,-X-X-X-.-.-.-.-.-.-.-.-.-.-.-.-.-.-.-.-.-.-.-.-.-.-.-.-.-.-.-.-.-.-.-.-.-.-,-X-X-X-.-.-.-E-.-.-,-X-X-.-.-.-X-X-X-X-X-.-.-.-.-X-------
X-.-.-+V.-.-.-.-.-.-.-.-.-.-.-.-.-.-,-X-,-X-.-.-.-.-,-X---,-X-A-,-,-,-,-,-,-,-,-,-,-,-,-,-,-,-,-A-,-,-,-,-,-,-,-,-,-,-,-,-,-,-,-,-A-X---,-X-.-.-.-.-,-X-,-X-.-.-.-X/X-X-,-,-X-.-.-.-X-------
X-E-.-+V.-.-.-.-.-.-.-.-.-.-.-.-.-.-X-----,-X-.-.-.-X---,-,-X-.-.-.-.-.-.-.-.-.-.-.-.-.-.-,-.-.-.-.-,-.-.-.-.-.-.-.-.-.-.-.-.-.-.-.-X-,---,-X-.-.-.-X---,-X-.-t/t/E-.-.-X-,-X-.-.-.-X-------
X-.-.-+V.-.-.-.-.-.-.-.-.-.-.-.-.-.-X-,-,-,-X-.-.-.-X-,-,-X-.-.-.-.-.-.-.-.-.-.-.-.-.-.-.-,-,-,-,-,-,-.-.-.-.-.-.-.-.-.-.-.-.-.-.-.-.-X-,-,-X-.-.-.-X-,-,-X-t/:-.-.-.-.-.-X-X-.-.-.-X-------
X-E-.-+V.-.-.-.-.-.-.-.-.-.-.-.-.-.-X-,-X-X-X-.-.-.-X-X-X-.-.-.-.-.-.-.-.-.-.-.-E-.-E-.-E-H-.-.-.-.-,-H-E-.-E-.-E-.-.-.-.-.-.-.-.-.-.-.-X-X-X-.-.-.-X-X-X-X/.-.-.-.-.-.-E-X-X-.-.-.-X-------
X-.-.-+VE-.-.-E-.-.-E-.-.-E-.-.-E-.-X-,-X-H-.-.-.-.-.-.-.-.-.-.-.-.-.-.-.-,-,-,-,-,-,-,-,-,-,-,-,-,-,-,-,-,-,-,-,-,-,-.-.-.-.-.-.-.-.-.-.-.-.-.-.-.-.-H-X-X-.-E-:-E-.-.-.-X/X-.-.-.-X-------
,-X-X-XV.-.-.-.-.-.-.-.-.-.-.-.-.-.-X-,-X-.-E-.-.-.-.-.-.-.-.-.-.-.-.-.-.-,-.-.-,-.-,-.-,-.-,-.-.-,-.-,-.-,-.-,-.-.-,-.-.-.-.-.-.-.-.-.-.-.-.-.-.-.-E-.-X-X-.-.-.-.-.-E-t/.-.-.-.-.-X-------
----,-X-.-.-.-.-.-.-.-.-.-.-.-.-.-.-X-,-X-.-.-.-.-.-.-.-.-.-.-.-.-.-.-.-.-,-.-.-,-.-,-.-,-.-,-.-.-,-.-,-.-,-.-,-.-.-,-.-.-.-.-.-.-.-.-.-.-.-.-.-.-.-.-.-X-X-:-:-.-.-.-.-t/.-.-.-.-.-X-------
----,-X-E-.-.-E-.-.-E-.-.-E-.-.-E-,-X-,-X-.-.-.-.-.-.-.-.-.-.-.-.-.-.-.-.-,-.-.-,-.-,-.-,-.-,-.-A-,-.-,-.-,-.-,-.-.-,-.-.-.-.-.-.-.-.-.-.-.-.-.-.-.-.-.-X-X-:-E-.-E-:-E-t/.-.-.-.-.-X-------
------,-X-.-A-.-.-.-.-.-.-.-.-.-,-X---,-X-.-.-.-.-.-.-.-.-.-.-.-.-.-.-.-.-,-.-.-,-.-,-.-,-.-,-.-.-,-.-,-.-,-.-,-.-.-,-.-.-.-.-.-.-.-.-.-.-.-.-.-.-.-.-.-X-X-.-.-.-.-.-.-t/.-.-.-.-.-X-------
--------,-X-X-X-X-X6X6X6X-X-X-X-X-----,-X-.-.-.-.-.-.-.-.-.-.-.-.-.-.-.-.-,-,-,-,-,-,-,-,-,-,-,-,-,-,-,-,-,-,-,-,-,-,-.-.-.-.-.-.-.-.-.-.-.-.-.-.-.-.-.-X-X-.-.-.-.-:-.-E-X/X-.-E-.-X-------
--------------------------------------,-X-.-.-.-.-.-.-.-.-.-.-.-.-.-.-.-.-.-.-.-.-.-.-.-.-.-.-.-.-.-.-.-.-.-.-.-.-.-.-.-.-.-.-.-.-.-.-.-.-.-.-.-.-.-.-.-X-X/.-.-:-.-.-.-.-X-X-.-.-.-X-------
--------------------------------------,-X-.-A-.-.-.-.-.-.-.-.-.-.-.-.-.-.-.-E-.-E-.-E-.-E-.-E-.-.-.-E-.-E-.-E-.-E-.-E-.-.-.-.-.-.-.-.-.-.-.-.-.-.-.-A-.-X-X-t/t/.-E-:-:-E-X-X-.-E-.-X-------
--------------------------------------,-X-A-.-.-.-.-.-.-.-.-.-.-.-.-.-.-.-.-.-.-.-.-.-.-.-.-.-.-.-.-.-.-.-.-.-.-.-.-.-.-.-.-.-.-.-.-.-.-.-.-.-.-.-.-.-A-X-X-.-.-t/.-.-,-X-,-X-.-.-.-X-------
--------------------------------------,-X-X-X-X-X-X-X-X-X-X-X-X-X-X-X-X-X-X-X-X-X-X-X-X-X-X-X-.-.-.-X-X-X-X-X-X-X-X-X-X-X-X-X-X-X-X-X-X-X-X-X-X-X-X-X-X-X-X-.-.-.-X/X-X-,-,-X-.-E-.-X-------
------------------------------------------------------------------------------------------,-X-.-.-.-X-------------------------------------------------,-,-X-.-.-.-X-X-X-X-X-.-.-.-.-X-------
----------------------------------------------------------------------------------------,-,-X-.-.-.-X-------------------------------------------------,-X-.-A-.-.-.-.-.-.-.-.-.-E-.-X-------
--------------------------------------------------------------------------------,-,-,-,-,-.-X-.-A-.-,-X-,-,-,-,---------------------------------------,-X-.-.-.-.-.-.-.-.-.-.-.-.-.-X-------
------------------------------------------------------------------------------,-,-X-X-X-X-X-.-.-.-.-.-X-X-X-X-X-,-------------------------------------,-X-.-.-.-.-.-.-.-.-.-.-.-.-,-X-------
------------------------------------------------------------------------------,-X-.-.-.-.-.-.-.-.-.-.-.-.-.-.-.-X-------------------------------------,-X-.-.-.-,-X-X-X-X-X-X-X-X-X---------
------------------------------------------------------------------------------,-X-.-E-.-.-.-.-.-.-.-.-.-.-.-E-.-X-------------------------------------,-X-.-.-.-X---------------------------
------------------------------------------------------------------------------,-X-.-.-.-.-.-.-.-.-.-.-.-.-.-.-.-X-------------------------------------,-X-.-.-.-X---------------------------
------------------------------------------------------------------------------,-X-.-.-.-.-.-.-.-.-.-.-.-.-.-.-.-X-------------------------------------,-X-.-E-.-X---------------------------
------------------------------------------------------------------------------,-X-.-.-.-.-.-.-.-.-.-.-.-.-.-.-.-X-------------------------------------,-X-.-.-.-X---------------------------
------------------------------------------------------------------------------,-X-.-.-.-.-.-.-.-.-.-.-.-.-.-.-.-X-------------------------------------,-X-.-E-.-X---------------------------
------------------------------------------------------------------------------,-X-.-.-.-.-.-.-.-.-.-.-.-.-.-.-.-X-------------------------------------,-X-.-.-.-X---------------------------
------------------------------------------------------------------------------,-X-.-.-.-.-.-.-.-.-.-.-.-.-.-.-.-X-------------------------------------,-X-.-E-.-X---------------------------
------------------------------------------------------------------------------,-X-.-E-.-.-.-.-.-E-.-.-.-.-.-E-.-X-------------------------------------,-X-.-.-.-X---------------------------
------------------------------------------------------------------------------,-X-.-.-.-.-.-.-.-.-.-.-.-.-.-.-,-X-------------------------------------,-X-.-E-,-X---------------------------
--------------------------------------------------------------------------------,-X-X-X-X-X-.-E-.-E-,-X-X-X-X-X-----------------------------------------,-X0X0X0----------------------------
------------------------------------------------------------------------------------------,-X-.-.-.-X---------------------------------------------------------------------------------------
------------------------------------------------------------------------------------------,-X-.-E-.-X---------------------------------------------------------------------------------------
------------------------------------------------------------------------------------------,-X-.-.-.-X---------------------------------------------------------------------------------------
------------------------------------------------------------------------------------------,-X-E-.-E-X---------------------------------------------------------------------------------------
------------------------------------------------------------------------------------------,-X-.-.-,-X---------------------------------------------------------------------------------------
--------------------------------------------------------------------------------------------,->->->-----------------------------------------------------------------------------------------
