X-X-X-X-X-X-X-X-X-X-X-X-X-X-X-X-X-X-X-X-X-X-X-X-X-X-X-X-X-X-X-X-X-X-X-X-X-X-X-X-X-X-X-X-X-X-X-X-X-X-X-X-X-X-X-X-X-X-X-X-X-X-X-X-X-----------------------------------------------------------------------------------
X-.-.-.-.-.-.-.-.-.-.-.-.-.-.-.-.-.-.-.-.-.-.-.-.-.-.-.-.-.-.-.-.-.-.-.-.-.-.-.-.-.-.-.-.-.-.-.-.-.-.-.-.-.-.-.-.-.-.-.-.-.-.-.-X-----------------------------------------------------------------------------------
X-.-A-.-.-.-.-.-.-.-.-.-.-.-.-.-.-.-.-.-.-.-.-.-.-.-.-.-.-.-.-.-.-.-.-.-.-.-.-.-.-.-.-.-.-.-.-.-.-.-.-.-.-.-.-.-.-.-.-.-.-.-A-.-X-----------------------------------------------------------------------------------
X-.-.-.-.-.-.-.-.-.-.-.-.-.-.-.-.-.-.-.-.-.-.-.-.-.-.-.-.-.-.-.-.-.-.-.-.-.-.-.-.-.-.-.-.-.-.-.-.-.-.-.-.-.-.-.-.-.-.-.-.-.-.-.-X-----------------------------------------------------------------------------------
X-.-.-.-.-.-.-.-.-.-.-.-.-.-.-.-.-.-.-.-.-.-.-.-.-.-.-.-.-.-.-.-.-.-.-.-.-.-.-.-.-.-.-.-.-.-.-.-.-.-.-.-.-.-.-.-.-.-.-.-.-.-.-.-X-----------------------------------------------------------------------------------
X-.-.-.-.-.-.-.-.-.-.-.-.-.-.-.-.-.-.-.-.-.-.-.-.-.-.-.-.-.-.-.-.-.-.-.-.-.-.-.-.-.-.-.-.-.-.-.-.-.-.-.-.-.-.-.-.-.-.-.-.-.-.-.-X-----------------------------------------------------------------------------------
X-.-.-.-.-.-.-.-.-.-.-.-.-.-.-.-.-.-.-.-.-.-.-.-.-.-.-.-.-.-.-.-.-.-.-.-.-.-.-.-.-.-.-.-.-.-.-.-.-.-.-.-.-.-.-.-.-.-.-.-.-.-.-.-X-----------------------------------------------------------------------------------
X-.-.-.-.-.-.-.-.-.-.-.-.-.-.-.-.-.-.-.-.-.-.-.-.-.-.-.-.-.-.-.-.-.-.-.-.-.-.-.-.-.-.-.-.-.-.-.-.-.-.-.-.-.-.-.-.-.-.-.-.-.-.-.-X-----------------------------------------------------------------------------------
X-.-.-.-.-.-.-.-.-.-.-.-.-.-.-.-.-.-.-.-.-.-.-.-E-.-.-.-.-.-.-.-.-.-.-.-.-.-.-.-E-.-.-.-.-.-.-.-.-.-.-.-.-.-.-.-E-.-.-.-.-.-.-.-X-----------------------------------------------------------------------------------
X-.-.-.-.-.-.-.-.-.-.-.-.-.-.-.-.-.-.-.-.-.-.-.-.-.-.-.-.-.-.-.-.-.-.-.-.-.-.-.-.-.-.-.-.-.-.-.-.-.-.-.-.-.-.-.-.-.-.-.-.-.-.-.-X-----------------------------------------------------------------------------------
X-.-.-.-.-.-.-.-.-.-.-.-.-.-.-.-.-.-.-.-.-.-.-.-.-.-.-.-.-.-.-.-.-.-.-.-.-.-.-.-.-.-.-.-.-.-.-.-.-.-.-.-.-.-.-.-.-.-.-.-.-.-.-.-X-----------------------------------------------------------------------------------
X-.-.-.-.-.-.-.-.-.-.-.-.-.-.-.-.-.-.-.-.-.-.-.-.-.-.-.-.-.-.-.-.-.-.-.-.-.-.-.-.-.-.-.-.-.-.-.-.-.-.-.-.-.-.-.-.-.-.-.-.-.-.-.-X-----------------------------------------------------------------------------------
X-.-.-.-.-.-.-.-.-.-.-.-.-.-.-.-.-.-.-.-.-.-.-.-.-.-.-.-.-.-.-.-.-.-.-.-.-.-.-.-.-.-.-.-.-.-.-.-.-.-.-.-.-.-.-.-.-.-.-.-.-.-.-.-X-----------------------------------------------------------------------------------
X-.-.-.-.-.-.-.-.-.-.-.-.-.-.-.-.-.-.-.-.-.-.-.-.-.-.-.-.-.-.-.-.-.-.-.-.-.-.-.-.-.-.-.-.-.-.-.-.-.-.-.-.-.-.-.-.-.-.-.-.-.-.-.-X-----------------------------------------------------------------------------------
X-.-.-.-.-.-.-.-.-.-.-.-.-.-.-.-.-.-.-.-.-.-.-.-.-.-.-.-.-.-.-.-.-.-.-.-.-.-.-.-.-.-.-.-.-.-.-.-.-.-.-.-.-.-.-.-.-.-.-.-.-.-A-.-X-----------------------------------------------------------------------------------
X-.-.-.-.-.-.-.-.-.-.-.-.-.-.-.-.-.-.-.-.-.-.-.-.-.-.-.-.-.-.-.-.-.-.-.-.-.-.-.-.-.-.-.-.-.-.-.-.-.-.-.-.-.-.-.-.-.-.-.-.-.-.-.-X-----------------------------------------------------------------------------------
X-.-.-.-.-.-.-.-E-.-.-.-.-.-.-.-X-X-X-X-X-X-X-X-X-X-X-X-X-X-X-X-X-X-X-X-X-X-X-X-X-X-X-X-X-X-X-X-X-X-X-X-X-X-X-X-X-X-X-X-X-X-X-X-X-----------------------------------------------------------------------------------
X-.-.-.-.-.-.-.-.-.-.-.-.-.-.-.-X-----------------------------------------------------------------------------------------------------------------------------------------------------------------------------------
X-.-.-.-.-.-.-.-.-.-.-.-.-.-.-.-X-----------------------------------------------------------------------------------------------------------------------------------------------------------------------------------
X-.-.-.-.-.-.-.-.-.-.-.-.-.-.-.-X-----------------------------------------------------------------------------------------------------------------------------------------------------------------------------------
X-.-.-.-.-.-.-.-.-.-.-.-.-.-.-.-X-----------------------------------------------------------------------------------------------------------------------------------------------------------------------------------
X-.-.-.-.-.-.-.-.-.-.-.-.-.-.-.-X-----------------------------------------------------------------------------------------------------------------------------------------------------------------------------------
X-.-.-.-.-.-.-.-.-.-.-.-.-.-.-.-X-----------------------------------------------------------------------------------------------------------------------------------------------------------------------------------
X-.-.-.-.-.-.-.-.-.-.-.-.-.-.-.-X-----------------------------------------------------------------------------------------------------------------------------------------------------------------------------------
X-.-.-.-.-.-.-.-.-.-.-.-.-.-.-.-X-----------------------------------------------------------------------------------------------------------------------------------------------------------------------------------
X-.-.-.-.-.-.-.-.-.-.-.-.-.-.-.-X-----------------------------------------------------------------------------------------------------------------------------------------------------------------------------------
X-.-.-.-.-.-.-.-.-.-.-.-.-.-.-.-X-----------------------------------------------------------------------------------------------------------------------------------------------------------------------------------
X-.-.-.-.-.-.-.-.-.-.-.-.-.-.-.-X-----------------------------------------------------------------------------------------------------------------------------------------------------------------------------------
X-.-.-.-.-.-.-.-.-.-.-.-.-.-.-.-X-----------------------------------------------------------------------------------------------------------------------------------------------------------------------------------
X-.-.-.-.-.-.-.-.-.-.-.-.-.-.-.-X-----------------------------------------------------------------------------------------------------------------------------------------------------------------------------------
X-.-.-.-.-.-.-.-.-.-.-.-.-.-.-.-X-----------------------------------------------------------------------------------------------------------------------------------------------------------------------------------
X-.-.-.-.-.-.-.-.-.-.-.-.-.-.-.-X-----------------------------------------------------------------------------------------------------------------------------------------------------------------------------------
X-.-.-.-.-.-.-.-E-.-.-.-.-.-.-.-X-------------------------------X-X-X-X-X-X-X-X-X-X-X-X-X-X-X-X-X-X-X-X-X-X-X-X-X-X-X-X-X-X-X-X-X-X-X-X-X-X-X-X-X-X-X-X-X-X-X-X-X---------------------------------------------------
X-.-.-.-.-.-.-.-.-.-.-.-.-.-.-.-X-------------------------------X-----------------------------------------------------------------------------------------------X---------------------------------------------------
X-.-.-.-.-.-.-.-.-.-.-.-.-.-.-.-X-------------------------------X---<-------------------------------------------------------------------------------------------X---------------------------------------------------
X-.-.-.-.-.-.-.-.-.-.-.-.-.-.-.-X-------------------------------X-----------------------------------------------------------------------------------------------X---------------------------------------------------
X-.-.-.-.-.-.-.-.-.-.-.-.-.-.-.-X-------------------------------X-------W-------------------------------------------------------------------------------A-------X---------------------------------------------------
X-.-.-.-.-.-.-.-.-.-.-.-.-.-.-.-X-------------------------------X-----------------------------------------------------------------------------------------------X---------------------------------------------------
X-.-.-.-.-.-.-.-.-.-.-.-.-.-.-.-X-------------------------------X-----------------------------------------------------------------------------------------------X---------------------------------------------------
X-.-.-.-.-.-.-.-.-.-.-.-.-.-.-.-X-----------------------------,-X-,-,-,-,-,-,-,-,-,-,-,-,-,-,-,-,-,-,-,-,-,-,-,-,-,-,-,-,-,-,-,-,-,-,-,-,-,-,-,-,-,-,-,-,-,-,-,-X---------------------------------------------------
X-.-.-.-.-.-.-.-E-.-.-.-.-.-.-.-X-,-,-,-,-,-,-,-,-,-,-,-,-,-,-,-X-.-.-.-.-.-.-.-.-.-.-.-.-.-.-.-.-.-.-.-.-.-.-.-.-.-.-.-.-.-.-.-.-.-.-.-.-.-.-.-.-.-.-.-.-.-.-.-X-X-X-X-X-X-X-X-X-----------------------------------
X-.-.-.-.-.-.-.-.-.-.-.-.-.-.-.-X-,-X-X-X-X-X-X-X-X-X-X-X-X-X-,-X-,-.-.-.-.-.-.-.-.-.-.-.-.-.-.-.-.-.-.-.-.-.-.-.-.-.-.-.-.-.-.-.-.-.-.-.-.-.-.-.-.-.-.-.-.-.-.-,---------------X-----------------------------------
X-.-.-.-.-.-.-.-.-.-.-.-.-.-.-.-X-X-.-.-.-.-.-.-K-.-.-.-.-.-.-X-X-,-,-.-.-.-.-.-.-.-.-.-.-.-.-.-.-.-.-.-.-.-.-.-.-.-.-.-.-.-.-.-.-.-.-.-.-.-.-.-.-.-.-.-.-.-.-.-,---------------X-----------------------------------
X-.-.-.-.-.-.-.-.-.-.-.-.-.-.-.-X-X-.-.-.-.-.-.-.-.-.-.-.-.-.-X-X-.-,-.-.-.-.-.-.-.-.-.-.-.-.-.-.-.-.-.-.-.-.-.-.-.-.-.-.-.-.-.-.-.-.-.-.-.-.-.-.-.-.-.-.-.-.-.-,---------------X-----------------------------------
X-.-.-.-.-.-.-.-.-.-.-.-.-.-.-.-X-X-.-.-.-.-.-.-.-.-.-.-E-.-.-X-X-.-,-,-.-.-.-.-.-.-.-.-.-.-.-.-.-.-.-.-.-.-.-.-.-.-.-.-.-.-.-.-.-.-.-.-.-.-.-.-.-.-.-.-.-.-.-.-,-------W-------X-----------------------------------
X-.-.-.-.-.-.-.-.-.-.-.-.-.-.-,-X-X-.-.-.-.-.-.-.-.-.-.-.-.-.-X-X-.-.-,-,-.-.-.-.-.-.-.-.-.-.-.-.-.-.-.-.-.-.-.-.-.-.-.-.-.-.-.-.-.-.-.-.-.-.-.-.-.-.-.-.-.-.-.-,---------------X-----------------------------------
X-.-.-.-.-.-.-.-.-.-.-.-.-.-.-,-X-X-.-.-.-.-.-.-.-.-.-.-.-.-.-X-X-.-.-.-,-,-.-.-.-.-.-.-.-.-.-.-.-.-.-.-.-.-.-.-.-.-.-.-.-.-.-.-.-.-.-.-.-.-.-.-.-.-.-.-.-.-.-.-,---------------X-----------------------------------
X-.-.-.-.-.-.-.-.-.-.-.-.-.-.-,-.-,-.-.-.-.-.-.-.-.-.-.-.-.-.-,-,-.-.-.-.-,-,-.-.-.-.-.-.-.-.-.-.-.-.-.-.-.-.-.-.-.-.-.-.-.-.-.-.-.-.-.-.-.-.-.-.-.-.-.-.-.-.-.-,---------------X-----------------------------------
X-.-.-.-.-.-.-.-E-.-.-.-.-.-.-,-.-,-.-.-.-.-.-.-E-.-.-.-E-.-.-,-,-.-.-.-A-.-,-,-.-.-.-.-.-.-.-.-E-.-.-.-.-.-.-.-.-.-.-.-.-.-.-.-.-.-.-.-.-.-.-.-.-.-.-.-.-.-.-.-,-------<-------X-----------------------------------
X-.-.-.-.-.-.-.-.-.-.-.-.-.-.-,-.-,-.-.-.-.-.-.-.-.-.-.-.-.-.-,-,-.-.-.-.-.-.-,-,-.-.-.-.-.-.-.-.-.-.-.-.-.-.-.-.-.-.-.-.-.-.-.-.-.-.-.-.-.-.-.-.-.-.-.-.-.-.-.-,---------------X-----------------------------------
X-.-.-.-.-.-.-.-.-.-.-.-.-.-.-,-X-X-.-.-.-.-.-.-.-.-.-.-.-.-.-X-X-.-.-.-.-.-.-.-,-.-.-.-.-.-.-.-.-.-.-.-.-.-.-.-.-.-.-.-.-.-.-.-.-.-.-.-.-.-.-.-.-.-.-.-.-.-.-.-,---------------X-----------------------------------
X-.-.-.-.-.-.-.-.-.-.-.-.-.-.-.-X-X-.-.-.-.-.-.-.-.-.-.-.-.-.-X-X-.-.-.-.-.-.-.-,-,-.-.-.-.-.-.-.-.-.-.-.-.-.-.-.-.-.-.-.-.-.-.-.-.-.-.-.-.-.-.-.-.-.-.-.-.-.-.-,---------------X-----------------------------------
X-.-.-.-.-.-.-.-.-.-.-.-.-.-.-.-X-X-.-.-.-.-.-.-.-.-.-.-E-.-.-X-X-.-.-.-.-.-.-.-.-,-,-.-.-.-.-.-.-.-.-.-.-.-.-.-A-.-.-.-.-.-.-.-.-.-.-.-.-.-.-.-.-.-.-.-.-.-.-.-,---------------X-----------------------------------
X-.-.-.-.-.-.-.-.-.-.-.-.-.-.-.-X-X-.-.-.-.-.-.-.-.-.-.-.-.-.-X-X-.-.-.-.-.-.-.-.-.-,-,-.-.-.-.-.-.-.-.-.-.-.-.-.-.-.-.-.-.-.-.-.-.-.-.-.-.-.-.-.-.-.-.-.-.-.-.-,---------------X-----------------------------------
X-.-.-.-.-.-.-.-.-.-.-.-.-.-.-.-X-X-.-.-.-,-,-,-,-,-,-.-.-.-,-X-X-.-.-.-.-.-.-.-.-.-.-,-,-.-.-.-.-.-.-.-.-.-.-.-H-.-.-.-.-.-.-.-.-.-.-.-.-.-.-.-.-.-.-.-.-.-.-.-,---------------X-----------------------------------
X-.-.-.-.-.-.-.-.-.-.-.-.-.-.-.-X-,-X-X-X-X-X-.-.-.-X-X-X-X-X-,-X-.-.-.-.-.-.-.-.-.-.-.-,-,-.-.-.-,-,-,-,-,-,-,-,-,-,-,-,-,-,-.-.-.-.-.-.-.-.-.-.-.-.-.-.-.-.-.-,---------------X-----------------------------------
X-.-.-.-.-.-.-.-.-.-.-.-.-.-.-.-X-X-X-X-X-X-X-,-,-,-X-X-X-X-X-X-X-.-.-.-.-.-.-.-.-.-.-.-.-,-,-.-A-,-.~.~.~.~.~.~.~.~.~.~.~.~,~,-A-.-.-.-.-.-.-.-.-.-.-.-.-.-.-.-,---------------X-------------,-,-,-,-,-,-,-,-,-,---
X-.-.-.-.-.-.-.-.-.-.-.-.-.-.-.-.-.-.-.-.-.-.-.-.-.-.-.-.-.-.-.-.-.-.-.-.-.-.-.-.-.-.-.-.-.-,-,-,-.~.~.~.~.~.~.~.~.~.~.~.~.~.~,~,-.-.-.-.-.-.-.-.-.-.-.-.-.-.-.-,---------------X-----------,-,-X-X-X-X-X-X-X-X-X-,-
X-.-.-.-.-.-.-.-.-.-.-.-.-.-.-.-.-.-.-.-.-.-.-.-.-.-.-.-.-.-.-.-.-.-.-.-.-.-.-.-.-.-.-.-.-.-,-,-.~.~.~.~.~.~.~.~.~.~.~.~.~.~.~.~,~.-.-.-.-.-.-.-.-.-.-.-.-.-.-.-,---------------X-----------,-X-.-.-.-.-.-.-.-.-.-X-
X-.-.-.-.-.-.-.-.-.-.-.-.-.-.-.-.-.-.-.-.-.-.-.-.-.-.-.-.-.-.-.-.-.-.-.-.-.-.-.-.-.-.-.-.-.-.-,-.~.~.~.~.~.~.~.~.~.~.~.~.~.~.~.~,~.-.-.-.-.-.-.-.-.-.-.-.-.-.-.-,---------------X-----------,-X-.-.-.-,-,-,-,-.-.-X-
X-.-.-.-.-.-.-.-.-.-.-.-.-.-.-.-.-.-.-.-.-.-.-.-.-.-.-.-.-.-.-.-.-.-.-.-.-.-.-.-.-.-.-.-.-.-.-,-.~.~.~.~.~.~.~.~.~.~.~.~.~.~.~.~,~.-.-.-.-.-.-.-.-.-.-.-.-.-.-.-,---------------X-----------,-X-.-.-.-,->->->-.-.-X-
X-.-.-.-.-.-.-.-.-.-.-.-.-.-.-.-.-.-.-.-.-.-.-.-.-.-.-.-.-.-.-.-.-.-.-.-.-.-.-.-.-.-.-.-.-.-.-,-.~.~.~.~.~.~.~.~.~.~.~.~.~.~.~.~,~.-.-.-.-.-.-.-.-.-.-.-.-.-.-.-,-------------,-X-,-,-,-,-,-,-X-.-.-.-,->-.->-.-.-X-
X-.-.-.-.-.-.-.-.-.-.-.-.-.-.-.-.-.-.-.-.-.-.-.-.-.-.-.-.-.-.-.-.-.-.-.-.-.-.-.-.-.-.-.-.-.-.-,-.~.~.~.~.~.~.~.~.~.~.~.~.~.~.~.~,~.-.-.-.-.-.-.-.-.-.-.-.-.-.-.-,-------------,-X-X-X-X-X-X-X-X-.-.-.-,->->->-.-.-X-
X-.-.-.-.-.-.-.-.-.-.-.-.-.-.-.-.-.-.-.-.-.-.-.-.-.-.-.-.-.-.-.-.-.-.-.-.-.-.-.-.-.-.-.-.-.-.-,-.~.~.~.~.~.~.~.~.~.~.~.~.~.~.~.~,~.-.-.-.-.-.-.-.-.-.-.-.-.-.-.-,-------------,-L-.-L-L-.-L-.-.-.-.-.-.-.-.-.-.-.-X-
X-.-.-.-.-.-.-.-.-.-.-.-.-.-.-.-E-.-.-.-.-.-.-.-<-.-.-.-.-.-.-.-.-.-.-.-.-.-.-.-E-.-.-.-H-.-H-,-.~.~.~.~.~.~.~.~K~.~.~.~.~.~.~.~,~.-.-.-A-.-.-.-.-.-.-.-.-.-.-.-,-------<---<-,-L-.-L-L-.-L-.-.-.-.-.-.-.-.-.-.-.-X-
X-.-.-.-.-.-.-.-.-.-.-.-.-.-.-.-.-.-.-.-.-.-.-.-.-.-.-.-.-.-.-.-.-.-.-.-.-.-.-.-.-.-.-.-.-.-.-,-.~.~.~.~.~.~.~.~.~.~.~.~.~.~.~.~,~.-.-.-.-.-.-.-.-.-.-.-.-.-.-.-,-------------,-L-.-L-L-.-L-.-.-.-.-.-,-,-,-,-.-.-X-
X-.-.-.-.-.-.-.-.-.-.-.-.-.-.-.-.-.-.-.-.-.-.-.-.-.-.-.-.-.-.-.-.-.-.-.-.-.-.-.-.-.-.-.-.-.-.-,-.~.~.~.~.~.~.~.~.~.~.~.~.~.~.~.~,~.-.-.-.-.-.-.-.-.-.-.-.-.-.-.-,-------------,-X-X-X-X-X-X-X-X-.-.-.-,-.-.-,-.-.-X-
X-.-.-.-.-.-.-.-.-.-.-.-.-.-.-.-.-.-.-.-.-.-.-.-.-.-.-.-.-.-.-.-.-.-.-.-.-.-.-.-.-.-.-.-.-.-.-,-.~.~.~.~.~.~.~.~.~.~.~.~.~.~.~.~,~.-.-.-.-.-.-.-.-.-.-.-.-.-.-.-,---------------X-----------,-X-.-.-.-,-.-.-,-.-.-X-
X-.-.-.-.-.-.-.-.-.-.-.-.-.-.-.-.-.-.-.-.-.-.-.-.-.-.-.-.-.-.-.-.-.-.-.-.-.-.-.-.-.-.-.-.-.-.-,-.~.~.~.~.~.~.~.~.~.~.~.~.~.~.~.~,~.-.-.-.-.-.-.-.-.-.-.-.-.-.-.-,-------<-------X-----------,-X-.-.-.-,-,-,-,-.-.-X-
X-.-.-.-.-.-.-.-.-.-.-.-.-.-.-.-.-.-.-.-.-.-.-.-.-.-.-.-.-.-.-.-.-.-.-.-.-.-.-.-.-.-.-.-.-.-.-,-.~.~.~.~.~.~.~.~.~.~.~.~.~.~.~.~,~.-.-.-.-.-.-.-.-.-.-.-.-.-.-.-,---------------X-----------,-X-.-.-.-.-.-.-.-.-.-X-
X-.-.-.-.-.-.-.-.-.-.-.-.-.-.-.-.-.-.-.-.-.-.-.-.-.-.-.-.-.-.-.-.-.-.-.-.-.-.-.-.-.-.-.-.-.-.-,-,~.~.~.~.~.~.~.~.~.~.~.~.~.~.~,~,~.-.-.-.-.-.-.-.-.-.-.-.-.-.-.-,---------------X-----------,-X-.-.-.-.-.-.-.-.-,-X-
X-.-.-.-.-.-.-.-.-.-.-.-.-.-.-.-.-.-.-.-.-,-,-,-,-,-,-.-.-.-.-.-.-.-.-.-.-.-.-.-.-.-.-.-.-.-.-.-,-,~.~.~.~.~.~.~.~.~.~.~.~.~,~,~.-.-.-.-.-.-.-.-.-.-.-.-.-.-.-.-,---------------X-------------,-X-X-X-X-X-X-X-X-X---
X-.-.-.-.-.-.-.-.-.-.-.-.-.-.-.-X-X-X-X-X-X-X-.-.-.-X-X-X-X-X-X-X-.-.-.-.-.-.-.-.-.-.-.-.-.-.-.-A-,-,~,~,~,~,~,~,~,~,~,~,~,~,~.-A-.-.-.-.-.-.-.-.-.-.-.-.-.-.-.-,---------------X-----------------------------------
X-.-.-.-.-.-.-.-.-.-.-.-.-.-.-.-X-,-X-X-X-X-X-,-,-,-X-X-X-X-X-,-X-.-.-.-.-.-.-.-.-.-.-.-.-.-.-.-.-.-.-.-.-.-.-.-.-.-.-,-,-.-.-.-.-.-.-.-.-.-.-.-.-.-.-.-.-.-.-.-,---------------X-----------------------------------
X-.-.-.-.-.-.-.-.-.-.-.-.-.-.-.-X-X-.-.-.-.-.-.-.-.-.-.-.-.-.-X-X-.-.-.-.-.-.-.-.-.-.-.-.-.-.-.-.-.-.-.-.-.-.-.-.-.-.-.-,-,-.-.-.-.-.-.-.-.-.-.-.-.-.-.-.-.-.-.-,---------------X-----------------------------------
X-.-.-.-.-.-.-.-.-.-.-.-.-.-.-.-X-X-.-.-.-.-.-.-.-.-.-.-.-.-.-X-X-.-.-.-.-.-.-.-.-.-.-.-.-.-.-.-.-.-.-.-.-.-.-.-.-.-.-.-.-,-,-.-.-.-.-.-.-.-.-.-.-.-.-.-.-.-.-.-,---------------X-----------------------------------
X-.-.-.-.-.-.-.-.-.-.-.-.-.-.-.-X-X-.-.-E-.-.-.-.-.-.-.-.-.-.-X-X-.-.-.-.-.-.-.-.-.-.-.-.-.-.-.-.-.-.-.-.-.-.-.-A-.-.-.-.-.-,-,-.-.-.-.-.-.-.-.-.-.-.-.-.-.-.-.-,---------------X-----------------------------------
X-.-.-.-.-.-.-.-.-.-.-.-.-.-.-,-X-X-.-.-.-.-.-.-.-.-.-.-.-.-.-X-X-.-.-.-.-.-.-.-.-.-.-.-.-.-.-.-.-.-.-.-.-.-.-.-.-.-.-.-.-.-.-,-,-.-.-.-.-.-.-.-.-.-.-.-.-.-.-.-,---------------X-----------------------------------
X-.-.-.-.-.-.-.-.-.-.-.-.-.-.-,-X-X-.-.-.-.-.-.-.-.-.-.-.-.-.-X-X-.-.-.-.-.-.-.-.-.-.-.-.-.-.-.-.-.-.-.-.-.-.-.-.-.-.-.-.-.-.-.-,-.-.-.-.-.-.-.-.-.-.-.-.-.-.-.-,---------------X-----------------------------------
X-.-.-.-.-.-.-.-.-.-.-.-.-.-.-,-.-,-.-.-.-.-.-.-.-.-.-.-.-.-.-,-,-.-.-.-.-.-.-.-.-.-.-.-.-.-.-.-.-.-.-.-.-.-.-.-.-.-.-.-.-.-.-.-,-,-.-.-.-.-.-.-.-.-.-.-.-.-.-.-,---------------X-----------------------------------
X-.-.-.-.-.-.-.-E-.-.-.-.-.-.-,-.-,-.-.-.-.-.-.-.-.-.-.-E-.-.-,-,-.-.-.-A-.-.-.-.-.-.-.-.-.-.-.-E-.-.-.-.-.-.-.-.-.-.-.-.-.-.-.-.-,-,-.-.-.-.-.-.-.-.-.-.-.-.-.-,-------<-------X-----------------------------------
X-.-.-.-.-.-.-.-.-.-.-.-.-.-.-,-.-,-.-.-.-.-.-.-.-.-.-.-.-.-.-,-,-.-.-.-.-.-.-.-.-.-.-.-.-.-.-.-.-.-.-.-.-.-.-.-.-.-.-.-.-.-.-.-.-.-,-,-.-.-.-.-.-.-.-.-.-.-.-.-,---------------X-----------------------------------
X-.-.-.-.-.-.-.-.-.-.-.-.-.-.-,-X-X-.-.-.-.-.-.-.-.-.-.-.-.-.-X-X-.-.-.-.-.-.-.-.-.-.-.-.-.-.-.-.-.-.-.-.-.-.-.-.-.-.-.-.-.-.-.-.-.-.-,-,-.-.-.-.-.-.-.-.-.-.-.-,---------------X-----------------------------------
X-.-.-.-.-.-.-.-.-.-.-.-.-.-.-.-X-X-.-.-.-.-.-.-.-.-.-.-.-.-.-X-X-.-.-.-.-.-.-.-.-.-.-.-.-.-.-.-.-.-.-.-.-.-.-.-.-.-.-.-.-.-.-.-.-.-.-.-,-,-.-.-.-.-.-.-.-.-.-.-,---------------X-----------------------------------
X-.-.-.-.-.-.-.-.-.-.-.-.-.-.-.-X-X-.-.-E-.-.-.-.-.-.-.-E-.-.-X-X-.-.-.-.-.-.-.-.-.-.-.-.-.-.-.-.-.-.-.-.-.-.-.-.-.-.-.-.-.-.-.-.-.-.-.-.-,-,-.-.-.-.-.-.-.-.-.-,-------W-------X-----------------------------------
X-.-.-.-.-.-.-.-.-.-.-.-.-.-.-.-X-X-.-.-.-.-.-.-.-.-.-.-.-.-.-X-X-.-.-.-.-.-.-.-.-.-.-.-.-.-.-.-.-.-.-.-.-.-.-.-.-.-.-.-.-.-.-.-.-.-.-.-.-.-,-.-.-.-.-.-.-.-.-.-,---------------X-----------------------------------
X-.-.-.-.-.-.-.-.-.-.-.-.-.-.-.-X-X-.-.-.-.-.-.-K-.-.-.-.-.-,-X-X-.-.-.-.-.-.-.-.-.-.-.-.-.-.-.-.-.-.-.-.-.-.-.-.-.-.-.-.-.-.-.-.-.-.-.-.-.-,-,-.-.-.-.-.-.-.-.-,---------------X-----------------------------------
X-.-.-.-.-.-.-.-.-.-.-.-.-.-.-.-X-,-X-X-X-X-X-X-X-X-X-X-X-X-X-,-X-,-,-,-,-,-,-,-,-,-,-,-,-,-,-,-,-,-,-,-,-,-,-,-,-,-,-,-,-,-,-,-,-,-,-,-,-,-,-,-.-.-.-.-.-.-.-.-,---------------X-----------------------------------
X-.-.-.-.-.-.-.-E-.-.-.-.-.-.-.-X-----------------------------,-X-.-.-.-.-.-.-.-.-.-.-.-.-.-.-.-.-.-.-.-.-.-.-.-.-.-.-.-.-.-.-.-.-.-.-.-.-.-.-.-.-.-,-,-,-,-,-,-X-X-X-X-X-X-X-X-X-----------------------------------
X-.-.-.-.-.-.-.-.-.-.-.-.-.-.-.-X-----------------------------,-X-.-.-.-.-.-.-.-.-.-.-.-.-.-.-.-.-.-.-.-.-.-.-.-.-.-.-.-.-.-.-.-.-.-.-.-.-.-.-.-.-.-,-,---------X---------------------------------------------------
X-.-.-.-.-.-.-.-.-.-.-.-.-.-.-.-X-----------------------------,-X-.-.-.-.-.-.-.-.-.-.-.-.-.-.-.-.-.-.-.-.-.-.-.-.-.-.-.-.-.-.-.-.-.-.-.-.-.-.-.-.-.-.-,-,-------X---------------------------------------------------
X-.-.-.-.-.-.-.-.-.-.-.-.-.-.-.-X-----------------------------,-X-.-.-.-.-.-.-.-.-.-.-.-.-.-.-.-.-.-.-.-.-.-.-.-.-.-.-.-.-.-.-.-.-.-.-.-.-.-.-.-.-.-.-.-,-,-----X---------------------------------------------------
X-.-.-.-.-.-.-.-.-.-.-.-.-.-.-.-X-----------------------------,-X-.-.-.-W-.-.-.-.-.-.-.-.-.-.-.-.-.-.-.-.-.-.-.-.-.-.-.-.-.-.-.-.-.-.-.-.-.-.-.-.-.-.-.-A-,-----X---------------------------------------------------
X-.-.-.-.-.-.-.-.-.-.-.-.-.-.-.-X-----------------------------,-X-.-.-.-.-.-.-.-.-.-.-.-.-.-.-.-.-.-.-.-.-.-.-.-.-.-.-.-.-.-.-.-.-.-.-.-.-.-.-.-.-.-.-.-.-,-,---X---------------------------------------------------
X-.-.-.-.-.-.-.-.-.-.-.-.-.-.-.-X-----------------------------,-X-.-<-.-.-.-.-.-.-.-.-.-.-.-.-.-.-.-.-.-.-.-.-.-.-.-.-.-.-.-.-.-.-.-.-.-.-.-.-.-.-.-.-.-.-.-,-,-X---------------------------------------------------
X-.-.-.-.-.-.-.-.-.-.-.-.-.-.-.-X-----------------------------,-X-.-.-.-.-.-.-.-.-.-.-.-.-.-.-.-.-.-.-.-.-.-.-.-.-.-.-.-.-.-.-.-.-.-.-.-.-.-.-.-.-.-.-.-.-.-.-,-X---------------------------------------------------
X-.-.-.-.-.-.-.-E-.-.-.-.-.-.-.-X-----------------------------,-X-X-X-X-X-X-X-X-X-X-X-X-X-X-X-X-X-X-X-X-X-X-X-X-X-X-X-X-X-X-X-X-X-X-X-X-X-X-X-X-X-X-X-X-X-X-X-X-X---------------------------------------------------
X-.-.-.-.-.-.-.-.-.-.-.-.-.-.-.-X-----------------------------------------------------------------------------------------------------------------------------------------------------------------------------------
X-.-.-.-.-.-.-.-.-.-.-.-.-.-.-.-X-----------------------------------------------------------------------------------------------------------------------------------------------------------------------------------
X-.-.-.-.-.-.-.-.-.-.-.-.-.-.-.-X-----------------------------------------------------------------------------------------------------------------------------------------------------------------------------------
X-.-.-.-.-.-.-.-.-.-.-.-.-.-.-.-X-----------------------------------------------------------------------------------------------------------------------------------------------------------------------------------
X-.-.-.-.-.-.-.-.-.-.-.-.-.-.-.-X-----------------------------------------------------------------------------------------------------------------------------------------------------------------------------------
X-.-.-.-.-.-.-.-.-.-.-.-.-.-.-.-X-----------------------------------------------------------------------------------------------------------------------------------------------------------------------------------
X-.-.-.-.-.-.-.-.-.-.-.-.-.-.-.-X-----------------------------------------------------------------------------------------------------------------------------------------------------------------------------------
X-.-.-.-.-.-.-.-.-.-.-.-.-.-.-.-X-----------------------------------------------------------------------------------------------------------------------------------------------------------------------------------
X-.-.-.-.-.-.-.-.-.-.-.-.-.-.-.-X-----------------------------------------------------------------------------------------------------------------------------------------------------------------------------------
X-.-.-.-.-.-.-.-.-.-.-.-.-.-.-.-X-----------------------------------------------------------------------------------------------------------------------------------------------------------------------------------
X-.-.-.-.-.-.-.-.-.-.-.-.-.-.-.-X-----------------------------------------------------------------------------------------------------------------------------------------------------------------------------------
X-.-.-.-.-.-.-.-.-.-.-.-.-.-.-.-X-----------------------------------------------------------------------------------------------------------------------------------------------------------------------------------
X-.-.-.-.-.-.-.-.-.-.-.-.-.-.-.-X-----------------------------------------------------------------------------------------------------------------------------------------------------------------------------------
X-.-.-.-.-.-.-.-.-.-.-.-.-.-.-.-X-----------------------------------------------------------------------------------------------------------------------------------------------------------------------------------
X-.-.-.-.-.-.-.-.-.-.-.-.-.-.-.-X-,-,-,-,-,-,-,-,-,-,-,-,-,-,-,-,-,-,-,-,-,-,-,-,-,-,-,-,-,-,-,-,-,-,-,-,-,-,-,-,-,-,-,-,-,-,-,-,-----------------------------------------------------------------------------------
X-.-.-.-.-.-.-.-E-.-.-.-.-.-.-.-X-X-X-X-X-X-X-X-X-X-X-X-X-X-X-X-X-X-X-X-X-X-X-X-X-X-X-X-X-X-X-X-X-X-X-X-X-X-X-X-X-X-X-X-X-X-X-X-X-----------------------------------------------------------------------------------
X-.-.-.-.-.-.-.-.-.-.-.-.-.-.-.-.-.-.-.-.-.-.-.-.-.-.-.-.-.-.-.-.-.-.-.-.-.-.-.-.-.-.-.-.-.-.-.-.-.-.-.-.-.-.-.-.-.-.-.-.-.-.-.-X-----------------------------------------------------------------------------------
X-.-.-.-.-.-.-.-.-.-.-.-.-.-.-.-.-.-.-.-.-.-.-.-.-.-.-.-.-.-.-.-.-.-.-.-.-.-.-.-.-.-.-.-.-.-.-.-.-.-.-.-.-.-.-.-.-.-.-.-.-.-A-.-X-----------------------------------------------------------------------------------
X-.-.-.-.-.-.-.-.-.-.-.-.-.-.-.-.-.-.-.-.-.-.-.-.-.-.-.-.-.-.-.-.-.-.-.-.-.-.-.-.-.-.-.-.-.-.-.-.-.-.-.-.-.-.-.-.-.-.-.-.-.-.-.-X-----------------------------------------------------------------------------------
X-.-.-.-.-.-.-.-.-.-.-.-.-.-.-.-.-.-.-.-.-.-.-.-.-.-.-.-.-.-.-.-.-.-.-.-.-.-.-.-.-.-.-.-.-.-.-.-.-.-.-.-.-.-.-.-.-.-.-.-.-.-.-.-X-----------------------------------------------------------------------------------
X-.-.-.-.-.-.-.-.-.-.-.-.-.-.-.-.-.-.-.-.-.-.-.-.-.-.-.-.-.-.-.-.-.-.-.-.-.-.-.-.-.-.-.-.-.-.-.-.-.-.-.-.-.-.-.-.-.-.-.-.-.-.-.-X-----------------------------------------------------------------------------------
X-.-.-.-.-.-.-.-.-.-.-.-.-.-.-.-.-.-.-.-.-.-.-.-.-.-.-.-.-.-.-.-.-.-.-.-.-.-.-.-.-.-.-.-.-.-.-.-.-.-.-.-.-.-.-.-.-.-.-.-.-.-.-.-X-----------------------------------------------------------------------------------
X-.-.-.-.-.-.-.-.-.-.-.-.-.-.-.-.-.-.-.-.-.-.-.-.-.-.-.-.-.-.-.-.-.-.-.-.-.-.-.-.-.-.-.-.-.-.-.-.-.-.-.-.-.-.-.-.-.-.-.-.-.-.-.-X-----------------------------------------------------------------------------------
X-.-.-.-.-.-.-.-.-.-.-.-.-.-.-.-.-.-.-.-.-.-.-.-E-.-.-.-.-.-.-.-.-.-.-.-.-.-.-.-E-.-.-.-.-.-.-.-.-.-.-.-.-.-.-.-E-.-.-.-A-.-.-.-X-----------------------------------------------------------------------------------
X-.-.-.-.-.-.-.-.-.-.-.-.-.-.-.-.-.-.-.-.-.-.-.-.-.-.-.-.-.-.-.-.-.-.-.-.-.-.-.-.-.-.-.-.-.-.-.-.-.-.-.-.-.-.-.-.-.-.-.-.-.-.-.-X-----------------------------------------------------------------------------------
X-.-.-.-.-.-.-.-.-.-.-.-.-.-.-.-.-.-.-.-.-.-.-.-.-.-.-.-.-.-.-.-.-.-.-.-.-.-.-.-.-.-.-.-.-.-.-.-.-.-.-.-.-.-.-.-.-.-.-.-.-.-.-.-X-----------------------------------------------------------------------------------
X-.-.-.-.-.-.-.-.-.-.-.-.-.-.-.-.-.-.-.-.-.-.-.-.-.-.-.-.-.-.-.-.-.-.-.-.-.-.-.-.-.-.-.-.-.-.-.-.-.-.-.-.-.-.-.-.-.-.-.-.-.-.-.-X-----------------------------------------------------------------------------------
X-.-.-.-.-.-.-.-.-.-.-.-.-.-.-.-.-.-.-.-.-.-.-.-.-.-.-.-.-.-.-.-.-.-.-.-.-.-.-.-.-.-.-.-.-.-.-.-.-.-.-.-.-.-.-.-.-.-.-.-.-.-.-.-X-----------------------------------------------------------------------------------
X-.-.-.-.-.-.-.-.-.-.-.-.-.-.-.-.-.-.-.-.-.-.-.-.-.-.-.-.-.-.-.-.-.-.-.-.-.-.-.-.-.-.-.-.-.-.-.-.-.-.-.-.-.-.-.-.-.-.-.-.-.-.-.-X-----------------------------------------------------------------------------------
X-.-A-.-.-.-.-.-.-.-.-.-.-.-.-.-.-.-.-.-.-.-.-.-.-.-.-.-.-.-.-.-.-.-.-.-.-.-.-.-.-.-.-.-.-.-.-.-.-.-.-.-.-.-.-.-.-.-.-.-.-.-A-.-X-----------------------------------------------------------------------------------
X-.-.-.-.-.-.-.-.-.-.-.-.-.-.-.-.-.-.-.-.-.-.-.-.-.-.-.-.-.-.-.-.-.-.-.-.-.-.-.-.-.-.-.-.-.-.-.-.-.-.-.-.-.-.-.-.-.-.-.-.-.-.-.-X-----------------------------------------------------------------------------------
X-X-X-X-X-X-X-X-X-X-X-X-X-X-X-X-X-X-X-X-X-X-X-X-X-X-X-X-X-X-X-X-X-X-X-X-X-X-X-X-X-X-X-X-X-X-X-X-X-X-X-X-X-X-X-X-X-X-X-X-X-X-X-X-X-----------------------------------------------------------------------------------
