------------------------------------------------------------------------------------------------------------,-,-X-X-X-X-X-X-X-X-X-X-X-X-X-X-X-,-----------------------------------------------------
----------------------------------------------------------------,-,-,-,-,-,-,-,-,-,-,-,-,-,-,-,-,-,-,-,-,-,-,-X-,-,-,-,-,-,-,-,-,-,-,-,-,-,-.-X-,-,-,-,-,-,-,-,-,-,-,-,-,-,-,-,-,-,-,-,-,-----------
--------------------------------------------------------------,-,-X-X-X-X-X-X-X-X-X-X-X-X-X-X-X-X-X-X-X-X-X-X-,-,-.-.-,-,-,-,-,-,-,-,-.-.-,-,-.-X-X-X-X-X-X-X-X-X-X-X-X-X-X-X-X-X-X-X-X-X-,---------
------------------------------------------------------------,-,-X-,-,-,-,-,-,-,-,-,-,-,-,-,-,-,-,-,-,-,-,-,-,-,-.-.-.-,-.-.-.-K-.-.-,-.-.-.-,-,-,-,-,-,-,-,-,-,-,-,-,-,-,-,-,-,-,-,-,-,-,-X-,-------
------------------------------------------------------------,-X-,-,-.-.-.-.-.-.-.-.-.-.-.-.-.-.-.-.-.-.-.-.-.-.-.-.-,-,-,-E-.-,-,-E-,-.-.-.-.-.-.-.-.-.-.-.-.-.-.-.-.-.-.-.-.-.-.-.-.-.-,-,-X-,-----
------------------------------------------------------------,-X-,-.-.-.-.-.-.-.-.-.-.-.-.-.-.-.-.-.-.-.-.-.-.-.-.-.-,-,-,-,-.-,-,-,-,-.-.-.-.-.-.-.-.-.-.-.-.-.-.-.-.-.-.-.-.-.-.-.-.-.-.-,-.-X-----
------------------------------------------------------------,-X-,-.-.-.-.-.-.-.-.-.-.-.-.-.-.-.-.-.-.-.-.-.-.-.-.-.-,-,-.-,-.-,-.-.-,-.-.-.-.-.-.-.-.-.-.-.-.-.-.-.-.-.-.-.-.-.-.-.-.-.-.-,-.-X-----
------------------------------------------------------------,-X-,-.-.-.-.-.-.-.-.-.-.-.-.-.-.-.-.-.-.-.-.-.-.-.-.-.-,-,-.-,-.-,-.-.-,-.-.-.-.-.-.-.-.-.-.-.-.-.-.-.-.-.-.-.-.-.-.-.-.-.-.-,-.-X-----
------------------------------------------------------------,-X-,-.-.-.-.-.-.-.-.-.-.-.-.-.-.-E-.-.-.-.-.-.-.-.-.-.-,-,-.-,-.-,-.-.-,-.-.-.-.-.-.-.-.-.-.-.-.-.-.-.-.-E-.-.-.-.-.-.-.-.-.-,-.-X-----
------------------------------------------------------------,-X-,-.-.-.-.-.-.-.-.-.-.-.-.-.-.-.-.-.-.-.-.-.-.-.-.-.-,-,-,-,-.-,-,-,-,-.-.-.-.-.-.-.-.-.-.-.-.-.-.-.-.-.-.-.-.-.-.-.-.-.-.-,-.-X-----
------------------------------------------------------------,-X-,-.-.-.-.-.-.-.-.-.-.-.-.-.-.-.-.-.-.-.-.-.-.-.-.-.-,-,-,-,-.-,-,-,-,-.-.-.-.-.-.-.-.-.-.-.-.-.-.-.-.-.-.-.-.-.-.-.-.-.-.-,-.-X-----
------------------------------------------------------------,-X-,-.-.-.-.-.-.-.-.-.-.-.-.-.-.-.-.-.-.-.-.-.-.-.-.-.-.-,-.-.-.-.-.-.-,-.-.-.-.-.-.-.-.-.-.-.-.-.-.-.-.-.-.-.-.-.-.-.-.-.-.-,-.-X-----
------------------------------------------------------------,-X-,-.-.-.-.-.-.-.-.-.-.-.-.-.-.-.-.-.-.-.-.-.-.-.-.-.-.-,-.-.-.-.-.-.-,-.-.-.-.-.-.-.-.-.-.-.-.-.-.-.-.-.-.-.-.-.-.-.-.-.-.-,-.-X-----
------------------------------------------------------------,-X-,-.-.-.-.-.-.-.-.-.-.-.-.-.-.-.-.-.-.-.-.-.-.-.-.-.-.-,-,-,-,-,-,-,-,-.-.-.-.-.-.-.-.-.-.-.-.-.-.-.-.-.-.-.-.-.-.-.-.-.-.-,-.-X-----
------------------------------------------------------------,-X-,-.-.-.-.-.-.-.-.-.-.-.-.-.-.-.-.-.-.-.-.-.-.-.-.-.-.-,-,-,-,-,-,-,-,-.-.-.-.-.-.-.-.-.-.-.-.-.-.-.-.-.-.-.-.-.-.-.-.-.-.-,-.-X-----
------------------------------------------------------------,-X-,-.-.-.-.-.-.-.-.-.-.-.-.-.-.-.-.-.-.-.-.-.-.-.-.-.-.-,-,-,-,-,-,-,-,-.-.-.-.-.-.-.-.-.-.-.-.-.-.-.-.-.-.-.-.-.-.-.-.-.-.-,-.-X-----
------------------------------------------------------------,-X-,-.-.-E-.-.-.-.-.-.-.-.-.-.-.-.-.-.-.-.-.-.-.-.-.-.-.-.-.-.-.-.-.-.-.-.-.-.-.-.-.-.-.-.-.-.-.-.-.-.-.-.-.-.-.-.-.-.-.-.-.-,-.-X-----
------------------------------------------------------------,-X-,-.-.-.-.-.-.-.-.-.-.-.-.-.-.-.-.-.-.-.-.-.-.-.-.-.-.-.-.-.-.-.-.-.-.-.-.-.-.-.-.-.-.-.-.-.-.-.-.-.-.-.-.-.-.-.-.-.-.-.-.-,-.-X-----
------------------------------------------------------------,-X-,-.-.-.-.-.-.-.-.-.-.-.-.-.-.-.-.-.-.-.-.-.-.-.-.-.-.-E-.-.-.-E-.-.-.-E-.-.-.-.-.-.-.-.-.-.-.-.-.-.-.-.-.-.-.-.-.-.-.-.-.-,-.-X-----
------------------------------------------------------------,-X-,-.-.-.-.-.-.-.-.-.-.-.-.-.-.-.-.-.-.-.-.-.-.-.-.-.-.-.-.-.-.-.-.-.-.-.-.-.-.-.-.-.-.-.-.-.-.-.-.-.-.-.-.-.-.-.-.-.-.-.-.-,-.-X-----
------------------------------------------------------------,-X-,-.-.-.-.-.-.-.-.-.-.-.-.-.-.-.-.-.-.-.-,-,-,-H-.-.-.-.-,-E-,-,-,-E-.-.-.-,-,-H-,-.-.-.-.-.-.-.-.-.-.-.-.-.-.-E-.-.-.-.-.-,-.-X-----
------------------------------------------------------------,-X-,-.-.-.-.-.-.-.-.-.-.-.-.-.-.-.-.-.-.-.-,-.-,-,-.-.-.-,-,-,-,-,-,-,-,-.-.-,-,-,-,-.-.-.-.-.-.-.-.-.-.-.-.-.-.-.-.-.-.-.-.-,-.-X-----
------------------------------------------------------------,-X-,-.-.-.-.-.-.-.-.-.-.-.-.-.-.-.-.-.-.-.-,-.-,-,-.-E-,-,-,-.-.-.-.-,-,-,-.-E-.-.-,-.-.-.-.-.-.-.-.-.-.-.-.-.-.-.-.-.-.-.-.-,-.-X-----
------------------------------------------------------------,-X-,-.-.-.-.-.-.-.-.-.-.-.-.-.-.-.-.-.-.-.-,-.-,-,-.-.-,-,-.-.-.-.-.-.-,-,-.-,-.-.-,-.-.-.-.-.-.-.-.-.-.-.-.-.-.-.-.-.-.-.-.-,-.-X-----
------------------------------------------------------------,-X-,-.-.-.-.-.-.-.-.-.-.-.-.-.-.-.-.-.-.-.-,-.-,-,-.-.-,-,-.-.-.-.-.-.-,-,-.-,-.-.-,-.-.-.-.-.-.-.-.-.-.-.-.-.-.-.-.-.-.-.-.-,-.-X-----
------------------------------------------------------------,-X-,-.-.-.-.-.-.-.-.-.-.-.-.-.-.-.-.-.-.-.-,-.-,-,-.-.-,-,-.-.-.-.-.-.-,-,-.-,-.-.-,-.-.-.-.-.-.-.-.-.-.-.-.-.-.-.-.-.-.-.-.-,-.-X-----
------------------------------------------------------------,-X-,-.-.-.-.-.-.-.-.-.-.-.-.-.-.-.-.-.-.-.-,-.-,-,-.-.-,-,-.-.-.-.-.-.-,-,-.-,-.-.-,-.-.-.-.-.-.-.-.-.-.-.-.-.-.-.-.-.-.-.-.-,-.-X-----
------------------------------------------------------------,-X-,-.-.-.-.-.-.-.-.-.-.-.-.-.-.-.-.-.-.-.-,-.-,-,-.-.-,-,-,-.-.-.-.-,-,-,-.-,-,-,-,-.-.-.-.-.-.-.-.-.-.-.-.-.-.-.-.-.-.-.-.-,-.-X-----
------------------------------------------------------------,-X-,-.-.-.-.-.-.-.-.-.-.-.-.-.-.-.-.-.-.-.-,-,-,-,-.-E-.-,-,-,-,-,-,-,-,-.-.-E-,-,-,-.-.-.-.-.-.-.-.-.-.-E-.-.-.-.-.-.-.-.-.-,-.-X-----
------------------------------------------------------------,-X-,-.-.-.-.-.-.-.-.-.-.-.-.-.-.-.-.-.-.-.-.-.-.-.-.-.-.-.-,-,-,-,-,-,-.-.-.-.-.-.-.-.-.-.-.-.-.-.-.-.-.-.-.-.-.-.-.-.-.-.-.-,-.-X-----
------------------------------------------------------------,-X-,-.-.-.-.-.-.-.-.-.-.-.-.-.-.-.-.-.-.-.-.-.-.-H-.-.-.-.-.-E-.-.-.-E-.-.-.-.-.-H-.-.-.-.-.-.-.-.-.-.-.-.-.-.-.-.-.-.-.-.-.-,-.-X-----
------------------------------------------------------------,-X-,-.-.-.-.-.-.-.-.-.-.-.-.-.-.-.-.-.-.-.-.-.-.-.-.-.-.-.-.-.-.-.-.-.-.-.-.-.-.-.-.-.-.-.-.-.-.-.-.-.-.-.-.-.-.-.-.-.-.-.-.-,-.-X-----
------------------------------------------------------------,-X-,-.-.-.-.-.-.-.-.-.-.-E-.-.-.-.-.-.-.-.-.-.-.-.-.-.-.-E-.-.-.-.-.-.-.-E-.-.-.-.-.-.-.-.-.-.-.-.-.-.-.-.-.-.-.-.-.-.-.-.-.-,-.-X-----
------------------------------------------------------------,-X-,-.-.-.-.-.-.-.-.-.-.-.-.-.-.-.-.-.-.-.-.-.-.-.-.-.-.-.-.-.-.-.-.-.-.-.-.-.-.-.-.-.-.-.-.-.-.-.-.-.-.-.-.-.-.-.-.-.-.-.-.-,-.-X-----
------------------------------------------------------------,-X-,-.-.-.-.-.-.-.-.-.-.-.-.-.-.-.-.-.-.-.-.-.-.-.-.-.-.-.-.-E-.-.-.-E-.-.-.-.-.-.-.-.-.-.-.-.-.-.-.-.-.-.-.-.-.-.-.-.-.-.-.-,-.-X-----
------------------------------------------------------------,-X-,-.-.-.-.-.-.-.-.-.-.-.-.-.-.-.-.-.-.-.-.-.-.-.-.-.-.-.-.-.-.-.-.-.-.-.-.-.-.-.-.-.-.-.-.-.-.-.-.-.-.-.-.-.-.-.-.-.-.-.-.-,-.-X-----
------------------------------------------------------------,-X-,-.-.-.-.-.-.-.-.-.-.-.-.-.-.-.-.-.-.-.-.-.-.-.-.-.-.-.-.-.-.-E-.-.-.-.-.-.-.-.-.-.-.-.-.-.-.-.-.-.-.-.-.-.-.-E-.-.-.-.-.-,-.-X-----
------------------------------------------------------------,-X-,-.-.-.-.-.-.-.-.-.-.-.-.-.-.-.-.-.-.-.-.-.-.-.-.-.-.-.-.-.-.-.-.-.-.-.-.-.-.-.-.-.-.-.-.-.-.-.-.-.-.-.-.-.-.-.-.-.-.-.-.-,-.-X-----
------------------------------------------------------------,-X-,-.-.-.-.-.-.-.-.-.-.-.-.-.-.-.-.-.-.-.-.-.-.-.-.-.-.-.-.-.-.-.-.-.-.-.-.-.-.-.-.-.-.-.-.-.-.-.-.-.-.-.-.-.-.-.-.-.-.-.-.-,-.-X-----
------------------------------------------------------------,-X-,-.-.-.-.-.-.-.-.-.-.-.-.-.-.-.-.-.-.-.-.-.-.-.-.-.-.-.-.-.-.-.-.-.-.-.-.-.-.-.-.-.-.-.-.-.-.-.-.-.-.-.-.-.-.-.-.-.-.-.-.-,-.-X-----
------------------------------------------------------------,-X-,-.-.-E-.-.-.-.-.-.-.-.-.-.-.-.-.-.-.-.-.-.-.-.-.-.-.-.-.-.-.-.-.-.-.-.-.-.-.-.-.-.-.-.-.-.-.-.-.-.-.-.-.-.-.-.-.-.-.-.-.-,-.-X-----
------------------------------------------------------------,-X-,-.-.-.-.-.-.-.-.-.-.-.-.-.-.-.-.-.-.-.-.-.-.-.-.-.-.-.-.-.-.-.-.-.-.-.-.-.-.-.-.-.-.-.-.-.-.-.-.-.-.-.-.-.-.-.-.-.-.-.-.-,-.-X-----
------------------------------------------------------------,-X-,-.-.-.-.-.-.-.-.-.-.-.-.-.-.-.-.-.-.-.-.-.-.-.-.-.-.-.-.-.-.-.-.-.-.-.-.-.-.-.-.-.-.-.-.-.-.-.-.-.-.-.-.-.-.-.-.-.-.-.-.-,-.-X-----
------------------------------------------------------------,-X-,-.-.-.-.-.-.-.-.-.-.-.-.-.-.-.-.-.-.-.-.-.-.-.-.-.-.-.-.-.-.-.-.-.-.-.-.-.-.-.-.-.-.-.-.-.-.-.-.-.-.-.-.-.-.-.-.-.-.-.-.-,-.-X-----
------------------------------------------------------------,-X-,-.-.-.-.-.-.-.-.-.-.-.-.-.-.-.-.-.-.-.-.-.-.-.-.-.-.-.-.-.-.-.-.-.-.-.-.-.-.-.-.-.-.-.-.-.-.-.-.-.-.-.-.-.-.-.-.-.-.-.-.-,-.-X-----
------------------------------------------------------,-,-,-,-X-X-.-.-.-.-.-.-.-.-.-.-.-.-.-.-.-.-.-.-.-.-.-.-.-.-.-.-.-.-.-.-.-.-.-.-.-.-.-.-.-.-.-.-.-.-.-.-.-.-.-.-.-.-.-.-.-.-.-.-.-.-,-X-X-,-,-
------------------------------------------------------,-X-X-X-X-X-.-.-.-.-.-.-.-.-.-.-.-.-.-.-.-.-.-.-.-.-.-.-.-.-.-.-,-,-.-.-.-.-.-.-.-.-.-.-.-.-.-.-.-.-.-.-.-.-.-.-.-.-.-.-.-.-.-.-.-.-.-X-X-X-X-
------------------------------------------------------,-X-,-,-,-.-.-.-.-.-.-.-.-.-.-.-.-.-.-.-.-.-.-.-.-.-.-.-.-.-.-.-,-,-.-.-.-.-.-.-.-.-.-.-.-.-.-.-.-.-.-.-.-.-.-.-.-.-.-.-.-.-.-.-.-.-.-,-,-,-X-
------------------------------------------------------,-X-,-.-.-.-.-.-.-.-.-.-.-.-.-.-.-.-.-.-.-.-.-.-.-.-.-.-.-.-.-.-.-.-.-.-.-.-.-.-.-.-.-.-.-.-.-.-.-.-.-.-.-.-.-.-.-.-.-.-.-.-.-.-.-.-.-.-.-,-X-
------------------------------------------------------,-X-,-.-.-.-.-.-.-.-.-.-.-.-.-.-.-.-.-.-.-.-.-.-.-.-.-.-.-.-.-.-.-.-.-.-.-.-.-.-.-.-.-.-.-.-.-.-.-.-.-.-.-.-.-.-.-.-.-.-.-.-.-.-.-.-.-.-.-,-X-
------------------------------------------------------,-X-,-,-,-,-,-,-,-,-,-,-,-,-,-,-,-,-,-,-,-,-,-,-,-,-,-,-,-,-,-,-,-,-,-,-,-,-,-,-,-,-,-,-,-,-,-,-,-,-,-,-,-,-,-,-,-,-,-,-,-,-,-,-,-,-,-,-,-,-X-
------------------------------------------------------,-X-,-------------------------------------------------------------------------------------------------------------------------------------,-X-
------------------------------------------------------,-X-,-------------------------------------------------------------------------------------------------------------------------------------,-X-
------------------------------------------------------,-X-,-------------------------------------------------------E-----------------------------------------------------------------------------,-X-
------------------------------------------------------,-X-,---------------E---------------------E-----------------------------------------------------------------------------------------------,-X-
------------------------------------------------------,-X-,-------E-----------------------------------------------------------------------------------------------------------------------------,-X-
------------------------------------------------------,-X-,---------------------------E---------------------E-----------------------------------------------------------------------------------,-X-
------------------------------------------------------,-X-,-------------,-,-,-,-,-,-,-,-,-,-,-,-,-,-,-,-,-,-,-,-,-,-,-,-,-,-,-,-,-,-------------,-,-,-,-,-,-,-,-,-,-,-,-,-,-,-,-,-,-------------,-X-
------------------------------------------------------,-X-,-------------,-X-X-X-X-X-X-X-X-X-X-X-X-X-X-X-X-X-X-X-X-X-X-X-X-X-X-X-X-X-------------,-X-X-X-X-X-X-X-+-X-X-X-X-X-X-X-X-X-------------,-X-
------------------------------------------------------,-X-,-------------,-X-,-.-.-.-.-.-.-X-.-,-,-,-E-,-,-,-,-,-.-.-.-.-.-.-.-.-X-X-------------,-X-.-,-,-,-.-.-.-.-.-X-X-,-,-,-X-X-------------,-X-
------------------------------------------------------,-X-,-------------,-X-,-,-,-,-,-,-.-X-.-,-,-,-,-.-,-,-,-,-.-.-.-.-.-.-.-.-X-X-------------,-X-,-,-A-,-,-.-.-.-.-X-X-.-.-.-X-X-------------,-X-
------------------------------------------------------,-X-,-------------,-X-,-.-.-.-.-,-.-X-.-,-.-.-.-.-.-.-.-,-.-.-.-.-.-.-.-E-X-X-------------,-X-,-W-.-.-,-.-.-.-.-X-X-.-.-.-X-X-------------,-X-
------------------------------------------------------,-X-,---------E---,-X-,-E-.-E-.-,-.-X-.-,-.-.-.-.-.-.-.-,-.-.-.-.-.-.-.-.-X-X-------E-----,-X-,-,-.-,-,-.-.-.-.-X-X-.-.-<-X-X-------------,-X-
------------------------------------------------------,-X-,-------------,-X-,-,-,-,-,-,-.-X-.-E-.-.-.-.-.-.-.-,-.-E-.-.-.-.-.-E-X-X-------------,-X-.-,-,-,-,-,-,-,-.-X-X-.-.-.-X-X-------------,-X-
------------------------------------------------------,-X-,-------------,-X-,-.-.-.-.-,-.-X-.-,-,-.-.-.-.-.-.-,-.-.-.-.-.-.-.-.-X-X-,-,-,-,-,-,-,-X-.-E-.-.-X-X-X-X-X-X-X-.-.-.-X-X-------------,-X-
------------------------------------------------------,-X-,-------------,-X-,-.-.-.-.-,-.-X-.-,-,-,-,-,-,-,-,-,-.-.-.-.-.-.-.-E-X-X-.-.-.-.-.-.-,-X-,-,-,-,-X-X-.-,-.-.-,-,-,-,-X-X-------------,-X-
------------------------------------------------------,-X-,-------------,-X-,-,-,-,-,-,-.-X-.-.-.-.-.-.-.-.-.-.-.-.-.-.-.-.-.-.-X-X-,-,-,-,-,-,-,-X-,-.-.-.-X-X-.-,-.-.-.-.-.-.-X-X-------------,-X-
------------------------------------------------------,-X-,-------------,-X-,-,-,-,-,-,-.-X-.-.-.-.-.-.-.-.-.-.-.-.-.-.-.-.-.-.-X-X-.-.-.-.-.-.-A-X-,-.-.-.-X-X-.-,-.-.-.-.-.-.-X-X-------------,-X-
------------------------------------------------------,-X-,-------------,-X-,-E-,-E-,-,-.-X-X-.-X-X-X-X-X-X-X-X-X-X-.-.-.-.-.-.-X-X-.-.-.-.-.-.-.-.-,-.-.-.-X-X-.-,-.-E-.-.-.-.-X-X-------------,-X-
------------------------------------------------------,-X-,-------------,-X-,-,-,-,-,-,-.-X-X-.-X-X-X-X-X-X-X-X-X-X-.-.-.-.-.-.-X-X-.-.-.-.-.-.-.-.-,-.-.-.-X-X-.-,-.-.-.-.-.-.-X-X-------------,-X-
------------------------------------------------------,-X-X-------------,-X-,-.-.-.-.-,-.-.-.-.-,-.-,-E-.-.-.-,-.-X-.-.-.-.-.-.-X-X-.-.-.-.-.-.-.-.-,-.-E-.-X-X-.-,-.-.-.-.-.-.-X-X-------------,-X-
----------------------------------------------------------X-------------,-X-,-.-.-.-.-,-.-.-.-.-E-.-,-.-.-.-.-,-.-X-.-.-.-.-.-.-X-X-.-.-.-.-.-.-.-.-,-.-.-.-X-X-,-,-.-E-.-.-.-.-X-X-------------,-X-
----------------------------------------------------------X-------------,-X-,-,-,-,-,-,-.-.-.-.-,-.-,-.-.-.-.-,-.-X-.-.-.-E-.-.-X-X-.-.-.-.-.-.-.-.-,-,-,-<-X-X-.-,-.-.-.-.-.-.-X-X-------------,-X-
----------------------------------------------------------X-------------,-X-,-.-.-.-.-,-.-.-.-.-,-.-,-.-.-.-.-,-X-X-X-X-X-X-X-X-X-X-.-.-.-.-.-.-.-X-X-X-X-X-X-X-X-X-X-X-X-+-X-X-X-X-------------,-X-
----------------------------------------------------------X-------------,-X-,-.-.-.-.-,-.-.-.-.-E-.-,-.-.-.-.-.-X-X-X-X-X-X-X-X-X-X-.-.-.-.-.-.-.-X-X-X-X-X-X-X-X-X-X-X-X-,-X-X-X-X-------------,-X-
----------------------------------------------------------X-------------,-X-,-,-,-,-,-,-.-.-.-.-,-.-,-,-,-,-,-.-X-X-,-,-.-,-.-.-.-.-.-.-.-.-.-.-.-.-.-.-.-.-W-.-A-.-,-<-------<-----------------,-X-
----------------------------------------------------------X-------------,-X-,-,-E-,-,-,-.-.-.-.-,-.-.-.-.-.-,-.-X-X-.-,-,-,-.-.-.-.-.-.-.-.-.-.-.-.-.-.-.-.-.-.-,-.-,-H-------------------------,-X-
----------------------------------------------------------X-------------,-X-,-,-,-,-,-,-.-.-.-.-,-,-,-,-,-,-,-.-X-X-,-,-.-,-.-.-.-.-.-.-.-.-.-.-.-.-.-.-.-.-.-.-A-.-,-A-------------------------,-X-
----------------------------------------------------------X-------------,-X-,-.-.-.-.-,-.-.-.-.-.-.-.-E-.-E-.-.-X-X-.-,-,-,-.-.-.-.-.-.-.-E-.-.-.-.-.-.-.-.-.-.-,-.-,-<-------------------------,-X-
----------------------------------------------------------X-------------,-X-,-,-,-,-,-,-.-.-.-.-.-.-.-.-.-.-.-.-X-X-,-,-.-,-.-.-.-.-.-.-.-.-.-.-.-.-.-.-.-.-.-.-,-.-,---------------------------,-X-
----------------------------------------------------------X-------------,-X-,-.-.-.-.-.-.-.-.-.-.-.-.-.-.-.-.-.-X-X-.-,-,-,-.-A-.-.-.-.-.-.-.-.-.-.-.-.-.-.-.-.-,-.-,-<-------------------------,-X-
------------------------------,-,-,-----------------------X-------------,-X-X-X-X-X-X-X-X-X-X-X-X-X-X-X-X-X-.-.-X-X-.-,-.-,-.-.-.-.-.-.-.-.-.-.-.-.-.-.-.-.-.-.-,-.-,-,-B-,-,-<-,-,-------------,-X-
------------------------------,-X-X-X-X-X-X-X-X-X-X-X-X-X-X-------------,-X-X-X-X-X-X-X-X-X-X-X-X-X-X-X-X-X-.-.-X-X-.-X-X-X-X-X-X-X-.-.-.-.-.-.-.-X-X-X-X-X-X-X-X-X-X-X-.-.-.-X-X-X-------------,-X-
------------------------------,-X-,-------------------------------------------------------,-.-.-.-X-X-E-H-X-.-.-X-X-+-X-,-,-,-,-,-X-.-.-.-.-.-.-.-X-X-X-X-X-X-X-X-X-X-X-,-,-,-X-X-X-------------,-X-
------------------------------,-X-,-------E---E-----------------------------------E-------,-.-.-.-X-X-.-,-X-.-.-X-X-.-X-X-X-X-X-X-X-.-.-.-.-.-.-.-X-X-E-.-E-,-.-.-.-.-.-E-.-.-H-X-X-------------,-X-
------------------------------,-X-,-------------------------------------------------------,-.-.-.-X-X-.-,-X-.-.-.-.-E-.-,-.-E-.-X-X-.-.-.-.-.-.-.-X-X-.-.-,-,-.-.-.-E-.-.-.-E-,-.-,-------------,-X-
------------------------------,-X-,---:---E-----------------------------------------E-----,-.-.-,-X-X-E-,-X-.-.-.-.-.-.-,-.-.-.-X-X-.-.-.-.-.-.-.-X-X-.-.-E-,-.-E-.-,-,-E-,-,-A-X-X-------------,-X-
------------------------------,-X-,-------------------------------------------------------,-.-.-,-X-X-.-,-X-.-.-.-.-.-E-X-X-,-,-X-X-.-.-.-.-.-.-.-X-X-,-,-,-X-X-X-X-X-X-.-.-.-X-X-X-------------,-X-
------------------------------,-X-,---E-----------------------------------------------E---,-.-.-,-,-.-.-,-X-.-.-.-E-.-.-X-X-.-.-,-,-.-.-.-.-.-.-.-X-X-,-,-,-X-X-X-X-X-X-,-,-,-X-X-X-------------,-X-
------------------------------,-X-,-------------------,-,-,-,-,-,-,-,-,-,-,---------------,-.-.-,-,-.-E-,-X-E-.-.-.-.-.-X-X-.-.-,-,-.-B-.-.-.-.-.-X-X-.-.-.-,-,-,-,-.-.-.-.-.-.-.-,-------------,-X-
------------------------------,-X-,---------------X-X-X-X-X-X-X-X-X-X-X-X-X-X-------------,-.-.-,-X-X-.-,-X-.-.-.-.-E-.-X-X-.-.-X-X-,-,-,-,-,-,-,-X-X-.-.-.-,-,-,-,-.-E-.-.-.-.-.-,-------------,-X-
------------------------------,-X-,-------------,-X-,-X-.-.-.-,-.-.-,-.-.-X-X-------------,-.-.-.-X-X-.-,-X-X-.-.-E-.-,-X-X-.-.-X-X-,-,-,-,-,-,-,-X-X-.-.-.-,-,-,-,-,-,-,-,-,-,-.-,-------------,-X-
------------------------------,-X-,-------------,-X-X-X-.-.-.-,-.-.-,-E-,-X-X-------------,-.-.-,-X-X-.-.-,-X-X-X-X-X-X-X-.-.-.-X-X-------------,-X-X->->->->->-X-X-X-X-,-,-,-X-X-X-------------,-X-
------------------------------,-X-,-------------,-.-+-+-.-.-.-,-.-.-.-.-,-X-X-------------,-.-.-,-X-X-.-.-.-.-X-X-X-X-X-.-.-.-.-X-X-------------,-X-,-X-.-.-,-X-X-X/X/X/.-.-.-X-X-X-------------,-X-
------------------------------,-X-,-------------,-.-+-+-.-E-.-,-.-.-.-.-,-X-X-------------,-.-.-,-,-.-.-.-.-.-.-.-.-.-E-.-.-.-.-,-,-------------,-X-,-X-.-E-,-X-A-./././.-.-.-H-X-X-------------,-X-
------------------------------,-X-,-------------,-.-+-+-.-.-.-,-,-,-,-,-,-X-X-------------,-.-.-,-,-.-W-.-.-.-.-E-.-.-.-.-.-.-.-,-,-------------,-X-,-X-.-.-,-X-,-./././.-.-E-,-.-,-------------,-X-
------------------------------,-X-,-------------,-X-X-X-.-.-.-.-.-.-.-.-.-X-X-------------,-.-.-,-X-X-A-A-.-.-.-.-.-.-.-.-.-.-,-X-X-------------,-X-,-X-.-.-,-X-,-./././.-.-.-,-X-X-------------,-X-
------------------------------,-X-,---------------X-,-X-E-E-.-.-.-.-.-.-.-X-X-------------,-.-.-.-X-,-X-,-,-X-X-X-X-X-X-X-,-,-X-,-X-------------,-X-,-XQ+Q+Q+QX-,-X/X/X/X-X-X-X-X-X-------------,-X-
------------------------------,-X-,---------------X-,-X-E-.-E-.-.-.-.-.-.-X-X-------------,-.-.-.-X-X-X-,-,-X-X-X-X-X-X-X-,-,-X-X-X-------------,-X-X-X-.-.-,-X-,-X-X-X-X-X-X-X-X-X-------------,-X-
,-,-,-,-,-,-,-,-,-,-,-,-,-,-,-,-X-,-------------,-X-,-,-X-X-X-,-.-.-.-.-.-X-X-------------,-.-.-H-.-.-.-.-.-.-.-.-.-.-.-.-.-.-.-.-,-------------,-.-.-.-.-.-.-.-.-.-.-.-.-.-.-H-.-,-------------,-X-
X-X-X-X-X-X-X-X-X-X-X-X-X-X-X-X-X-,-------------,-X-X-X-X-X-X-X-.-.-.-.-.-X-X-------------,-.-.-.-.-.-.-.-.-.-.-.-.-.-.-.-.-.-.-.-,-------------,-.-.-.-.-.-.-.-.-.-.-.-.-.-.-.-.-,-------------,-X-
X-,-,-,-,-,-,-,-,-,-,-,-,-,-,-,-,-,-------------,-X-.-H-,-,-,-X-.-.-E-.-.-X-X-------------,-,-,-,-,-,-,-,-,-,-,-,-,-,-,-,-,-,-,-,-,-------------,-,-,-,-,-,-,-,-,-,-,-,-,-,-,-,-,-,-------------,-X-
X-,-.-.-E-,-E-,-.-E---E-.-,---,-.-,-------------,-,-W-,-.-.-.-X-.-.-.-.-.-X-X-------------------------------------------------------------------------------------------------------------------,-X-
X-,-.-.-.-,---,-.-,---,-.-,---,-.-,-------------,-,-.-,-.-.-.-X-X-.-.-X.X.X.X-----------------------------------------------------------------------E-------------------------------------------,-X-
X-,-E-.-.-,---,-.-,---,-.-,---,-.-,-------------,-,-.-,-.-.-.-X-X-.-.-X-X---X---------------------------------------E---------------------------------------------E-----------------------------,-X-
X-,-,-,-E-,---E-.-E---,-.-,---,-.-,-------------,-X-E-,-.-.-.-X-.-.-.-.-X.--X---------------------------E---------------------------------------------------------------------------------------,-X-
X-,-E---------,-,-,---,-,-,---,-,-,-------------,-X-.-,-.-.-.-X-.-.-.-.-X.--X-------------------------------------------------------------W-------------------------E---------------------------,-X-
X-,-,-,-,-E-------------------------------------,-X-.-,-,-,-,-X-,-,-,-,-X.,-X-----------------------------------E-------------------------E---------------E-------------------------------------,-X-
X-,-.-.-.-,-------------------------------------,-X-.-.-.-.-.-X-X-.-.-X.X.X.X-------------------------------------------------E-----------------------------------------------------------------,-X-
X-,-,-,-,-,-------------------------------------,-X-.-E-.-.-.-X-.-.-.-.-,-X-X-------------------------------------------------------------------------------------------------------------------,-X-
X-,-------------,-,-,-,-,-,-,-,-,-,-------------,-,-.-.-.-.-.-X-.-.-.-.-,-.-,-------------,-,-,-,-,-,-,-,-,-,-,-,-,-,-,-,-,-,-,-,-,-------------,-,-,-,-,-,-,-,-,-,-,-,-,-,-,-,-,-,-------------,-X-
X-,-,-,-,-,-----,-.-.-.-.-.-.-.-.-,-------------,-,-.-.-.-E-.-X-.-.-.-.-,-.-,-------------,-.-.-.-.-.-.-.-.-.-.-.-.-.-.-.-.-.-.-.-,-------------,-.-.-.-.-.-.-.-.-.-.-.-.-.-.-.-.-,-------------,-X-
X-,-.-.-.-,-----,-.-.-.-.-.-.-.-.-,-------------,-,-E-.-.-.-.-+-.-.-.-.-,-.-,-------------,-.-.-.-.-.-.-.-.-.-.-.-.-.-.-.-.-.-.-.-,-------------,-.-.-.-.-.-.-.-.-.-.-.-.-.-.-.-.-,-------------,-X-
X-,-,-,-,-,-----,-.-.-.-.-.-.-.-.-,-------------,-X-.-.-.-.-.-X-.-.-.-.-,-X-X-------------,-.-.-H-.-.-.-.-.-,-,-,-,-,-,-.-.-.-.-.-,-------------,-.-.-.-.-.-,-,-,-,-,-,-.-.-.-H-.-,-------------,-X-
X-,-------------,-.-.-.-.-.-.-.-.-,-------------,-X-.-.-.-.-.-X-.-.-.-.-.-X-X-------------,-.-.-,-X-X-X-X-X-X-X-,-,-,-X-X-X-X-X-X-X-------------,-X-X-X-X-X-X-X-L-L-L-X-X-X-X-X-X-X-------------,-X-
X-,-,-,-,-,-----,-,-,-,-,-,-,-,-,-,-------------,-X-X-X-X-X-X-X-.-.-E-.-.-X-X-------------E-.-E-,-X-X1X1X1X-X-X-+-+-+-X-X-X-X-X-X-X-------------,-X-X-X-X-X-X-X-L-L-L-X-X-X-X-X-X-X-------------,-X-
X-,-.-.-.-,-------------------------------------,-X-X-X-X-X-X-X-.-.-.-.-,-X-X-------------,-.-.-,-X-.-.-,-.-.-.-.-.-.-.-,-,-,-E-X-X-------------,-X-.-.-.-.-.-.-.-.-.-.-.-.-.-.-X-X-------------,-X-
X-,-,-,-,-,-------------------------------------,-X-.-.-.-.-.-X-.-.-.-.-,-X-X-------------,-.-.-,-X-.-E-,-.-.-.-.-.-.-.-,-,-,-,-X-X-------------,-X-.-.-.-.-.-.-.-.-.-.-.-.-.-.-X-X-------------,-X-
X-,---------------------------------------------,-,-E-.-.-E-.-X-.-.-E-.-,-.-,-------------,-.-.-,-X-.-.-,-.-.-.-.-.-.-.-,-,-,-,-X-X-------------,-X-.-.-.-.-.-.-.-X-X-X-X-X-.-.-X-X-------------,-X-
X-,-,-,-,-,---,-,-,---,-,-,---,-,-,---,-,-,---,-,-,-.-.-.-.-.-+-.-.-.-.-,-.-,-------------,-.-.-,-X-.-E-,-.-.-.-.-.-.-.-,-,-,-,-X-X-------------,-X-.-.-.-.-.-.-.-X-X-X-X-X-.-.-X-X-------------,-X-
X-,-.-.-.-,---,-.-,---,-.-,---,-.-,---,-.-,---,-,-,-.-E-.-.-.-X-.-.-.-.-,-.-,-------------,-.-.-,-X-.-.-,-.-.-.-.-.-.-.-,-,-,-,-X-X-------------,-X-.-.-.-.-.-.-.-.-.-,-W-X-.-.-X-X-------------,-X-
X-,-.-.-.-,---,-.-,---,-.-,---,-.-,---,-.-,---,-,-X-.-,-,-,-,-X-.-.-E-.-,-X-X-------------,-.-.-,-X-.-E-,-.-.-.-.-.-.-.-,-,-,-,-X-X-------------,-X-.-.-.-.-.-.-.-.-E-,-W-X-.-.-X-X-------------,-X-
X-,-.-.-.-,---,-.-,---,-.-,---,-.-,---,-.-,---,-,-X-.-,-.-.-.-X-.-.-.-.-.-X-X-------------,-.-.-,-X-.-.-,-.-.-.-.-.-.-.-,-,-,-,-X-X-------------,-X-.-.-.-.-.-.-.-.-.-,-A-X-.-.-X-X-------------,-X-
X-,-,-,-,-,-,-,-,-,-,-,-,-,-,-,-,-,-,-,-,-,-,-,-,-X-.-,-.-.-.-X-.-.-.-.-.-X-X-------------,-.-.-,-X-.-E-,-.-.-.-.-.-.-.-,-,-,-,-X-X-------------,-X-.-.-E-.-.-.-.-X-X-X-X-X-.-.-X-X-------------,-X-
X-.-.-.-.-.-.-.-.-.-.-.-.-.-.-.-.-.-.-.-.-.-.-.-.-X-.-,-.-.-.-X-X-X-L-X-X-X-X-------------,-.-.-,-X-.-.-X-X-H-A-,-A-,-A-X-X-,-,-X-X-------------,-X-,-,-,-,-,-.-.-X-X-.-.-X-.-.-X-X-------------,-X-
X-X-X-X-X-X-X-X-X-X-X-X-X-X-X-X-X-X-X-X-X-X-X-X-X-X-.-,-.-.-.-X-X-X-,-X-X-X-,-------------,-.-.-,-X-.-E-X-X-.-.-.-.-.-.-X-X-.-.-X-X-------------,-X-.-,-.-,-,-.-.-X-X-.-.-+-.-.-X-X-------------,-X-
------------------------------,-X-X-X-X-X-X-X-X-X-X-.-<-.-.-.-X-X-,-,-.-.-X-,-------------,-.-.-,-X-.-.-.-.-.-.-.-.-.-.-.-.-.-.-X-X-------------,-X-:-,-,-,-,-.-.-X-X-E-.-X-.-.-X-X-------------,-X-
------------------------------,-X-.-.-.-.-.-.-K-X-X-.-,-,-A-,-X-X-,-,-.-.-X-,-------------,-.-.-,-X-.-E-.-.-.-E-.-.-.-E-.-.-.-E-X-X-------------,-X-,-,-,-,-,-.-.-X-X-.-.-X-.-.-X-X-------------,-X-
------------------------------,-X-.-.-.-.-.-.-.-X-X-.-,-.-.-.-X-X-,-,-.-.-X-,-------------,-.-.-,-X-X-X-X-,-,-,-,-E-,-,-,-X-X-A-X-X-------------,-X-.-.-.-E-.-.-.-X-X-E-.-.-.-E-X-X-------------,-X-
------------------------------,-X-.-.-.-.-.-.-.-X-X-X-X-X-X-X-X-X-,-,-.-.-X-,-------------,-.-.-.-X-----,-X-.-.-X-X-.-.-X-,-X-+-X-X-------------,-X-X-X-X-X-X-X-X-X-X-X-X-X-X-X-X-X-------------,-X-
------------------------------,-X-.-.-E-.-.-.-.-X-X-X-X-X-X-X-X-X-,-,-.-.-X-,-----E-------,-,-,-,-X-X-X-X-X-,-,-X-X-,-,-X-X-X-A-X-X---------------X-X-X-X-X-X-X-X-X-X-X-X-X-X-X-X-X-------------,-X-
------------------------------,-X-.-.-.-.-.-.-.-.-.-.-.-.-.-.-.-.-,-,-.-.-X-,---------------------------,-,-,-,-,-,-,-,-,-,-,-,-,---------------------------------------------------------------,-X-
------------------------------,-X-.-.-.-.-.-.-.-.-.-.-.-.-.-.-.-.-.-.-.-.-X-,-------------------------------------------------------------------------------------------------------------------,-X-
------------------------------,-X-.-.-.-.-.-.-.-.-.-.-.-.-.-.-.-.-.-.-.-.-X-,---------------E---------------------------------E---E-------------------------------------------------------------,-X-
------------------------------,-X-.-.-.-.-.-.-E-.-.-.-.-.-.-.-.-.-.-.-.-.-X-,---------------------------E-----------------E---------------W-----------------------------------------------A-----,-X-
------------------------------,-X-.-.-.-.-.-.-.-.-.-.-B-.-.-.-.-.-.-.-.-.-X-,-----E-------------------------------------------------------------------------------------------------------------,-X-
------------------------------,-X-.-.-.-.-.-.-.-.-.-.-.-.-.-.-.-.-.-.-.-.-X-,-------------------------------------------------------------------------------------------------------------------,-X-
------------------------------,-X-.-.-.-.-.-.-.-.-.-.-.-.-.-.-.-.-.-.-.-.-X-,-,-,-,-,-,-,-,-,-,-,-,-,-,-,-,-,-,-,-,-,-,-,-,-,-,-,-,-,-,-,-,-,-,-,-,-,-,-,-,-,-,-,-,-,-,-,-,-,-,-,-,-,-,-,-,-,-,-,-X-
------------------------------,-X-.-.-E-.-.-.-.-.-.-.-.-.-.-.-.-.-.-.-.-.-X-X-X-X-X-X-X-X-X-X-X-X-X-X-X-X-X-X-X-X-X-X-X-X-X-X-X-X-X-X-X-X-X-X-X-X-X-X-X-X-X-X-X-X-X-X-X-X-X-X-X-X-X-X-X-X-X-X-X-X-X-
------------------------------,-X-.-.-.-.-.-.-.-.-.-.-.-.-.-.-.-.-.-.-.-.-X-------------------------------------------------------------------------------------------------------------------------
------------------------------,-X-.-.-.-.-.-.-.-.-.-.-.-.-.-.-.-.-.-.-.-.-X-------------------------------------------------------------------------------------------------------------------------
------------------------------,-X-X-X-X-X-X-X-X-X-X-X-X-X-X-X-X-X-X-X-X-X-X-------------------------------------------------------------------------------------------------------------------------
