----------------------------------------------------------------------------------------------------------------------------------------------------------,-X-X-X-X-X---------------------------------------------------------------------
------------------------------------------------------------------------------------------------------------------------------------------------------,-,-,-X-.-.-,-X-,-,-----------------------------------------------------------------
------------------------------------------------------------------------------------------------------------------------------------------------------,-X~X~X~.4A4,4X~X~X~----------------------------------------------------------------
------------------------------------------------------------------------------------------------------------------------------------------------------,-X~.~,~.-.-,-.~.~X~----------------------------------------------------------------
------------------------------------------------------------------------------------------------------------------------------------------------------,-X~.~,~.-.-,-.~.~X~----------------------------------------------------------------
------------------------------------------------------------------------------------------------------------------------------------------,-,-,-,-,-,-,-X~.~,~.-.-,-.~.~X~,-,-,-,-,-,-----------------------------------------------------
------------------------------------------------------------------------------------------------------------------------------------------,-X~X~X~X~X~X~X~.~,~.-E-,-.~.~X~X~X~X~X~X~X~----------------------------------------------------
----------------------------------------------------------------------------------------------------------------------------------------,-,-X~.~.~.~.~.~.~.~,~.-.-,-.~.~.~.~.~.~.~,~X~,---------------------------------------------------
----------------------------------------------------------------------------------------------------------------------------------------,-X-X-.~,~,~,~,~,~,~,~.-.-,-,~,~,~,~,~,~.~,~X-X---------------------------------------------------
----------------------------------------------------------------------------------------------------------------------------------------,-X-,-.~,~.-.-.-.-.-.-.-.-.-.-.-.-.-.-,-.~,~.-X---------------------------------------------------
----------------------------------------------------------------------------------------------------------------------------------------,-X-,-.~,~.-A-.-.-.-E-.-.-.-E-.-.-.-A-,-.~,~.-X---------------------------------------------------
----------------------------------------------------------------------------------------------------------------------------------------,-X-,-.~,~.-.-.-.-.-.-.-.-.-.-.-.-.-.-,-.~,~.-X---------------------------------------------------
----------------------------------------------------------------------------------------------------------------------------------------,-X-,-.~,~.-.-.-.-.-E-.-.-.-.-.-.-.-.-,-.~,~.-X---------------------------------------------------
----------------------------------------------------------------------------------------------------------------------------------------,-X-,-.~,~.-.-.-.-.-.-.-.-.-.-.-.-.-.-,-.~,~.-X---------------------------------------------------
----------------------------------------------------------------------------------------------------------------------------------------,-X-,-.~,~.-A-.-.-.-.-.-E-.-.-.-.-.-A-,-.~,~.-X---------------------------------------------------
----------------------------------------------------------------------------------------------------------------------------------------,-X-,-.~,~,-,-,-,-,-,-.-.-,-,-,-,-,-,-,-.~,~.-X---------------------------------------------------
----------------------------------------------------------------------------------------------------------------------------------------,-X-X-.~.~.~.~.~.~.~,~.-.-,-.~.~.~.~.~.~.~,~X-X---------------------------------------------------
------------------------------------------------------------------------------------------------------------------------------------------,-X~,~,~,~,~,~,~.~,~.-.-,-.~,~,~,~,~,~,~,~X~----------------------------------------------------
------------------------------------------------------------------------------------------------------------------------------------------,-XT+T+T+T+T+T+T.~,~.-E-,-.~,~+T+T+T+T+T+TXT----------------------------------------------------
------------------------------------------------------------------------------------------------------------------------------------------,-X-.-.-.-.-.-+T.~,~.-.-,-.~,~+T.-.-.-.-.-X-----------------------------------------------------
------------------------------------------------------------------------------------------------------------------------------------------,-X-.-.-.-.-.-+T.~,~.-.-,-.~,~+T.-.-.-.-.-X-----------------------------------------------------
------------------------------------------------------------------------------------------------------------------------------------------,-X-.-.-.-.-.-+T.~,~.-.-,-.~,~+T.-.-.-.-.-X-----------------------------------------------------
------------------------------------------------------------------------------------------------------------------------------------------,-X-.-E-.-.-.-+T.~,~.-E-,-.~,~+T.-.-.-E-.-X-----------------------------------------------------
------------------------------------------------------------------------------------------------------------------------------------------,-X-A-.-.-.-.-+T.~,~.-.-,-.~,~+T.-.-.-.-A-X-----------------------------------------------------
------------------------------------------------------------------------------------------------------------------------------------------,-X-X-X-X-X-X-XTX~X~.-.-,-X~X~XTX-X-X-X-X-X-----------------------------------------------------
----------------------------------------------------------------------------------------------------------------------------------------------------------,-X-.-.-.-X---------------------------------------------------------------------
----------------------------------------------------------------------------------------------------------------------------------------------------------,-X-,-,-,-X---------------------------------------------------------------------
------------------------------------------------------------------------------------------------------------------------------------------------------,-,-,-X-L-L-L-X-,-,-----------------------------------------------------------------
----------------------------------------------------------------------------------------------------------------------------------------------------,-,-X-X-X-,-,-,-X-X-X-----------------------------------------------------------------
----------------------------------------------------------------------------------------------------------------------------------------------------,-.-X-.-.-.-.-.-.-.-,-X---------------------------------------------------------------
--------------------------------------------------------------------------------------------------------------------------------------------------,-,-X-.-.-.-.-E-.-.-.-.-X---------------------------------------------------------------
--------------------------------------------------------------------------------------------------------------------------------------------------,-.-X-.-.-.-.-.-.-.-.-.-,-X-------------------------------------------------------------
------------------------------------------------------------------------------------------------------------------------------------------------,-,-X-.-E-.-.-.-.-.-.-.-E-.-X-------------------------------------------------------------
------------------------------------------------------------------------------------------------------------------------------------------------,-.-X-.-.-.-.-.-.-.-.-.-.-.-,-X-----------------------------------------------------------
----------------------------------------------------------------------------------------------------------------------------------------------,-,-X-.-.-.-.-.-.-E-.-.-.-.-.-.-X-----------------------------------------------------------
------,-,-,-,-,-,-----------------------------,-,-,-,-,-,-------------------------------------------------------------------------------------,-.-X-.-.-.-.-.-.-.-.-.-.-.-.-.-,-X---------------------------------------------------------
----,-,-X-X-X-X-X-,-------------------------,-,-X-X-X-X-X-,---------------------------------------------------------------------------------,-,-X-.-.-.-E-.-.-.-.-.-.-.-E-.-,-,-X-,-------------------------------------------------------
--,-,-X-.-.-.-.-.-X-,---------------------,-,-X-.-.-.-.-.-X-,-----------------------------------------------------------------------------,-,-X-,-,-,-.-.-.-.-.-.-.-.-.-,-,-,-,-.-X-------------------------------------------------------
,-,-X-.-.-.-.-.-.-.-X-,-----------------,-,-X-.-.-.-.-.-.-.-X-,-------------------------------------------------------------------------,-,-X-.-A-,-,-,-,-.-.-.-E-.-,-,-,-,-,-.-A-X-,-----------------------------------------------------
,-X-.-.-.-.-.-.-.-.-.-X-,-,-,-,-,-,-,-,-,-X-.-.-.-.-.-.-.-.-.-X-,---------------------------------------------------------------------,-,-X-.-.-.-.-,-,-,-,-,-.-,-,-,-.-,-,-.-.-.-.-X-----------------------------------------------------
X-.-.-.-H-.-.-.-.-.-.-.-X-X-X-X-X-X-X-X-X-.-.-.-.-.-.-.-.-.-.-.-X-------------------------------------------------------------------,-,-X-.-.-.-.-.-.-,-,-.-,-,-,-.-.-,-,-.-.-.-<-.-X-,---------------------------------------------------
X-.-.-.-.-.-.-.-.-.-.-.-.-.-.-.-.-.-.-.-.-.-.-.-.-.-.-.-.-.-.-.-X-----------------------------------------------------------------,-,-X-.-.-.-.-.-.-.-.-,-,-.-.-.-.-,-,-.-.-.-.-.-.-.-X---------------------------------------------------
X-.-.-.-.-.-.-.-.-.-.-.-.-.-.-.-.-.-.-.-.-.-.-.-.-.-.-.-.-.-.-.-X---------------------------------------------------------------,-,-X-.-.-.-.-.-.-.-.-.-.-,-,-.-.-,-,-.-.-.-.-.-.-.-.-X-,-------------------------------------------------
X-.-.-.-.-.-.-.-.-.-.-.-.-.-.-.-.-.-.-.-.-.-.-.-.-.-.-.-.-.-.-.-X-----------------------------------------------------,-,-,-,-,-,-X-.-.-.-.-.-.-.-.-.-.-.-.-,-,-,-,-.-.-.-.-.-.-.-.-.-.-X-------------------------------------------------
X-.-.-.-.-.-.-.-.-.-.-.-.-.-.-.-.-.-.-.-.-.-.-.-E-.-.-.-.-.-.-.-X---------------------------------------------------,-,-X-X-X-X-X-.-.-.-.-.-.-.-.-.-.-.-.-.-.-,-,-.-.-.-.-.-.-.-.-.-.-.-X-,-----------------------------------------------
X-.-.-.-.-.-.-.-.-.-.-.-.-.-.-.-.-.-.-.-.-.-.-.-.-.-.-.-.-.-.-.-X-------------------------------------------------,-,-X-.-.-.-,-.-.-.-.-.-.-.-.-.-.-.-.-.-.-.-.-.-.-.-.-.-.-.-.-.-.-.-.-.-X-----------------------------------------------
,-X-.-.-.-.-.-.-E-.-.-.-.-.-.-.-.-.-.-.-.-.-.-.-.-.-.-.-.-.-.-.-,-X-----------------------------------------------,-.-X-.-.-A-,-.-.-.-.-.-.-.-.-.-.-.-.-.-.-.-.-.-.-.-.-.-.-.-.-.-.-.-.-.-X-,---------------------------------------------
--X-.-.-.-.-.-.-.-.-.-.-.-.-.-.-.-.-.-.-.-.-.-.-.-.-.-.-.-.-.-.-.-X---------------------------------------------,-,-X-.-.-.-.-,-.-.-.-.-.-.-.-.-.-.-.-.-.-.-.-.-.-.-.-.-.-.-.-.-.-.-.-.-.-.-X---------------------------------------------
--,-X-.-.-.-.-.-.-.-.-.-.-.-.-.-E-.-.-.-.-.-.-.-.-.-.-.-.-.-.-.-.-X-------------------------------------------,-,-X-.-.-.-.-.-,-.-.-.-.-.-.-.-.-.-.-.-.-.-.-.-.-.-.-.-.-.-.-.-.-.-.-.-.-.-.-X-,-------------------------------------------
----X-.-.-.-.-.-.-.-.-.-.-.-.-.-.-.-.-.-.-.-.-.-.-.-.-.-.-.-.-.-.-X-----------------------------------------,-,-X-.-.-.-.-.-.-,-.-.-.-.-.-.-.-.-.-.-.-.-.-.-.-.-.-.-.-.-.-.-.-.-.-.-.-.-.-.-.-X-------------------------------------------
----,-X-.-.-.-.-.-.-.-.-.-.-.-.-.-.-.-.-.-.-.-.-.-.-.-.-.-.-.-.-.-,-X---------------------------------------,-.-X-.-.-.-.-.-.-,-.-.-.-.-.-.-.-.-.-.-.-.-.-.-.-.-.-.-.-.-.-.-.-.-.-.-.-.-.-.-.-X-,-----------------------------------------
------X-.-.-.-.-.-.-.-.-.-.-.-.-.-.-.-.-.-.-.-.-.-.-.-.-.-.-.-.-.-.-X-------------------------------------,-,-X-.-.-.-.-.-.-.-,-,-.-.-.-.-.-.-.-.-.-.-.-.-.-.-.-.-.-.-.-.-.-.-.-.-.-.-.-.-.-.-,-X-,-,-,-,---------------------------------
------,-X-X-X-X-X-X-X-X-X-.-.-.-.-.-.-.-.-.-.-.-X-X-X-X-X-.-.-.-.-.-X-----------------------------------,-,-X-.-.-.-.-.-.-.-.-,-X-,-.-.-.-.-.-.-.-.-.-.-.-.-.-.-.-.-.-.-.-.-.-.-.-.-E-.-.-.-.-,-X-X-X-X-X-,-------------------------------
------,-,-,-,-,-,-,-,-,-,-X-.-.-.-.-.-.-.-.-.-X-.-.-.-.-X-.-.-.-.-.-X---------------------------------,-,-X-.-.-.-.-.-.-.-.-.-X-X-,-.-.-.-.-.-.-.-.-.-.-.-.-.-.-.-.-.-.-.-.-.-.-.-.-.-.-.-.-.-,-.-.-.-.-.-X-------------------------------
----,-,-X-X-X-X-X-X-X-X-X-X-.-.-.-.-.-.-.-.-.-X-.-.-.-.-.-X-.-.-.-.-,-X-------------------------------,-.-X-.-.-.-.-.-.-.-.-,-X-X-,-,-.-.-.-.-.-.-.-.-.-.-.-.-.-.-.-.-.-.-.-.-.-.-.-.-.-.-.-.-,-.-.-A-.-.-X-,-----------------------------
----,-X-.-.-.-.-.-.-.-.-.-X-X-.-.-.-.-.-.-.-X-.-.-.-.-.-.-X-.-.-.-.-.-X-----------------------------,-,-X-.-.-.-.-.-.-.-.-,-X-X-,-,-,-,-.-.-.-.-.-.-.-.-.-.-.-.-.-.-.-.-.-.-.-.-.-.-.-.-.-.-.-,-.-.-.-.-.-.-X-,---------------------------
--,-,-X-B-.-B-.-B-.-B-.-.-X-X-.-.-.-.-.-.-.-X-.-.-.-.-.-.-.-X-.-.-.-.-X---------------------------,-,-X-.-.-.-.-.-.-.-.-.-X-,-X-.-,-.-,-.-.-.-.-.-.-.-.-.-.-.-.-.-.-.-.-.-.-.-.-.-.-.-.-.-.-.-,-X-.-.-.-.-.-.-X---------------------------
,-,-X-.-.-.-.-.-.-.-.-.-.-.-X-X-.-.-.-.-.-.-X-.-.-.-.-.-.-.-X-.-.-.-.-X-------------------------,-,-X-.-.-.-.-.-.-.-.-.-,-X-X-.-.-,-,-,-,-.-.-.-.-,-,-,-,-,-,-,-,-,-,-,-,-,-,-.-.-.-.-.-.-.-,-X-,-X-.-.-.-.-.-X-,-,-,-,-,-,-,-,-,---------
,-X-B-.-.-.-.-.-.-.-B-.-.-.-.-X-.-.-.-.-.-.-X-.-.-.-.-.-.-.-X-.-.-.-.-,-X-----------------------,-.-X-.-.-.-.-.-.-.-.-,-X-X-.-.-.-.-,-.-,-,-.-.-.-,-.-.-.-.-.-.-.-.-.-.-.-.-,-.-.-.-E-.-.-,-X-----,-X-.-.-.-.-.-X-X-X-X-X-X-X-X-X---------
,-X-.-.-.-.-.-.-.-.-.-.-.-.-.-X-X-.-.-.-.-.-X-.-.-.-.-.-.-.-X-.-.-.-.-.-X-,-,-,-,-,-,-,-,-,-,-,-,-X-.-.-.-.-.-.-.-.-.-X-,-X-.-.-.-.-,-.-.-,-.-.-.-,-.-H-.-H-.-H-.-H-.-H-.-H-,-.-.-.-.-.-,-X---------,-X-.-.-.-.-.-.-.-.-.-.-.-.-X---------
X-.-B-.-.-.-E-.-.-.-B-.-.-.-.-.-X-.-.-.-.-.-X-.-.-.-.-.-.-.-X-.-.-.-.-.-X-X-X-X-X-X-X-X-X-X-X-X-X-.-.-.-.-.-.-.-<-.-,-X-X-.-.-.-E-.-,-,-.-,-,-.-.-,-.-.-.-.-.-.-.-.-.-.-.-.-,-.-.-.-.-,-X-------------,-X-.-A-.-.-.-A-.-E-.-A-.-X---------
X-.-.-.-.-.-.-.-.-.-.-.-.-.-.-.-L-.-.-.-.-.-X-.-.-.-.-.-.-.-X-.-.-.-.-.-A-.-A-.-L-.-.-.-.-.-.-.-.-.-.-.-.-.-.-.-.-,-X-,-X-.-.-.-.-.-.-,-.-.-,-,-.-,-.-H-.-A-,-A-,-A-,-A-.-H-,-.-.-,-,-X---------------,-X-.-.-.-.-.-.-.-.-.-.-.-X---------
X-.-B-.-.-.-.-.-.-.-B-.-.-.-.-.-L-.-.-.-.-.-X-.-.-.-.-.-.-.-X-.-.-.-.-.-.-.-.-.-L-.-A-.-<-.-.-.-.-.-.-.-.-.-.-.-.-X---,-X-.-.-.-.-.-.-,-,-.-.-,-.-,-.-.-.-,-.-.-.-.-,-.-.-.-,-.-,-,-X-,---------------,-X-.-.-.-X-X-X-X-X-.-E-.-X---------
>-.-.-.-.-.-.-.-.-.-.-.-.-.-.-.-L-.-.-.-.-.-X-.-.-.-.-.-.-.-X-.-.-.-.-.-A-.-A-.-L-.-.-.-.-.-.-.-.-.-.-.-.-.-.-.-,-X---,-X-.-.-.-.-.-.-.-,-.-.-,-,-,-.-H-.-A-.-.-.-t/,-A-.-H-,-,-,-.-.-X-,-------------,-X-.-.-.-X-X-.-.-X2.-.-.-X---------
>-.-B-.-.-.-.-.-.-.-B-.-.-.-.-.-L-.-E-.-.-.-X-.-.-.-.-.-.-.-X-.-.-.-.-.-.-.-.-.-L-.-<-.-.-.-.-.-.-.-.-.-.-.-W-.-X-,---,-X-.-E-.-K-.-E-.-,-.-.-,-,-,-.-.-.-,-.-.-.-.-,-.-.-.-,-,-,-.-.-,-X-------------,-X-.-A-<-X-X-W-.-.2.-A-.-X---------
X-.-.-.-.-.-.-.-.-.-.-.-.-.-.-.-L-.-.-.-.-.-X-.-.-.-.-.-.-.-X-.-.-.-.-.-A-.-A-.-L-.-.-.-.-.-.-.-.-.-.-.-.-.-.-.-.-X---,-X-.-.-.-.-.-.-,-,-.-.-,-.-,-.-H-.-A-.-.-.-.-,-A-.-H-,-.-,-,-,-X---------------,-X-.-.-.-X-X-X-X-X2.-.-.-X---------
X-.-B-.-.-.-E-.-.-.-B-.-.-.-.-.-L-.-.-.-.-.-X-.-.-.-.-.-.-.-X-.-.-.-.-.-.-.-.-.-L-.-A-.-<-.-.-.-.-.-.-.-.-.-.-.-.-X-,-,-X-.-.-.-.-.-.-,-.-.-,-,-.-,-.-.-.-,-,-,-,-,-,-.-.-.-,-.-.-,-X-,---------------,-X-.-.-.-X-X-X-X-X-.-E-.-X---------
X-.-.-.-.-.-.-.-.-.-.-.-.-.-.-.-L-.-.-.-.-.-X-.-.-.-.-.-.-.-X-.-.-.-.-.-A-.-A-.-L-.-.-.-.-.-.-.-.-.-.-.-.-.-.-.-.-.-X-,-X-.-.-.-.-.-,-,-.-,-,-.-.-,-.-H-.-A-.-A-.-A-.-A-.-H-,-.-.-.-.-X-,-------------,-X-.-.-.-.-.-.-.-.-.-.-.-X---------
X-.-B-.-.-.-.-.-.-.-B-.-.-.-.-.-X-.-.-.-.-.-X-.-.-.-.-.-.-.-X-.-.-.-.-.-X-X-X-X-X-X-X-X-X-X-X-X-X-.-.-.-.-.-.-.-<-.-.-X-X-.-.-.-E-.-,-.-.-,-.-.-.-,-.-.-.-.-.-.-.-.-.-.-.-.-,-.-.-.-.-.-X-,---------,-,-X-.-A-.-.-.-A-.-E-.-A-.-X---------
,-X-.-.-.-.-.-.-.-.-.-.-.-.-.-X-X-.-.-.-.-.-X-.-.-.-.-.-.-.-X-.-.-.-.-.-X-----------------------,-X-.-.-.-.-.-.-.-.-.-X-,-X-.-.-.-.-,-.-,-,-.-.-.-,-.-H-.-H-.-H-.-H-.-H-.-H-,-.-.-.-.-.-.-X-,-----,-,-X-.-.-.-.-.-.-.-.-.-.-.-.-X---------
,-X-B-.-.-.-.-.-.-.-B-.-.-.-.-X-.-.-.-.-.-.-X-.-.-.-.-.-.-.-X-.-.-.-.-X-,-------------------------X-.-.-.-.-.-.-.-.-.-.-X-X-.-.-.-,-,-,-,-.-.-.-.-,-,-,-,-,-,-,-,-,-,-,-,-,-,-.-.-.-E-.-.-.-X-,-,-,-X-.-.-.-.-,-X-X-X-X-X-X-X-X-X---------
--,-X-.-.-.-.-.-.-.-.-.-.-.-X-X-.-.-.-.-.-.-X-.-.-.-.-.-.-.-X-.-.-.-.-X---------------------------,-X-.-.-.-.-.-.-.-.-.-.-X-X-.-.-,-.-,-.-.-.-.-.-.-.-.-.-.-.-.-.-.-.-.-.-.-.-.-.-.-.-.-.-.-.-X-,-X-.-.-.-.-.-X---------------------------
----,-X-B-.-B-.-B-.-B-.-.-X-X-.-.-.-.-.-.-.-X-.-.-.-.-.-.-.-X-.-.-.-.-X-----------------------------,-X-.-.-.-.-.-.-.-.-.-X-,-X-,-,-,-,-.-.-.-.-.-.-.-.-.-.-.-.-.-.-.-.-.-.-.-.-.-.-.-.-.-.-.-,-X-.-.-.-.-.-,-X---------------------------
----,-X-.-.-.-.-.-.-.-.-.-X-X-.-.-.-.-.-.-.-.-X-.-.-.-.-.-.-X-.-.-.-.-X-------------------------------,-X-.-.-.-.-.-.-.-.-.-X-X-,-,-,-.-.-.-.-.-.-.-.-.-.-.-.-.-.-.-.-.-.-.-.-.-.-.-.-.-.-.-.-,-.-.-.-.-.-,-X-----------------------------
------,-X-X-X-X-X-X-X-X-X-X-.-.-.-.-.-.-.-.-.-X-.-.-.-.-.-X-.-.-.-.-X-,---------------------------------X-.-.-.-.-.-.-.-.-.-.-X-X-,-.-.-.-.-.-.-.-.-.-.-.-.-.-.-.-.-.-.-.-.-.-.-.-.-.-.-.-.-.-,-.-.-A-.-.-X-------------------------------
------,-,-,-,-,-,-,-,-,-.-X-.-.-.-.-.-.-.-.-.-.-X-.-.-.-.-X-.-.-.-.-X-----------------------------------,-X-.-.-.-.-.-.-.-.-.-X-X-,-.-.-.-.-.-.-.-.-.-.-.-.-.-.-.-.-.-.-.-.-.-.-.-.-.-.-.-.-.-,-.-.-.-.-,-X-------------------------------
----,-,-X-X-X-X-X-X-X-X-X-.-.-.-.-.-E-.-.-.-.-.-X-X-X-X-X-.-.-.-.-.-X-------------------------------------,-X-.-.-.-.-.-.-.-.-,-X-.-.-.-.-.-.-.-.-.-.-.-.-.-.-.-.-.-.-.-.-.-.-.-.-.-E-.-.-.-.-,-X-X-X-X-X---------------------------------
----,-.-X-.-.-.-.-.-.-.-.-.-.-.-.-.-.-.-.-.-.-.-.-.-.-.-.-.-.-.-.-.-X---------------------------------------,-X-.-.-.-.-.-.-.-,-.-.-.-.-.-.-.-.-.-.-.-.-.-.-.-.-.-.-.-.-.-.-.-.-.-.-.-.-.-.-.-X-X-X-------,-,-,-,-,-,-,-,-,-,-,-,-,-,-,-,-
--,-,-X-.-.-.-.-.-.-.-.-.-.-.-.-.-.-.-.-.-.-.-.-.-.-.-.-.-.-.-.-.-X-,-----------------------------------------X-.-.-.-.-.-.-.-,-.-.-.-.-.-.-.-.-.-.-.-.-.-.-.-.-.-.-.-.-.-.-.-.-.-.-.-.-.-.-,-X-X-X-------,-X-X-X-X-X/X-X-X-X-X-X/X-X-X-X-
--,-.-X-.-.-.-.-.-.-.-.-.-.-.-.-.-.-.-.-.-.-.-.-.-.-.-.-.-.-.-.-.-X-------------------------------------------,-X-.-.-.-.-.-.-,-.-.-.-.-.-.-.-.-.-.-.-.-.-.-.-.-.-.-.-.-.-.-.-.-.-.-.-.-.-.-X-,-X-X-------,-X-.-.-.-t/.-.-.-.-,-t/.-.-.-X-
,-,-X-.-.-.-.-.-.-.-.-.-.-.-.-.-.-.-.-.-.-.-.-.-.-.-.-.-.-.-.-.-.-X---------------------------------------------,-X-.-.-.-.-.-,-.-.-.-.-.-.-.-.-.-.-.-.-.-.-.-.-.-.-.-.-.-.-.-.-.-.-.-.-.-,-X-,-X-X-------,-X-.-.-.-t/.-E-.-.-,-t/.-.-.-X-
,-.-X-.-.-.-.-.-.-.-.-.-.-.-.-.-.-.-.-.-.-.-.-.-.-.-.-.-.-.-.-.-.-X-----------------------------------------------,-X-.-.-.-.-,-.-.-.-.-.-.-.-.-.-.-.-.-.-.-.-.-.-.-.-.-.-.-.-.-.-.-.-.-.-X---,-X-X-------,-X-.-.-.-t/.-.-.-.-,-t/.-.-.-X-
,-X-.-.-.-.-.-.-.-.-.-.-.-.-.-.-.-.-.-.-.-.-.-.-.-.-.-.-.-.-.-.-X-,-------------------------------------------------X-.-.-.-A-,-.-.-.-.-.-.-.-.-.-.-.-.-.-.-.-.-.-.-.-.-.-.-.-.-.-.-.-.-,-X---,-X-X-,-,-,-,-X/t/t/t/t/.-E-.-.-,-t/t/t/t/X/
.-X-.-.-.-.-.-.-.-.-.-.-.-.-.-.-.-.-.-.-.-.-.-.-.-.-.-.-.-.-.-.-X---------------------------------------------------,-X-.-.-.-,-.-.-.-.-.-.-.-.-.-.-.-.-.-.-.-,-,-.-.-.-.-.-.-.-.-.-.-.-X-----,-X-X-X-X-X-X-.-.-.-.-.-.-.-.-.-.-.-.-.-.-X-
X-.-.-.-.-.-E-.-.-.-.-.-.-.-.-.-E-.-.-.-.-.-.-.-.-.-E-.-.-.-.-.-X-----------------------------------------------------,-X-X-X-X-X-.-.-.-.-.-.-.-.-.-.-.-.-.-,-,-,-,-.-.-.-.-.-.-.-.-.-,-X---------------,-X-.-.-E-.-.-.-E-.-E-.-.-.-.-.-X-
X-.-.-.-.-.-.-.-.-.-.-.-.-.-.-.-.-.-.-.-.-.-.-.-.-.-.-.-.-.-.-.-X---------------------------------------------------------------,-X-.-.-.-.-.-.-.-.-.-.-.-,-,-.-.-,-,-.-.-.-.-.-.-.-.-X-------------------,-X-,-,-,-,-.-.-.-.-.-.-.-.-.-X-
X-.-.-.-.-.-.-.-.-.-.-.-.-.-.-.-.-.-.-.-.-.-.-.-.-.-.-.-.-.-.-.-X-----------------------------------------------------------------,-X-.-.-.-.-.-.-.-.-.-,-,-.-.-.-.-,-,-.-.-.-.-.-.-,-X-------------------,-X/t/t/t/t/.-E-.-E-.-E-.-.-.-X-
X-.-.-.-.-.-.-.-.-.-.-.-.-.-.-.-.-.-.-.-.-.-.-.-.-.-.-.-.-.-.-.-X-------------------------------------------------------------------,-X-.-.-.-.-.-.-.-,-,-.-,-,-,-.-.-,-,-.-.-.-.-.-X---------------------,-X-.-.-.-t/.-.-.-.-.-.-.-.-.-X-
X-.-.-.-A-.-.-.-.-.-.-.-X-.-.-.-X-X-X-X-X-.-.-.-.-.-.-.-A-.-.-,-X---------------------------------------------------------------------,-X-.-.-.-.-.-,-,-,-,-,-.-,-,-,-.-,-,-.-.-<-,-X---------------------,-X-.-.-.-t/.-E-.-E-.-E-.-E-.-X-
,-X-.-.-.-.-.-.-.-.-,-X-X-.-.-.-X-------,-X-.-.-.-.-.-.-.-.-,-X-------------------------------------------------------------------------,-X-.-.-.-,-,-,-,-.-.-.-.-.-,-,-,-,-,-.-.-X-----------------------,-X-.-.-.-t/.-.-.-.-.-.-.-.-.-X-
--,-X-.-.-.-.-.-.-,-X-,-X-.-.-.-X---------,-X-.-.-.-.-.-.-,-X-----------------------------------------------------------------------------,-X-.-A-,-,-.-.-.-.-.-.-.-.-.-,-,-,-,-A-X-----------------------,-X-X-X-X-X/X-X-X-X-X-X-X-X-X-X-
----,-X-.-.-.-.-,-X---,-X-.-.-.-X-----------,-X-.-.-.-.-,-X---------------------------------------------------------------------------------,-X-,-.-.-.-.-.-.-.-.-.-.-.-.-.-,-,-X---------------------------------------------------------
------,-X-X-X-X-X---,-,-X-.-.-.-X-,-----------,-X-X-X-X-X-------------------------------------------------------------------------------------,-X-.-.-.-.-.-.-.-.-.-.-.-.-.-.-,-X---------------------------------------------------------
------------------,-,-X-.-.-.-.-.-X-,---------------------------------------------------------------------------------------------------------,-X-.-.-.-.-.-.-.-.-.-.-.-.-.-.-X-----------------------------------------------------------
----------------,-,-X-.-.-.-.-.-.-.-X-,---------------------------------------------------------------------------------------------------------,-X-.-.-.-.-.-.-.-.-.-.-.-.-,-X-----------------------------------------------------------
--------------,-,-X-.-.-.-.-.-.-.-.-.-X-,-,-,-,-,-----------------------------------------------------------------------------------------------,-X-.-.-.-.-.-.-.-.-.-.-.-.-X-------------------------------------------------------------
--------------,-X-.-.-.-.-.-.-.-.-.-.-.-X-X-X-X-X-------------------------------------------------------------------------------------------------,-X-.-.-.-.-.-E-.-.-.-.-,-X-------------------------------------------------------------
--------------,-X-.-.-.-.-.-.-.-.-.-.-.-+-+-H-H-X-------------------------------------------------------------------------------------------------,-X-.-.-.-.-.-.-.-.-.-.-X---------------------------------------------------------------
--------------,-X-.-.-.-.-.-.-.-.-.-:-.-+-+-W-.-X---------------------------------------------------------------------------------------------------,-X-.-.-.-.-.-.-.-.-,-X---------------------------------------------------------------
--------------,-X-.-.-.-.-.-.-.-.-.-.-.-+-+-H-H-X---------------------------------------------------------------------------------------------------,-X-.-.-.-.-K-.-.-.-X-----------------------------------------------------------------
--------------,-X-.-.-.-.-.-.-.-.-.-.-,-X-X-X-X-X-----------------------------------------------------------------------------------------------------,-X-X-X-X-X-X-X-X-X-----------------------------------------------------------------
----------------,-X-.-.-.-.-.-.-.-.-,-X---------------------------------------------------------------------------------------------------------------------------------------------------------------------------------------------------
------------------,-X-.-.-.-K-.-.-,-X-----------------------------------------------------------------------------------------------------------------------------------------------------------------------------------------------------
--------------------,-X-.-.-.-.-,-X-------------------------------------------------------------------------------------------------------------------------------------------------------------------------------------------------------
----------------------,-X-X-X-X-X---------------------------------------------------------------------------------------------------------------------------------------------------------------------------------------------------------
