----------------------------------------------------------------,-X-X-X-X-X-X-X-X-X-------------------------------------------------------------------------------------
----------------------------------------------------------------,-X-H-,-.-.-<-.-A-X-------------------------------------------------------------------------------------
----------------------------------------------------------------,-X-W-,-.-<-.-<-.-X-------------------------------------------------------------------------------------
----------------------------------------------------------------,-X-.-,-.-.-.-.-<-X-,-,-,-,-,-,-,-,-------------------------,-,-,-,-,-,-----,-,-,-,-,-,-----------------
----------------------------------------------------------------,-X-X-X-X-X-<-.-.-X-X-X-X-X-X-X-X-X-------------------------,-X-X-X-X-X-----,-X-X-X-X-X-----------------
------------------------------------------------------------------------,-X-.-.-.-X-X-A-.-.-.-.-.-X-,-,-,-,-,-,-,-----------,-X-.-H-.-X-----,-X-.-A-.-X-----------------
------------------------------------------------------------------------,-X-.-.-.-X-X-.-.-.-.-.-.-X-X-X-X-X-X-X-X-----------,-X-.-.-.-X-----,-X-.-.-.-X-----------------
--------------------------------------------------------------------,-,-,-X-.-.-.-X-X-.-.-.-.-.-.-X-X-H-.-.-.-A-X-----------,-X-.-E-.-X-----,-X-.-E-.-X-----------------
--------------------------------------------------------------------,-X-X-X-.-.-.-X-X-.-.-.-.-.-.-X-X-.-.-.-.-.-X-----------,-X-.-.-.-X-----,-X-.-.-.-X-----------------
--------------------------------------------------------------------,-X-.-.-.-.-,-X-X-.-.-E-.-.-.-L-L-.-.-E-.-.->-------,-,-,-X1.1.1.1X1,-,-,-X2.2.2.2X2,-,-------------
--------------------------------------------------------------------,-X-X-X-.-.-,-X-X-.-.-.-.-.-.-X-X-.-.-.-.-.->-------,-X~X-X1,1,1,1X1X-X-X-X2,2,2,2X2X-X-------------
--------------------------------------------------------------------,-,-,-X-.-.-,-,-.-.-.-.-.-.-.-X-X-H-.-.-.-A-X-------,-X~.-.-.-.-.-.-.-.-.-.-.-.-.-H-H-X-,-,-,-,-,-,-
--------------------------------------------------------------------,-X-X-X-.-.-,-,-.-.-.-.-.-.-.-X-X-X-X-X-X-X-X-------,-X~.~E-.-.-.-.-.-.-.-.-.-.-.-.-H-X1X1X-X-X-X-X-
--------------------------------------------------------------------,-X-A-.-.-.-,-,-.-.-.-E-.-.-.-X---------------------,-X~H-.-.-.-.-.-.-.-.-.-.-.-.-.-,-.1.1.-.-.-.-X-
--------------------------------------------------------------------,-X-X-X-.-.-,-X-X-.-.-.-.-.-.-X---------------------,-X~X-X-.-.-.-X-X-X-X-X-.-.-.-.-,-.1.1.-.-E-W-X-
--------------------------------------------------------------------,-,-,-X-.-.-,-X-X-.-.-.-.-.-.-X-,-,-,-,-,-,-,-,-,-,-,-,-,-X-.-.-.-X-----,-X-.-.-.-.-,-.1.1.-.-.-.-X-
--------------------------------------------------------------------,-X-X-X-.-.-,-X-X-.-.-.-.-.-.-X-X-X-X-X-X-X-X-X-X-X-X-X-X-X-.-.-.-X-----,-X-.-.-.-.-,-X1X1X-X-X-X-X-
----------------------------------------------------------------,-,-,-X-.-.-.-.-,-,-.-.-.-.-.-.-.-.-.-.-.-.-.-.-.-.-.-.-.-.-X-X-.-.-.-X-----,-X-.-.-.-.-.-X-------------
----------------------------------------------------------------,-X-X-X-.-.-.-.-,-,-.-.-.-E-.-.-.-.-.-.-.-.-.-.-.-.-.-.-.-.-X-X-.-.-.-X---,-,-X-.-.-.-.-.-X-------------
----------------------------------------------------------------,-X-.-.-.-.-E-.-,-,-.-.-.-.-.-.-.-.-E-.-.-.-.-.-.-.-.-.-.-.-X-X-.-.-.-X---,-X-X-.-.-.-.-,-X-,-,-,-,-,-,-
----------------------------------------------------------------,-X-E-.-.-.-.-.-,-X-X-X-.-.-.-.-.-.-.-.-.-.-.-.-.-E-.-.-.-.-X-X-.-.-.-X---,-X-.-.-.-.-.-,-X2X2X-X-X-X-X-
----------------------------------------------------------------,-X-H-.-.-.-.-.-.-X-X-,-X-.-.-.-.-.-.-.-.-.-.-.-.-.-.-.-.-.-X-X-.-.-.-X---,-X-X-.-.-.-.-,-.2.2.-.-.-.-X-
----------------------------------------------------------------,-X-X-X-X-X-.-E-.-.-A-X-X-.-.-E-.-.-.-.-.-E-.-.-.-.-.-<-.-.-X-X-.-.-.-X-----,-X-.-.-.-.-,-.2.2.-.-E-H-X-
------------------------------------------------,-,-,-,-,-,-,-,-,-,-,-,-,-X-.-.-.-.-E-.-X-X-,-,-,-X-X-X-,-,-,-X-X-X-L-L-L-X-X-X-.-.-.-X-----,-X-.-.-.-.-,-.2.2.-.-.-.-X-
------------------------------------------------,-X-X-X-,-X-X-X-X-X-X-X-X-X/.-.-.-.-.-.-X-X-,-,-,-X-X-X-,-,-,-X-X-X-L-L-L-X-X-X-.-.-.-X-----,-X-.-.-.-.-,-X2X2X-X-X-X-X-
------------------------------------------------,-X-E-X-,-X-A-E-.-.-.-.-.-./.-E-.-.-.-.-.-.-.-.-.-.-.-.-.-.-.-.-.-.-.-.-.-.-X-X-.-.-.-X-----,-X-.-.-.-.-.-X-------------
------------------------------------------------,-X-.-X-X-X-.-.-.-.-.-.-.-./.-.-.-.-.-.-.-.-.-.-.-.-.-.-.-.-.-.-E-.-.-E-.-.-X-X-.-.-.-X---,-,-X-.-E-.-.-.-X-------------
--------------------------------------------,-,-,-X-.-.-.-.-.-.-.-.-.-.-.-./.-.-.-.-.-.-.-.-.-.-.-.-.-.-.-.-.-.-.-.-.-.-.-.-X-X-.-.-.-X---,-X-X-.-.-.-.-,-X-,-,-,-,-,-,-
--------------------------------------------,-X-X-X-.-.-.-.-.-.-.-.-.-X-X-X/.-.-X-X-X-X-X-.-.-.-.-.-.-.-.-.-.-.-.-.-E-.-.-.-X-X-,-,-,-X---,-X-.-.-.-.-.-,-X1X1X-X-X-X-X-
--------------------------------------------,-X-E-.-.-.-.-.-.-.-.-.-A-X-,-X-A-.-X-----,-X-.-.-.-.-.-.-.-.-.-.-.-.-.-.-.-.-A-X-X-,-,-,-X---,-X-X-.-.-.-.-,-.1.1.-.-.-.-X-
--------------------------------------------,-X-X-X-.-.-.-.-.-X-X-X-X-X-,-X-X-X-X---,-,-X-X-X-X-X-X-X-X-X-X-X-X-X-X-X-X-X-X-X-X-,-,-,-X-,-,-,-X-.-.-.-.-,-.1.1.-.-E-K-X-
------------------------------------------------,-X-.-.-.-.-.-X-,-,-,-,-,-,-,-,-,-,-,-X-X-X-X-X-X-X-X-X-X-X-X-X-X-X-X-X-X1X2X-X-,-,-,-X-X-X-X-X3.3.-.-E-,-.1.1.-.-.-.-X-
------------------------------------------------,-X-X-X-.-.-.-X-X-X-X-X-X-X-X-X-X-X-X-X-.-.-.-,-,-,-,-,-,-,-,-.-.-.-.-,-,1,2,-.-.-.-.-.-.-.-.-,3.3.-.-.-,-X1X1X-X-X-X-X-
------------------------------------------------,-,-,-X-.-.-.-.-.-.-.-.-.-.-.-.-.-.-H-X-.-E-.-,-,-,-,-,-,-,-,-.-.-E-.-,-,1,2,-.-.-E-.-.-.-E-.-,3.3.-.-.-.-X-------------
------------------------------------------------,-X-X-X-.-.-.-X-X-X-X-X-.-X-X-X-.-.-,-X-.-.-.-,-,-,-,-,-,-,-,-A-.-.-.-,-,1,2,-,-,-,-,-.-.-.-.-,3.3.-.-.-.-X-------------
------------------------------------------------,-X-A-.-.-.-.-X-----,-X-E-X-,-X-.-.-,-X-X-X-X-X-X-X-X-X-X-X-X-X-X-+-X-X-X1X2X-X-,-,-,-X-X-X-X-X3.3.-.-E-,-X-,-,-,-,-,-,-
------------------------------------------------,-X-.-.-.-.-.-X-----,-X-X-X-,-X-.-.-.-X-X-X-X-X-------,-X-X-X-X-X-+-X-X-X-X-X-X-,-,-,-X---,-,-X-.-.-.-.-,-X2X2X-X-X-X-X-
--------------------------------------------,-,-,-X-.-.-.-.-.-X---------,-,-,-X-.-E-.-.-.-.-E-X-------,-X-H-.-.-.-.-.-.-.-.-X-X-,-,-,-X---,-X-X-.-.-.-.-,-.2.2.-.-.-.-X-
--------------------------------------------,-X-X-X-.-.-.-.-.-X---------,-X-X-X-.-X-X-X-.-X-X-X-,-,-,-,-X-.-.-.-.-.-.-.-.-.-X-X-.-.-.-X---,-X-.-.-.-E-.-,-.2.2.-.-E-W-X-
--------------------------------------------,-X-E-.-.-.-.-.-.-X---------,-X-K-.-.-X-,-X-.-X-,-X-X-X-X-X-X-.-.-E-.-.-.-.-.-.-X-X-.-.-.-X---,-X-X-.-.-.-.-,-.2.2.-.-.-.-X-
--------------------------------------------,-X-X-X-.-.-.-X-X-X---------,-X-X-X-.-X-,-X-.-X-,-X-.-.-H-X-X-.-.-.-.-.-E-.-.-,-X-X-.-.-.-X-----,-X-.-.-<-.-,-X2X2X-X-X-X-X-
------------------------------------------------,-X-.-.-.-X-,-,-------------,-X-E-X-,-X-E-X-,-X-.-.-.-X-X-.-.-.-.-.-.-.-.-,-X-X-.-.-E-X-----,-X-H-.-.~.-.-X-------------
------------------------------------------------,-X-X-X-.-X-X-X-------------,-X-X-X-,-X-X-X-,-X-:-.-.-X-X-.-.-.-.-.-.-.-.-,-.-.-E-.-.-X-----,-X-X~X~X~X~X~X-------------
------------------------------------------------,-,-,-X-.-.-E-X-----------------------------,-X-.-.-.-X-X-.-.-.-.-.-.-.-.-,-.-.-.-.-.-X---------------------------------
------------------------------------------------,-X-X-X-.-.-.-X-----------------------------,-X-.-E-.-X-X-.-.-.-.-.-.-.-.-,-.-.-E-.-E-X---------------------------------
------------------------------------------------,-X-E-.-.-.-.-X-,-,-----,-,-,-,-,-,-,-,-,-,-,-X-.-.-.-X-X-.-E-.-.-.-.-.-.-,-.-.-.-.-.-X-,-,-,-,-,-,-,-,-,---------------
------------------------------------------------,-X-.-.-.-.-.-X-X-X-----,-X-X-X-X-X-X-X-X-X-X-X-X-+-X-X-X-.-.-.-.-.-.-.-.-,-.-.-E-.-.-X-X-X-X-X-X-X-X-X-X---------------
--------------------------------------------,-,-,-X-.-.-,-,-,-,-.-X-,-,-,-X-W-.-.-.-,-X-X-.-.-.-.-.-.-.-.-.-.-.-.-.-.-.-.-,-X-X-.-.-E-X-X-A-.-.-.-.-.-.-X---------------
--------------------------------------------,-X-X-X-.-X-X-X-.-,-.-X-X-X-X-X-.-.-.-.-,-,-.-.-.-E-.-.-E-.-.-E-.-.-.-.-.-.-.-.-X-X-.-.-.-X-X-.-.-.-.-.-H-.-X---------------
--------------------------------------------,-X-A-.-.-X-,-X-.-,-.-.-.-.-.-.-.-.-.-.-,-,-.-.-.-.-.-.-.-.-.-.-.-.-.-.-E-.-.-.-X-X-.-.-.-L-L-.-.-.-.-.-.-.-X---------------
--------------------------------------------,-X-A-.-.-X-X-X-,-,-.-E-.-.-.-.-.-.-.-.-,-,-.-.-.-E-.-.-E-.-E-.-.-.-.-.-.-.-.-,-X-X-.-.-.-L-L-.-.-.-.-.-.-.-X---------------
--------------------------------------------,-X-.-.-.-.-E-.-.-.-.-.-.-.-.-.-.-.-.-.-,-X-X-.-.-.-.-E-.-.-.-.-.-.-E-.-.-.-.-,-X-X-.-.-.-L-L-.-.-.-E-.-.-.-X---------------
--------------------------------------------,-X-X-X-X-X-X-X-X-X-X-X-X-X-X-X-X-X-X-X-X-X-X-X-X-X-X-X-X-X-X-.-.-.-.-.-.-.-.-,-.-.-E-.-.-X-X-.-.-.-.-.-.-.-X---------------
--------------------------------------------------------------------------------------------,-,-,-,-,-,-X-.-.-.-.-.-.-.-.-,-.-.-.-.-.-X-X-.-.-.-.-.-.-.-X---------------
--------------------------------------------------------------------------------------------,-X-X-X-X-X-X-.-E-.-.-.-.-.-.-,-.-.-E-.-E-X-X-X-.-.-.-.-.-X-X---------------
--------------------------------------------------------------------------------------------,-X-H-.-.-X-X-.-.-.-.-.-.-.-.-,-.-.-.-.-.-X-,-X-,-,-,-,-,-X-----------------
--------------------------------------------------------------------------------------------,-X-.-.-.-X-X-.-.-.-.-.-.-.-.-,-.-.-.-.-.-X-,-X-.-.-.-.-.-X-----------------
--------------------------------------------------------------------------------------------,-X-.-.-.-.-,-.-.-.-.-.-.-.-.-,-X-X-E-.-.-X-,-X-.-.-.-.-.-X-----------------
--------------------------------------------------------------------------------------------,-X-.-E-.-K-,-.-.-.-.-.-E-.-.-.-X-X-.-.-E-X-,-X-.-.-.-.-.-X-----------------
--------------------------------------------------------------------------------------------,-X-.-.-.-.-,-.-E-.-.-.-.-.-.-.-X-X-.-.-.-X-,-X-,-,-,-,-,-X-----------------
--------------------------------------------------------------------------------------------,-X-.-E-.-X-X-.-.-.-.-.-.-.-.-.-X-X-.-.-.-X-,-X-.-.-.-.-.-X-----------------
--------------------------------------------------------------------------------------------,-X-.-.-.-X-X-A-,-,-,-,-,-,-,-,-X-X-.-.-.-X-,-X-.-.-.-.-.-X-----------------
--------------------------------------------------------------------------------------------,-X-.-.-.-X-X-.-.-.-.-.-.-.-.-.-X-X-.-.-,-X-,-X-,-,-,-,-,-X-----------------
--------------------------------------------------------------------------------------------,-X-.-.-E-.-,-.-.-.-.-.-.-.-.-.-,-.-.-<-,-X-X-X-.-.-.-.-.-X-----------------
--------------------------------------------------------------------------------------------,-X-X-X-X-X-X-X-X-X-X-X-X-X-X-X-X-X-X-X-X-X-.-.-.-.-.-.-.-X-----------------
--------------------------------------------------------------------------------------------------------------------,-X-X-X-X-X-X-X-X-X-.-X-.-.-.-.-.-X-----------------
--------------------------------------------------------------------------------------------------------------------,-X-A-A-A-A-A-A-A-X-B-X-,-,-,-,-,-X-----------------
--------------------------------------------------------------------------------------------------------------------,-X-.-.-.-.-.-.-.-X6B-X-.-.-.-.-.-X-----------------
--------------------------------------------------------------------------------------------------------------------,-X-.-.-.-.-E-.-.-.6B-X-.-.-.-.-.-X-----------------
--------------------------------------------------------------------------------------------------------------------,-X-.-.-H-.-.-.-.-X6X-X-,-:-,-,-,-X-----------------
--------------------------------------------------------------------------------------------------------------------,-X-.-E-.-.-E-.-.-X-,-X-.-.-.-.-.-X-----------------
--------------------------------------------------------------------------------------------------------------------,-X-.-.-.-.-.-.-.-X-,-X-.-.-.-.-.-X-----------------
--------------------------------------------------------------------------------------------------------------------,-X-.-.-.-.-.-.-.-X-,-X-.-.-.-.-.-X-----------------
--------------------------------------------------------------------------------------------------------------------,-X-.-.-H-H-H-.-W-X-,-X-,-,-,-,-,-X-----------------
--------------------------------------------------------------------------------------------------------------------,-X-X-X-X-X-X-X-X-X-,-X-.-.-.-.-.-X-----------------
----------------------------------------------------------------------------------------------------------------------------------------,-X-.-.-.-.-.-X-----------------
----------,-,-,-,-,-,-,-,-,-,-,-,-,-,-,-,-,-,-,-,-,-,-,-,-,-,-,-,-,-,-,-,-,-,-,-,-,-,---------------------------------------------------,-X-,-,-,-,-,-X-----------------
----------,-X~X~X~X~X~X~X~X~X~X~X~X~X~X~X~X~X~X~X~X~X~X~X~X~X~X~X~X~X~X~X~X~X~X~X~X~X~--------------------------------------------------,-X-.-.-.-.-.-X-----------------
----------,-X~.~.~.~.~.~.~.~.~.~.~.~.~.~.~.~.~.~.~.~.~.~.~.~.~.~.~.~.~.~.~.~.~.~.~,~X---------------------------------------------------,-X-.-.-.-.-.-X-----------------
----------,-X~.~.~.~.~.~.~.~.~.~.~.~.~.~.~.~.~.~.~.~.~.~.~.~.~.~.~.~.~.~.~.~.~.~,~,-X---------------------------------------------------,-X-.-.-.-.-.-X-----------------
----------,-X~.~.~.~.~.~.~.~.~.~.~E~.~.~.~.~.~E~.~.~.~.~.~E~.~.~.~.~.~.~.~.~.~.~,~.-X---------------------------------------------------,-X-,-,-,-,-,-X-----------------
----------,-X~.~.~.~.~.~.~.~.~.~.~.~.~.~.~.~.~.~.~.~.~.~.~.~.~.~.~.~.~.~.~.~.~,~,-.-X---------------------------------------------------,-X-.-.-.-.-.-X-----------------
----------,-X~.~.~.~.~E~.~.~.~.~.~.~.~.~.~.~.~.~.~.~.~.~.~.~.~.~.~.~.~.~.~.~.~,~.-.-X---------------------------------------------------,-X-.-.-.-.-.-X-----------------
----------,-X~.~.~.~.~.~.~.~.~.~.~.~.~.~.~.~.~.~.~.~.~.~.~.~.~.~.~.~.~.~.~.~,~,-.-.-X-,-,-,-,-,-,-,-,-,---------------------------------,-X-,-,-,-,-,-X-----------------
,-,-,-,-,-,-X~.~.~.~.~.~.~.~.~.~.~.~.~.~.~E~.~.~.~,~,~E~.~.~.~.~.~.~.~.~,~,~,~.-.-.-X-X-X-X-X-X-X-X-X-X-,-------------------------------,-X-.-.-.-.-.-X-----------------
X-X-X-X-X-X-X-,~.~.~.~.~.~,~,~,~.~.~.~.~.~.~.~,~,~,-,-,-,~.~.~.~.~.~,~,~,-.-.-.-.-.-.-.-.-.-.-.-.-.-.-.-X-------------------------------,-X-.-.-.-.-.-X-----------------
X-.-.-.-.-.-.-,-,~,~.~,~,~,-.-,-,-,~.~.~.~.~,~,~.-.-.-.-,-,-,~.~,~,~,-.-.-.-.-.-.-.-.-.-.-.-.-.-.-.-.-.-X-,-----------------------------,-X-.-.-.-.-.-X-----------------
X-E-.-E-.-.-.-.-.-,-,~,-.-.-.-.-.-,-,-,~,~,~,-.-.-.-.-.-.-.-,-,~,-.-.-.-.-.-.-.-.-.-.-.-.-.-.-.-.-.-.-.-.-X-,---------------------------,-X-,-,-,-,-,-X-----------------
X-.-.-.-.-.-.-.-.-.-.-.-.-.-.-E-.-.-.-,-,~.-.-.-.-.-.-.-.-.-.-.-.-.-.-.-.-,-,-.-.-.-.-.-.-.-.-.-.-.-.-.-.-.-X---------------------------,-X-.-.-.-.-.-X-----------------
X-E-.-E-.-.-,-,-.-.-.-.-.-,-,-.-.-.-.-.-.-.-.-.-.-,-,-,-.-.-.-.-.-.-.-.-,-,-,~,-.-.-X-X-X-X-X-.-.-.-.-.-.-.-X-,-------------------------,-X-.-.-.-.-.-X-----------------
X-X-X-X-X-X-X-,-,-E-.-,-,-,-,~,-,-.-.-.-.-E-.-,-,-,-.~E-,-,-.-.-.-.-.-,-,-.~.~,-.-.-X-------,-X-.-.-.-.-.-.-.-X-,-----------------------,-X-.-.-.-.-.-X-----------------
----------,-X~.~.~,-,-,-.~.~.~.~,-,-.-.-.-.-,-,-.-.~.~.~.~,-,-,-,-,-,-,-.~.~.~,~,-.-X-------,-X-.-.-.-.-.-.-.-.-X---------------------,-,-X-.-.-.-.-.-X-----------------
----------,-X~.~.~.~.~.~.~.~.~E~.~,~,-,-,-,-,-.~.~.~.~.~.~.~.~.~.~.~.~.~.~.~.~.~,-.-X---------,-X-.-.-.-.-.-.-.-X-,-,-,-,-,-,-,-,-,-,-,-.-X-.-.-.-E-.-X-----------------
----------,-X~.~.~.~.~.~.~.~.~.~.~.~.~,-,-.-.~.~.~.~.~.~.~.~.~.~.~.~.~.~.~.~.~.~,~,-X-----------,-X-.-.-.-.-.-.-.-X-X-X-X-X-X-X-X-X-X-X-X-.-E-.-.-.-.-X-----------------
----------,-X~.~.~.~.~.~.~.~.~.~.~.~.~.~.~.~.~E~.~.~.~E~.~.~.~.~.~.~.~.~.~.~.~.~.~,-X-------------X-.-.-.-.-.-.-.-.-.-.-.-.-.-.-.-.-.-.-.-.-.-.-.-.-,-X-----------------
----------,-X~.~.~.~.~.~.~.~.~.~.~.~.~.~.~.~.~.~.~.~.~.~.~.~.~.~.~.~.~.~.~.~.~.~.~,~X-------------,-X-.-.-.-.-.-.-.-.-.-.-.-.-.-.-.-.-.-.-.-.-.-.-H-X-------------------
----------,-X~X~X~X~X~X~X~X~X~X~X~X~X~X~X~X~X~X~X~X~X~X~X~X~X~X~X~X~X~X~X~X~X~X~X~X~X~--------------,-X-.-.-.-.-.-.-.-.-.-.-.-.-.-.-.-.-.-.-.-H-.-X---------------------
------------------------------------------------------------------------------------------------------,-X-.-.-.-.-.-.-.-.-.-.-.-.-.-.-.-.-.-.-.-,-X---------------------
------------------------------------------------------------------------------------------------------,-X-.-.-.-.-.-.-.-.-.-.-.-.-.-.-.-.-.-.-,-X-----------------------
--------------------------------------------------------------------------------------------------------,-X-X-X-X-X-X-X-X-X-X-X-X-X-X-X-X-X-X-X-------------------------
