------------------------------------------------------------------------------------------------------------------------------------------------------------------------------------,-,->->-X-,-,---------------
--------------------------------------------------------------------------------------------------------------------------------------------------------------------------------,-,-X-X-.-.-.-X-,-,-------------
----------------------------------------------------------------------------------------------------------------------------------------------------------------------------,-,-,-X-.-.-.-E-.-.-X-X-,-----------
----------------------------------------------------------------------------------------------------------------------------------------------------------------------------,-X-X-.-.-.-.-.-.-.-.-,-X-----------
----------------------------------------------------------------------------------------------------------------------------------------------------------------------------,-X-,-.-.-.-.-.-.-.-.-,-X-----------
------------------------------------------------------------------------------------------------------------------------------------,-,-,-,-,-,-,-,-------------------------,-X-,-.-.-.-.-.-.-.-.-,-X-----------
------------------------------------------------------------------------------------------------------------------------------------,-X-X-X-X-X-X-X-------------------------,-X-,-E-.-.-.-.-.-.-.-E-X-----------
------------------------------------------------------------------------------------------------------------------------------------,-X-E-W-E-.-.-X-------------------------,-X-X-.-.-.-.-.-.-.-.-,-X-----------
--------------------------------------------------------------------------------------------------------,-,-,-,-,-,-,-,-,-,---------,-X-H-.-.-.-.-X-----------------------------,-X-X-.-.-.-.-,-,-X-------------
--------------------------------------------------------------------------------------------------------,-X-X-X-X-X-X-X-X-X-,-------,-X-E-.-E-.-,-X-,-,-,-,-,-,-,-,-,-,-----------,-,-X-.-.-,-X-X---------------
--------------------------------------------------------------------------------------------------------,-X-.-.-.-:-.-.-.-.-X-,-----,-X-.-.-.-,-.-X-X-X-X-X-X-X-X-X-X-X-,-------------,-X-.-X-------------------
--------------------------------------------------------------------------------------------------------,-X-W-.-.-E-.-.-:-.-.-X-----,-X-E-,-,-.-,-.-,-,-,-,-,-,-,-,-.-.-X-,-,-,-,-,-,-,-X-+-X-,-,-,-,-,-,-,-,-,-
--------------------------------------------------------------------------------------------------------,-X-X-X-X-X-X-X-.-.-.-X-----,-X-,-.-,-,-.-.-.-.-.-.-.-.-.-.-.-,-,-X-X-X-,-X-X-X-X-,-X-X-X-X-,-X-X-X-X-X-
----------------------------------------------------------------------------------------------------------------------,-X-.-.-X-----,-X-.-,-.-H-.-.-.-.-E-.-.-.-.-.-E-,-.-.-.-X-,-X-E-.-.-.-.-.-.-X-,-X-.-,-,-X-
------------------------------------------------------------------------------------------------------------------------,-X-+-X-,-,-,-X-,-.-:-.-.-.-,-,-,-,-,-,-.-.-,-,-.-.-.-X-X-X-.-.-.-.-.-.-.-X-X-X-.-,-.-X-
--------------------------------------------------------------------------------------------------------------------,-,-,-X-+-X-X-X-X-X-.-.-.-.-.-.-,-.-.-.-.-,-.-,-,-.-.-.-.-.-.-.-.-.-.-.-.-.-.-.-.-.-.-,-.-X-
------------------------------------------------------------------------------------------------------------------,-,-X-X-.-.-.-.-E-X-X-.-.-.-.-.-.-,-.-.-.-.-,-.-,-.-.-.-.-.-.-.-.-.-.-.-.-.-.-.-.-.-.-.-,-.-X-
----------------------------------------------------------------------------------------------------------------,-,-X-.-.-.-.-.-.-.-X2XR.-.-.-.-.-.-,-,-,-,-,-,-.-,-.-.-.-.-.-.-.-.-.-.-.-.-.-.-.-.-.-.-.-,-.-X-
----------------------------------------------------------------------------------------------------------------,-X-,-.-.-.-.-.-.-E-.2+R.-.-.-.-.-.-.-.-.-.-.-.-.-,-.-.-.-.-.-.-.-.-.-.-.-.-.-.-.-.-.-.-.-,-,-X-
----------------------------------------------------------------------------------------------------------------,-X-,-.-.-.-.-.-.-.-.2+R.-.-.-.-.-.-.-.-.-.-.-.-.-,-.-.-.-.-.-.-.-.-.-.-.-.-.-.-.-.-.-.-E-.-,-X-
----------------------------------------------------------------------------------------------------------------,-X-,-A-.-.-.-E-.-.-.2+R.-.-.-.-.-.-.-.-.-.-.-.-.-,-.-.-.-.-.-.-.-.-.-.-.-.-.-.-.-.-.-.-.-.-,-X-
----------------------------------------------------------------------------------------------------------------,-X-,-H-.-E-.-.-.-E-.2+R.-.-.-.-.-.-.-.-<-.-.-.-.-,-.-.-.-.-.-.-.-.-.-.-.-W-A-.-.-.-.-E-.-.-,-X2
----------------------------------------------------------------------------------------------------------------,-X-,-.-.-.-.-E-.-.-.2+R.-.-.-.-.-.-.-.-.-.-.-.-.-,-.-.-.-.-.-.-.-.-.-.-.-.-.-.-.-.-.-.-E-.-,-X2
----------------------------------------------------------------------------------------------------------------,-X-,-.-.-.-.-.-.-E-.2+R.-.-.-.-.-.-.-.-.-.-.-.-.-,-.-.-.-.-.-.-.-.-.-.-.-.-.-.-.-.-.-.-.-,-,-X2
----------------------------------------------------------------------------------------------------------------,-X-.-.-.-.-.-.-.-.-.2+R.-.-.-.-.-.-,-,-,-,-,-,-.-,-.-.-.-.-.-.-.-.-.-.-.-.-.-.-.-.-.-.-.-,-.-X-
------------------------------------------------------------------------------------------------------------------,-X-X-.-.-.-.-.-.-X2XR.-.-.-.-.-.-,-.-.-.-.-,-.-,-.-.-.-.-.-.-.-.-.-.-.-.-.-.-.-.-.-.-.-,-.-X-
----------------------------------------------------------------------------------------------------------------------,-X-.-.-A-.-E-X-X-.-.-.-.-.-.-,-.-.-.-.-,-.-,-,-.-.-.-.-.-.-.-.-.-.-.-.-.-.-.-.-.-.-,-.-X-
------------------------------------------------,-,-,-,-,-,-,-,-,-,-,-,-,-,-,-,---------,-,-,-,-,-,-,-,-----------------,-X-X-X-X-X-X-X-.-.-.-.-.-.-,-,-,-,-,-,-.-.-,-.-.-.-.-.-.-.-.-.-.-.-.-.-.-.-.-.-.-,-.-X-
--------------------------------------------,-,-,-X-X-X-X-X-X-X-X-X-,-X-X-X-X-X-,-----,-,-X-X-X-X-X-X-X-,---------------------------,-X-,-,-.-.-.-.-.-.-.-.-.-.-.-.-,-,-.-.-.-X-X-X-.-.-.-.-.-.-.-X-X-X-.-,-,-X-
------------------------------------------,-,-X-X-B-.-.-E-.-.-.-.-X-,-X-E-.-.-,-X-,-,-,-X-,-.-,-E-,-.-,-X-,-,-,-,-,-,-,-,-,-,-,-,---,-X-.-,-,-.-.-.-.-.-.-.-.-.-.-.-.-,-,-.-.-X-,-X-A-.-.-E-.-.-H-X-,-X-.-.-.-X-
----------------------------------------,-,-X-.-.-.-.-.-.-.-.-.-.-X2XRX-.-.-.-,-.-X-X-X-.-,-.-,-.-,-.-,-,-X-X-X-X-X-X-X-X-X-X-X-X---,-X-.-.-,-,-,-.-,-,-,-,-,-,-.-.-E-,-,-X-X-X-,-X-X-X-X-X-X-X-X-X-,-X-X-X-X-X-
----------------------------------------,-X-.-.-.-.-.-.-.-.-.-.-.-.2+R.-.-.-.-,-.-,-B-,-.-,-.-,-.-,-.-,-E-.-.-.-.-.-.-.-.-A-.-E-X---,-X-.-.-.-.-,-X-X-X-.-.-.-X-X-X-X-X-X---------------------------------------
----------------------------------------,-X-.-.-.-.-.-.-.-.-.-.-.-X2XRX-.-.-.-,-.-,-.-,-.-,-,-X-X-X-.-,-,-.-.-.-.-.-.-.-.-.-.-.-X---,-X-.-.-.-.-.-X-,-X-X-X-X-X-------------------------------------------------
----------------------------------------,-X-.-.-.-.-.-.-.-.-.-.-E-X---,-X-E-A-,-E-,-,-,-E-,-X-----,-X-,-,-.-.-.-E-.-.-.-.-.-.-.-X---,-X-.-.-.-.-.-X-------------------------------------------------------------
----------------------------------------,-X-.-.-.-.-.-X-X-X-X-X-X-X-,-,-,-X-X-X-.-.-.-X-X-X-,-,-,-,-,-X-X-X-X-X-X-X-X-X-X-.-.-,-X---,-X-.-.-.-.-.-X-------------------------------------------------------------
----------------------------------------,-X-.-.-.-.-.-X-,-X~X~X~X~X~X~X~X~X~X~X-,-,-,-X-X~X~X~X~X~X~X~X~X~X~X~X~X~X~X~X~X-.-.-,-X---,-X-,-,-,-,-,-X-------------------------------------------------------------
----------------------------------------,-X-.-.-.-.-E-X-,-X~.~.~.~.~.~.~.~.~.~.~.~.~.~.~.~.~.~.~.~.~.~.~.~.~.~.~.~.~.~X~X-.-.-,-X---,-X-.-.-.-.-.-X-------------------------------------------------------------
--------------------------------------,-,-X-.-.-.-.-.-X-,-X~.~.~.~.~.~.~.~.~.~.~.~.~.~.~.~.~.~.~.~.~.~.~.~.~.~.~.~.~.~X~X-.-.-B-X---,-X-.-.-.-.-.-X-------------------------------------------------------------
--------------------------------------,-X-.-.-.-.-.-B-X-,-X~.~.~.~.~.~.~.~.~.~.~.~.~.~.~.~.~.~.~.~.~.~.~.~.~.~.~.~.~,~X~X-.-.-,-X---,-X-E-.-.-.-.-X-------------------------------------------------------------
------------------------------------,-,-X-.-.-.-.-.-.-X-,-X~.~.~.~.~.~.~.~.~.~.~.~.~.~.~.~.~.~.~.~.~.~.~.~.~.~.~.~.~,~X-X-.-.-,-X---,-X-.-.-.-.-.-X-------------------------------------------------------------
--------------------------------,-,-,-X-.-.-.-.-.-.-.-X-X-X-.~.~.~.~.~.~.~.~.~.~.~.~.~.~.~.~.~.~.~.~.~.~.~.~.~.~.~.~,~,-.-.-.-,-X---,-X-.-.-.-,-,-X-------------------------------------------------------------
--------------------------------,-X-X-.-.-.-.-.-.-.-.-E-.-,-.~.~.~.~.~.~.~.~.~.~.~.~.~.~.~.~.~.~.~.~.~.~.~.~.~.~.~.~,~,-E-.-.-,-X---,-X-.-.-.-,-.-X-------------------------------------------------------------
--------------------------------,-X-,-E-.-.-.-.-.-.-.-A-.-,-.~.~.~.~.~.~.~.~.~.~.~.~.~.~.~.~.~.~.~.~.~.~.~.~.~.~.~.~,~,-.-.-.-.-X---,-X-.-.-.-,-.-X-------------------------------------------------------------
--------------------------------,-X-,-.-.-.-.-.-.-.-.-E-.-,-.~.~.~.~.~.~.~.~.~.~.~.~.~.~.~.~.~.~.~.~.~.~.~.~.~.~.~.~,~X-X-.-.-.-X---,-X-.-.-.-,-.-X-----,-,-,-,-,-,-,-,-----------------------------------------
--------------------------------,-X-,-E-W-.-.-.-.-.-.-E-.-,-.~.~.~.~.~.~.~.~.~.~.~.~.~.~.~.~.~.~.~.~.~.~.~.~.~.~.~.~.~X~X-.-.-.-X-,-,-X-.-.-.-,-.-X-,-,-,-X-X-X-X-X-X-X-,-,-------------------------------------
--------------------------------,-X-,-.-.-.-.-.-.-.-.-,-.-,-.~.~.~.~.~.~.~.~.~.~.~.~.~.~.~.~.~.~.~.~.~.~.~.~.~.~.~.~.~X~X-.-.-.-X-X-X-X-.-.-.-,-,-X-,-X-X-X-,-,-,-,-,-X-X-X-------------------------------------
--------------------------------,-X-,-E-.-.-.-.-.-.-.-X-X-X-.~.~.~.~.~.~.~.~.~.~.~.~.~.~.~.~.~.~.~.~.~.~.~.~.~.~.~.~.~X~X-.-.-.-.-.-.-.-.-.-.-.-.-X-,-X-,-.-.-E-.-.-.-.-A-X-------------------------------------
--------------------------------,-X-X-.-.-.-.-.-.-.-.-X-,-X~.~.~.~.~.~.~.~.~.~.~.~.~.~.~.~.~.~.~.~.~.~.~.~.~.~.~.~.~.~X~X-B-.-.-.-.-.-.-.-.-.-.-.-X-,-X-,-.-.-.-.-.-.-.-.-X-------------------------------------
------------------------------------,-X-.-.-.-.-.-.-.-X-,-X~.~.~.~.~.~.~.~.~.~.~.~.~.~.~.~.~.~.~.~.~.~.~.~.~.~.~.~.~.~X~X-.-.-<-.-.-.-.-.-.-.-.-.-X-,-X-H-.-.-.-.-.-.-.-A-X-------------------------------------
------------------------------------,-X-.-.-.-.-.-.-.-X-,-X~.~.~.~.~.~.~.~.~.~.~.~.~.~.~.~.~.~.~.~.~.~.~.~.~.~.~.~.~.~X~,-X-X-.-.-.-.-.-.-.-.-E-.-X-,-X-H-.-.-.-.-.-,-X-X-X-------------------------------------
--------------------------------------,-X-.-.-.-.-.-.-X-,-X~.~.~.~.~.~.~.~.~.~.~.~.~.~.~.~.~.~.~.~.~.~.~.~.~.~.~.~.~.~X~----,-X-.-.-.-.-.-.-.-.-.-X-,-X-H-.-.-.-.-.-,-X-X-X-------------------------------------
----------------------------------------,-X-.-.-.-.-E-X-,-X~.~.~.~.~.~.~.~.~.~.~.~.~.~.~.~.~.~.~.~.~.~.~.~.~.~.~.~.~.~X~------,-X-X-X-X-.-.-.-.-.-X-,-X-,-.-.-.-.-.-,-.-A-X-------------------------------------
----------------------------------------,-X-.-.-.-.-.-X-,-X~.~.~.~.~.~.~.~.~.~.~.~.~.~.~.~.~.~.~.~.~.~.~.~.~.~.~.~.~.~X~------------,-X-,-.-.-.-.-X-,-X-.-.-.-.-.-.-,-.-A-X-------------------------------------
----------------------------------------,-X-.-.-.-.-.-X-,-X~X~X~X~X~X~X~X~X~X~X~X~X~,~,~,~X~X~X~,~,~,~,~X~X~X~X~X~X~X~X~------------,-X-,-.-.-.-.-X-X-X-.-.-.-.-.-.-,-.-.-X-------------------------------------
----------------------------------------,-X-X-.-.-.-X-X-------------,-,-,-X-X-X-X-X-,-,-,-X-X-X-,-,-,-,-X-X-X-X-X-X-X-X-,-,---------,-X-,-.-.-.-.-+-+-.-.-.-.-.-.-.-,-.-W-X-------------------------------------
,-,-,-,-,-,-,-,---------------------------X-X-,-,-,-X-X-----------,-,-X-X-.-.-.-.-.-.-.-.-.-.-.-.-.-.-.-.-.-.-.-.-.-.-.-X-,-,-------,-X-,-.-.-.-.-X-X-X-.-.-.-.-.-.-,-.-.-X-------------------------------------
,-X-X-X-X-X-X-X---------------------------X-------,-,-X---------,-,-X-.-.-.-.-.-.-.-.-.-.-.-.-.-.-.-.-.-.-.-.-.-.-.-.-.-.-X-X-,-----,-X-,-.-.-.-.-X-,-X-.-.-.-.-.-.-,-.-H-X-------------------------------------
,-X-,-.-.-:-A-X---------------------------X-------,-.-X-------,-,-X-.-.-.-.-.-.-.-.-.-.-.-.-.-.-.-.-.-.-.-.-.-.-.-.-.-.-.-.-.-X-,---,-X-,-.-.-.-.-X-,-X-.-.-.-.-.-.-,-X-X-X-------------------------------------
,-X-,-.-W-.-,-X7,-,-,-,-,-,-,-,-,-,-,-,-,-X-------,-.-X-------,-X-.-.-.-.-.-.-A-,-,-,-,-,-,-,-,-,-,-,-,-,-.-.-.-.-.-.-.-.-.-.-.-X---,-X-.-.-.-.-.-X-,-X-,-,-,-,-.-.-.-X-,-,-------------------------------------
,-X-,-.-.-,-,7X7X-X-X-X-X-X-X-X-X-X-X-X-X-X-------,-.-X-----,-,-X-.-.-.-.-.-X-X-X-.-.-.-.-.-.-.-.-.-.-.-X-X-X-E-.-.-.-.-.-.-.-.-,-X-,-X-.-.-.-.-.-X-,-X-,-.-.-,-.-.-.-X-X-X-------------------------------------
,-X-X-X-X-X7,---H-,-,-,-,-,-,-,---------A---------,-.-X---,-,-X-.-.-.-.-.-,-X-,-X-.-.-.-.-.-.-.-.-.-.-.-X-,-X-.-.-.-.-.-.-.-.-.-,-X-,-X-.-E-.-.-.-X-,-X-E-A-.-,-.-.-.-.-.-X-------------------------------------
----,---X-,-----------E---------------------E-----,-,-X---,-X-.-.-.-.-.-.-,-X-X-X-.-.-.-.-.-.-.-.-.-.-.-X-X-X-.-.-.-.-.-.-.-.-.-,-.-X-X-.-.-.-.-.-X-,-X-X-X-X-X-X-X-X-X-X-X-,-,---------------------------------
--,-,-X-------------------------------------,-,-,---,-X-,-,-X-,-.-.-.-.-.-,-.-.-.-.-.-.-.-.-.-.-.-.-.-.-.-,-.-.-.-.-.-.-.-.-.-.-,-.-X-X-.-.-.-.-.-X-,-,-,-,-,-,-,-,-,-X-X-X-X-X-,-,-----------------------------
,-,-X-,-,-----E-----------------------------,-.-,---,-X-X-X-X-,-.-.-.-.-.-,-.-.-.-.-.-.-.-.-.-.-.-.-.-.-.-,-.-.-.-.-.-.-.-.-.-.-,-,-X-X-.-.-.-.-.-X-X-X-X-X-X-X-,-X-X-X-,-,-,-X-X-X-----------------------------
,-,-X-,-,-----------------------------------,-.-,---,-.-A-X-X-,-<-.-.-.-.-,-.-.-.-.-.-.-.-.-.-.-.-.-.-.-.-,-.-.-.-.-.-.-.-.-.-.-.-.-X-X-.-.-.-.-.-.-.-.-,-.-.-X-,-X-.-.-.-E-.-.-,-X-----------------------------
,-X-,-K-------------------------------------,-,-,---,-.-.-X-X-,-.-.-.-.-.-,-.-.-.-.-.-.-.-.-A-.-.-.-.-.-.-,-.-.-.-.-.-.-.-.-.-.-.-.-X-X-.-.-.-.-.-.-.-.-,-.-.-X-,-X-H-.-.-.-.-.-,-X-----------------------------
X-,-,-,-----E-----------------,-,-,-,-,-,-,---------,-.-E-X-X-<-.-.-.-.-.-,-.-.-.-.-.-.-.-.-.-.-.-.-.-.-.-,-.-.-.-.-.-.-.-.-.-.-.-.-.-.-.-.-.-.-.-.-.-.-,-.-H-X-,-X-,-.-.-.-.-.-,-X-----------------------------
X-,-A-------------------------,-.-.-,-,-X-X---------,-.-.-X-X-.-.-.-.-.-.-,-.-.-.-.-.-.-.-.-.-.-.-.-.-.-.-,-.-.-.-.-.-.-.-.-.-.-.-.-.-.-.-.-.-.-.-.-.-.-,-.-H-X-,-X-,-.-.-.-.-.-,-X-----------------------------
X-,---------------------------,-.-.-,-,-.-,-------E-,-.-H-X-.-<-<-.-.-.-.-,-.-.-.-.-.-.-.-.-W-.-.-.-.-.-.-,-.-.-.-.-E-.-.-.-.-.-.-.-.-.-.-.-.-.-.-.-.-.-,-.-.-X-,-X-,-.-.-<-.-.-.-X-----------------------------
X-,-W-----------E-------------<-.-.-,-,-.-,---------,-.-:-X-X-.-.-.-.-.-.-,-.-.-.-.-.-.-.-.-.-.-.-.-.-.-.-,-.-.-.-.-.-.-.-.-.-.-.-.-.-.-.-.-.-.-.-.-.-.-,-.-A-X-,-X-,-E-.-.-.-.-.-X-----------------------------
X-,---------------------------,-.-.-,-,-X-X---------,-.-H-X-X-<-.-.-.-.-.-,-.-.-.-.-.-.-.-.-.-.-.-.-.-.-.-,-.-.-.-.-.-.-.-.-.-.-.-.-.-.-.-.-.-.-.-.-.-.-,-.-A-X-,-X-,-.-.-.-.-.-.-X-----------------------------
X-,-A-------------------------,-,-,-,-,-X-X---------,-.-.-X-X-,-.-.-.-.-.-,-.-.-.-.-.-.-.-.-A-.-.-.-.-.-.-,-.-.-.-.-.-.-.-.-.-.-.-.-X-X-.-.-.-.-.-.-.-.-,-.-.-X-,-X-,-.-.-.-.-E-.-X-----------------------------
X-,-,-------E-------------------------------,-,-,---,-.-E-X-X-,-.-.-.-.-.-,-.-.-.-.-.-.-.-.-.-.-.-.-.-.-.-,-.-.-.-.-.-.-.-.-.-.-,-,-X-X-.-.-.-.-.-.-.-A-,-,-,-X-,-X-.-.-.-.-.-.-.-X-----------------------------
,-X-,---------------------------------------E-.-,---,-.-.-X-X-,-.-.-.-.-.-,-.-.-.-.-.-.-.-.-.-.-.-.-.-.-.-,-.-.-.-.-.-.-.-.-.-.-,-.-X-X-.-.-.-.-.-X-X-X-X-X-X-X-,-X-.-.-.-.-.-.-.-X-----------------------------
,-X-,-,-------------------------------------,-.-,---,-.-A-X-X-.-.-.-.-.-.-,-.-.-.-.-.-.-.-.-.-.-.-.-.-.-.-,-.-.-.-.-.-.-.-.-.-.-,-.-X-X-.-.-.-.-.-X-,-,-,-,-,-,-,-X-.-.-,-,-,-,-.-X-----------------------------
--,-X-,-,-----E-----------------------------,-,-,---,-X-X-X-X-.-.-.-.-.-.-,-X-X-X-.-.-.-.-.-.-.-.-.-.-.-X-X-X-.-.-.-.-.-.-.-.-.-,-,-X-X-E-.-.-.-.-X-,-X-X-X-X-X-X-X-.-.-,-,-,-,-.-X-----------------------------
----,-X-,-,-,---,-,-,-,-,-,-,-,-------------------,-,-X-----,-X-.-.-.-.-.-.-X-,-X-.-.-.-.-.-.-.-.-.-.-.-X-,-X-E-.-.-.-.-.-.-.-.-.-X-,-X-,-.-.-.-.-X-,-X-,-.-.-.-.-.-.-.-.-.-.-.-.-X-----------------------------
------,-X-X-,-,-,-.-.-.-.-E-.-,-,-,-E-,-,-,-------,-.-X-----,-X-.-.-.-.-.-.-X-X-X-,-,-,-,-,-,-,-,-,-,-,-X-X-X-.-.-.-.-.-.-.-.-.-X-,-,-X-,-.-.-.-.-X-,-X-,-.-.-.-.-.-.-.-.-.-.-.-.-X-----------------------------
----------,-X-.-H-,-,-,-,-,-,-,-.-.-.-.-A-,-------,-.-X-------,-X-.-.-.-.-.-.-.-.-.-.-.-.-.-.-.-.-.-.-.-.-.-.-.-.-.-.-.-.-.-.-,-X---,-X-,-.-.-.-B-X-,-X-,-.-.-.-.-.-.-.-.-.-.-,-,-X-----------------------------
------------,-X-X-X-X-X-X-X-X-X-X-X-X-X-X-X-------,-.-X-------,-,-X-.-.-.-.-.-.-.-.-.-.-.-.-.-.-.-.-.-.-.-.-.-.-.-.-.-.-.-.-,-X-----,-X-,-.-.-.-.-X-,-X-,-E-.-.-.-.-.-.-.-.-.-,-.-X-----------------------------
------------------------------------------X-------,-.-X-------,-X-X-X-X-.-.-.-.-.-.-.-.-.-.-.-.-.-.-.-.-.-.-.-.-.-.-.-.-,-,-X-------,-X-,-.-.-.-.-X-,-X-,-.-.-.-.-.-.-.-.-.-.-,-.-X-----------------------------
------------------------------------------X-,-,-E-,-,-X-----,-,-X-X-,-,-X-,-,-,-,-,-,-,-,-,-,-,-,-,-,-,-,-,-,-,-.-.-.-,-X-X---------,-X-,-.-.-.-.-X-,-X-,-.-.-.-.-.-.-.-.-.-.-E-.-X-----------------------------
------------------------------------------X-A-.-.-.-,-X-----,-X~X~X~X~X~X~X~X~X~X~.~.~.~.~X~X~X~.~.~.~.~X~X~X~X~X-X-X-X-,-,-,-,-,-,-,-X-.-.-.-.-.-X-,-X-.-.-.-.-.-.-.-.-E-.-.-,-.-X-----------------------------
------------------------------------------X-X-X-X-X-X-X-----,-X~.~.~.~.~.~.~.~.~.~.~.~.~.~.~.~.~.~.~.~.~.~.~.~X~X-X-X-X-X-X-X-X-X-X-,-X-.-.-.-.-.-X-X-X-.-.-.-.-.-.-.-.-.-.-.-E-.-X-----------------------------
------------------------------------------------------------,-X~.~.~.~.~.~.~.~.~.~.~.~.~.~.~.~.~.~.~.~.~.~.~,~X~X-,-,-,-,-,-,-,-.-X-,-X-.-.-.-.-.-+-+-.-.-.-.-.-.-.-.-.-.-.-.-,-.-X-----------------------------
------------------------------------------------------------,-X~.~.~.~.~.~.~.~.~.~.~.~.~.~.~.~.~.~.~.~.~.~.~,~X-X-.-.-E-.-.-.-.-.-X.XNX-E-.-.-.-.-X-X-X-.-.-.-.-.-.-.-.-.-.-.-,-,-X-----------------------------
------------------------------------------------------------,-X~.~.~.~.~.~.~.~.~.~.~.~.~.~.~.~.~.~.~.~.~.~.~,~.-.-.-.-.-.-.-.-.-.-..+N.-.-.-.-,-,-X-,-X-.-.-.-.-.-.-.-.-E-.-.-.-,-X-----------------------------
------------------------------------------------------------,-X~.~.~.~.~.~.~.~.~.~.~.~.~.~.~.~.~.~.~.~.~.~.~,~X-X-.-.-.-.-.-.-.-.-..+N.-.-.-.-,-.-X-,-X-.-.-.-.-.-.-.-.-.-.-.-.-,-X-----------------------------
------------------------------------------------------------,-X~.~.~.~.~.~.~.~.~.~.~.~.~.~.~.~.~.~.~.~.~.~.~.~X~X-.-.-.-.-.-.-.-.-..+N.-.-.-.-,-.-X-,-X-.-.-.-.-.-.-.-.-.-.-.-.-,-X-----------------------------
------------------------------------------------------------,-X~.~.~.~.~.~.~.~.~.~.~.~.~.~.~.~.~.~.~.~.~.~.~.~X~X-.-.-.-.-.-.-.-.-X.XNX-.-.-.-,-,-X-X-X-.-.-.-.-.-.-E-.-.-.-.-.-B-X-----------------------------
--------------------------------------------,-,-,-,-,-,-,-,-,-X~.~.~.~.~.~.~.~.~.~.~.~.~.~.~.~.~.~.~.~.~.~.~.~X~X-,-.-.-.-.-.-,-X-X-,-X-.-.-.-E-.-X-X-,-.-.-.-.-.-.-.-.-.-.-.-.-,-X-----------------------------
------------------------------------------,-,-X-X-X-X-X-X-X-X-X-.~.~.~.~.~.~.~.~.~.~.~.~.~.~.~.~.~.~.~.~.~.~.~X~X-,-.-.-.-.-.-,-X---,-X-.-.-.-.-.-X-X-,-.-.-.-.-.-.-.-.-.-.-.-.-,-X-----------------------------
--------------------------------------,-,-X-X-.-.-.-.-.-.-.-,-,-.~.~.~.~.~.~.~.~.~.~.~.~.~.~.~.~.~.~.~.~.~.~.~X~X-,-.-.-.-.-.-,-X---,-X-.-A-.-W-.-X-X-,-.-.-.-.-.-.-.-.-.-.-.-.-.-X-----------------------------
------------------------------------,-,-X-.-.-.-:-.-.-.-E-.-,-,-.~.~.~.~.~.~.~.~.~.~.~.~.~.~.~.~.~.~.~.~.~.~.~X~X-,-E-.-.-.-.-,-X---,-X-.-.-.-.-.-X-X-,-.-.-.-.-.-.-.-.-.-.-.-,-,-X-----------------------------
------------------------------------,-X-,-.-.-.-.-.-.-.-.-.-,-,-.~.~.~.~.~.~.~.~.~.~.~.~.~.~.~.~.~.~.~.~.~.~.~X~X-,-.-.-.-.-.-,-X---,-X-E-.-E-.-E-X-X-E-.-.-.-.-.-.-.-.-.-.-.-,-.-X-----------------------------
------------------------------------,-X-,-.-.-.-.-.-,-X-X-X-X-X-.~.~.~.~.~.~.~.~.~.~.~.~.~.~.~.~.~.~.~.~.~.~.~X~X-,-.-.-.-.-.-,-X---,-X-.-E-.-E-.-X-X-X-.-.-.-.-.-.-.-.-.-.-.-,-.-X-----------------------------
------------------------------------,-X-,-.-.-.-,-,-X-------,-X~.~.~.~.~.~.~.~.~.~.~.~.~.~.~.~.~.~.~.~.~.~.~.~X~X-,-E-.-.-.-.-,-X---,-X-.-.-.-.-.-X-,-X-.-.-.-.-.-.-.-.-.-.-.-E-.-X-----------------------------
------------------------------------,-X-,-.-.-,-X-X---------,-X~.~.~.~.~.~.~.~.~.~.~.~.~.~.~.~.~.~.~.~X~X~.~.~X~X-,-.-.-.-.-E-,-X-,-,-X-E-.-E-.-E-X-,-X-.-.-.-.-.-.-.-E-.-.-.-,-.-X-----------------------------
------------------------------------,-X-,-.-,-X-------------,-X~.~.~,~,~,~,~.~.~.~.~.~.~,~,~,~,~,~,~.~X~X~.~.~X~X-.-.-.-.-.-.-.-X-X-,-X-.-.-.-.-.-X-,-X-.-.-.-.-.-.-.-.-.-H-.-,-,-X-----------------------------
------------------------------------,-X-,-.-,-X-------------,-X~X~X~X~X-.-X-X~X~X~X~X~X~X~X-,-,-,-X-X~X~X~X~X~X~X-X-.-.-.-X-X-X-X-X-,-X-.-E-.-E-.-X-,-X-.-X-X-X-X-X-X-X-X-X-X-X-X-X-----------------------------
------------------------------------,-X-.-.-,-X---------------------,-X-,-X-----,-X-X-X-X-X-E-.-.-X-X-X-X-X-X-X-X-X-.-.-.-X-X-X-X-X-,-X-.-.-W-.-H-X-,-X-.-X-----------------------------------------------------
------------------------------------,-X-:-.-,-X---------------------,-X-.-X-----,-X-.-.-.-.-.-.-.-.-.-.-.-.-.-.-.-.-.-.-.-.-.-.-E-X-,-X-X-X-X-X-X-X-,-X-X-X-----------------------------------------------------
------------------------------------,-X-.-.-,-X---------------------,-X-,-X-----,-X-E-.-.-.-.-.-.-.-.-.-W-.-.-.-.-.-.-.-.-.-.-,-,-X-----------------------------------------------------------------------------
------------------------------------,-X-.-.-,-X---------------------,-X0.0X0----,-X-.-.-.-.-<-.-.-.-.-X-X-X-.-.-.-.-.-.-.-.-.-,-.-X-----------------------------------------------------------------------------
------------------------------------,-X-.-.-,-X---------------------,-X-,-X-,-,-,-X-.-.-.-.-.-.-.-.-,-X-,-X-.-.-.-.-.-.-.-.-.-,-.-X-----------------------------------------------------------------------------
------------------------------------,-X-.-:-.-X---------------------,-X-,-X0X0X0X-X-.-.-.-.-.-.-.-.-,-X-X-X-.-.-.-.-.-.-.-.-.-,-.-X-----------------------------------------------------------------------------
------------------------------------,-X-.-:-.-X---------------------,-X-,-.0H0H0.-.-.-.-.-.-.-.-.-.-,-,-,-.-.-.-.-.-.-.-.-.-.-,-.-X-----------------------------------------------------------------------------
------------------------------------,-X-.-.-.-X---------------------,-X-X-X0X0X0X-X-.-.-.-.-.-.-.-.-.-.-E-.-.-.-.-.-.-.-.-.-.-,-.-X-----------------------------------------------------------------------------
------------------------------------,-X-.-.-.-X---------------------------------,-X-,-.-.-.-.-.-.-.-.-.-.-.-.-.-.-.-.-.-.-.-.-,-.-X-----------------------------------------------------------------------------
----------------------------------,-,-X-.-.-.-X-,-,-----------------------------,-X-,-.-.-.-.-.-.-.-.-.-.-.-.-.-.-.-.-.-.-.-.-,-.-X-----------------------------------------------------------------------------
------------------------------,-,-X-X-.-.-<-.-.-X-,-,---------------------------,-X-,-.-.-.-.-.-.-.-.-.-.-.-.-.-.-.-.-.-.-.-.-,-.-X-----------------------------------------------------------------------------
----------------------------,-,-X-.-.-.-.-.-.-.-.-X-X-,-------------------------,-X-,-E-.-.-.-.-,-,-,-,-,-,-,-,-,-,-,-,-,-,-,-,-,-X-----------------------------------------------------------------------------
--------------------------,-,-X-.-.-.-.-.-.-.-.-.-.-.-X-,-----------------------,-X-,-.-,-,-,-,-,-.-.-.-.-.-.-.-.-.-.-.-,-,-,-.-A-X-----------------------------------------------------------------------------
------------------------,-,-X-.-.-.-.-.-.-.-.-.-.-.-.-.-X-----------------------,-X-,-.-,-.1.1.1.1.1.-.-E-E-.-.-.-.-E-.-E-.-,-.-.-X-----------------------------------------------------------------------------
------------------------,-.-X-.-.-.-.-.-.-.-.-.-.-.-.-.-,-X---------------------,-X-.-.-,-.1.1.1.1.1.-.-.-.-.-.-.-.-.-.-.-.-,-.-.-X-----------------------------------------------------------------------------
----------------------,-,-X-.-.-.-.-.-.-.-.-.-.-.-.-.-.-.-X-,-------------------,-X-.-.-,-.1.1.1.1.1,-,-,-,-,-,-.-.-.-.-,-,-,-.-.-X-----------------------------------------------------------------------------
----------------------,-X-.-.-.-.-.-.-,-,-E-,-.-.-.-.-.-.-.-X-------------------,-X-.-.-,-.1.1.1.1.1,-.-.-.-.-,-.-.-.-.-,-.-E-.-A-X-----------------------------------------------------------------------------
----------------------,-X-.-.-.-.-.-.-,-.-.-,-.-.-.-.-.-.-.-X-------------------,-X-X-X-X-X1X1X1X1X1X-X-X-X-X-X-X-X-.-X-X-X-X-X-X-X-----------------------------------------------------------------------------
----------------------,-X-.-.-E-.-.-.-,-,-W-,-.-.-.-.-E-.-.-X---------------------------,-,-,-,-,-,-,-------,-,-,-X4.4X4,-,-----,-,-,-,-,-,-,-------------------------------------------------------------------
----------------------,-X-.-.-.-.-.-.-.-.-.-.-.-.-.-.-.-.-.-X---------------------------,-X-X-X-X-X-X---,-,-,-X-X-X-.-X-X-X-,---,-X-X-X-X-X-X-------------------------------------------------------------------
----------------------,-X-.-.-.-.-.-.-.-.-.-.-.-.-.-.-.-.-,-X---------------------------,-X-H-.-.-E-X4,-,-X-X-.-.-.-.-.-.-.-X-,-,-X-E-.-H-E-X-------------------------------------------------------------------
------------------------,-X-A-.-.-.-.-.-.-.-.-.-.-.-.-A-.-X-----------------------------,-X-.-.-.-,-X4,-X-.-.-.-.-.-.-.-.-.-.-X-X-X-.-.-.-.-X-------------------------------------------------------------------
--------------------------X-.-.-.-.-.-.-.-.-.-.-.-.-.-.-X-,-----------------------------,-X-.-.-E-,-X-X-.-.-.-.-.-.-.-.-.-.-.-.-.-X-.-E-.-.-X-------------------------------------------------------------------
--------------------------,-X-.-.-.-.-.-.-.-.-.-.-.-.-,-X-------------------------------,-X-.-,-,-.-,-.-.-.-.-.-.-.-.-.-.-.-.-.-.-,-,-.-.-.-X-------------------------------------------------------------------
----------------------------,-X-.-.-.-.-.-.-.-.-.-.-,-X---------------------------------,-X-.-E-.-,-,-.-.-.-.-.-.-.-.-.-.-.-.-.-.-,-,-.-E-.-X-------------------------------------------------------------------
------------------------------,-X-X-.-.-.-.-.-.-,-,-X-----------------------------------,-X-A-,-,-,-.-.-.-.-.-.-.-.-.-.-.-.-.-.-.-.-.-.-.-.-X-------------------------------------------------------------------
--------------------------------,-,-X-.-.-A-.-,-X-X-------------------------------------,-X-X-X-X-.-.-.-.-.-.-.-.-.-.-.-.-.-.-.-.-.-.-.-X-X-X-------------------------------------------------------------------
------------------------------------,-X-X-X-X-X---------------------------------------------,-,-X-.-.-.-.-.-.-.-.-,-,-,-.-.-.-.-.-.-.-,-X-----------------------------------------------------------------------
--------------------------------------------------------------------------------------------,-X-X-.-.-.-.-.-.-.-,-,-.-,-.-.-.-.-.-.-.-,-X-----------------------------------------------------------------------
--------------------------------------------------------------------------------------------,-X-X-.-.-.-.-.-.-.-,-.-W-,-.-.-.-.-.-.-.-,-X-----------------------------------------------------------------------
----------------------------------------------------------------------------------------------,-X-.-.-.-.-.-.-.-,-,-,-.-.-.-.-.-.-.-.-.-X-----------------------------------------------------------------------
----------------------------------------------------------------------------------------,-,-,-,-X-.-.-.-.-.-.-.-.-.-.-.-.-.-.-.-.-.-.-.-X-,-,-------------------------------------------------------------------
----------------------------------------------------------------------------------------,-X-X-X-X-,-.-.-.-.-.-.-.-.-<-.-.-.-.-.-.-.-.-.-X-X-X-------------------------------------------------------------------
----------------------------------------------------------------------------------------,-X-.-.-,-.-,-.-.-.-.-.-.-.-.-.-.-.-.-.-.-.-.-.-.-.-X-------------------------------------------------------------------
----------------------------------------------------------------------------------------,-X-.-E-.-,-,-.-.-.-.-.-.-.-.-.-.-.-.-.-.-.-.-.-E-.-X-------------------------------------------------------------------
----------------------------------------------------------------------------------------,-X-.-.-.-,-.-,-.-.-.-.-.-.-.-.-.-.-.-.-.-.-.-.-.-.-X-------------------------------------------------------------------
----------------------------------------------------------------------------------------,-X-.-.-E-.-X-X-X-,-.-.-.-.-.-.-.-.-.-.-.-X-.-E-.-.-X-------------------------------------------------------------------
----------------------------------------------------------------------------------------,-X-A-.-.-.-X---,-X-,-.-.-.-.-.-.-.-.-,-X-X-.-.-.-.-X-------------------------------------------------------------------
----------------------------------------------------------------------------------------,-X-E-.-.-E-X---,-X-,-.-,-,-,-.-.-,-X-X-,-X-E-.-H-E-X-------------------------------------------------------------------
----------------------------------------------------------------------------------------,-X-X-X-X-X-X---,-X-.-X-X-X-X-X-X-X-----,-X-X-X-X-X-X-------------------------------------------------------------------
--------------------------------------------------------------------------------------------------------,-X-.-X-------------------------------------------------------------------------------------------------
--------------------------------------------------------------------------------------------------------,-X-X-X-------------------------------------------------------------------------------------------------
