----------------------------------------------------------,-,-X-,---------------------------------------------------------
----------------------------------------------------------,-X-.-X---------------------------------------------------------
----------------------,-,-,-,-,-,-----------------------,-,-X-.-X-,-------------------------------------------------------
----------------------,-X-X-X-X-X-----------------------,-X-.-.-.-X-------------------------------------------------------
----------------------,-X-.-.-.-X-----------------------,-X-.-.-.-X-------------------------------------------------------
----------------------,-X-.-E-.-X-----------------------,-X-.-.-.-X-------------------------------------------------------
--------------,-,-,-,-,-XQ+Q+Q+QXQ,-,-,-,---------------,-X-.-.-.-X-------------------------------------------------------
--------------,-X-X-X-X-XQ+Q+Q+QXQX-X-X-X---------------,-X-.-.-.-X-------------------------------------------------------
--------------,-X-.-,-.-.-.-.-.-.-,-.-.-X---------------,-X-.-.-.-X-------------------------------------------------------
--------------,-X-,-,-,-,-,-,-,-,-,-,-,-X---------------,-X-.-.-.-X-------------------------------------------------------
--------,-,-,-,-X-.-.-,-,-,-,-,-,-.-.-,-X-,-,-,---------,-X-.-.-.-X-------------------------------------------------------
--------,-X-X-X-XQ.-.-,-,-.-.-,-,-.-.-,-XQX-X-X---------,-X-.-.-.-X-------------------------------------------------------
--------,-X-.-.-,-.-.-,-,-,1,1,1,-.-.-,-.-.-.-X---------,-X-.-.-.-X-------------------------------------------------------
--------,-X-E-.-,-.-.-,-.-.-<-:-,-.-.-,-.-.-E-X---------,-X-.-.-.-X-------------------------------------------------------
--------,-X-.-.-,-.-.-,-.-.-.-.-,-.-.-,-.-.-.-X---------,-X-.-.-.-X-------------------------------------------------------
--------,-X-X-X-XQ.-.-,-.-E-H-E-,-.-.-,-XQX-X-X---------,-X-.-.-.-X-------------------------------------------------------
--------------,-X-,-,-,-.-.-.-.-,-,-,-,-X---------------,-X-.-.-.-X-------------------------------------------------------
--------------,-X-.-,-,-.-.-.-.-,-,-.-.-X---------------,-X-.-.-.-X-,-,-,-,-----------------------------------------------
--------------,-X-.-,-,-.-.-A-.-,-,-.-.-X---------------,-X-.-.-.-X-,-X-X-X-----------------------------------------------
--------------,-X-X-X-X-X-.-.-.-X-X-X-X-X-,-,-,-,-,-,-,-,-X-.-.-.-X-,-X-H-X-,---------------------------------------------
----------------,-X-X-X-X-+-+-+-X-X-X-X-X-X-X-X-X-X-X-X-X-X-.-.-.-X-X-XQ,-XQX---------------------------------------------
--------,-,-,-,-,-X-.-E-.-.-.-E-.-.-E-X-X-.-<-<-X-.-.-.-,-.-.-.-.-.-.-.-.-.-X---------------------------------------------
--------,-X-X-X-X-X-B-.-.-.-.-.-.-.-.-X-X-.-<-,-X-E-.-E-,-.-.-E-.-.-.-.-E-.-X---------------------------------------------
--------,-X-.-.-.-+Q.-.-.-.-.-.-.-.-.-X-X-.-.-,-X-.-.-.-,-.-.-.-.-.-.-.-.-.-X---------------------------------------------
--------,-X-H-.-.-+Q.-.-.-.-.-.-.-.-.-X-X.....,.X..-.-.-,-.-.-.-.-.-.-.-.-.-X---------------------------------------------
--------,-X-,-,-,-+Q.-.-.-.-.-.-.-.-.-,-......,....-.-.-,-.-.-.-.-.-.-.-.-.-X---------------------------------------------
--------,-X-,-,-X-X-.-.-.-.-.-.-.-.-.-,-....W.,....-.-.-,-.-.-.-.-.-.-.-.-.-X---------------------------------------------
--------,-X-,-,-X-X-B-.-.-.-.-.-.-.-.-,-....A.,....-.-.-,-.-.-.-.-.-,-,-,-,-X---------------------------------------------
--------,-X-,-,-X-X-X-.-.-.-.-.-.-.-.-X-X.....,.X..-.-.-,-.-:-.-.-.-,-.-.-.-X---------------------------------------------
--------,-X-.-.-X-X-X-,-,-,-,-.-.-.-.-X-X-.-.-,-X-.-.-.-,-.-.-.-.-.-,-,-,-,-X---------------------------------------------
--------,-X-,-,-X-X-.-.-.-.-,-.-.-.-.-X-X-.-t=,-X-.-.-.-,-H-,-,-,-,-,-,-,-,-X---------------------------------------------
--------,-X-.-.-XQXQ.-.-.-.-,-.-.-.-.-X-X-.-.-,-X-.-.-.-.-.-.-.-.-.-.-.-.-.-X---------------------------------------------
--------,-X-.-.-+Q+Q.-.-.-.-,-.-.-.-.-X-X-.-.-,-X-.-.-.-.-.-.-.-.-.-.-.-.-.-X---------------------------------------------
--------,-X-.-.-+Q+Q.-.-.-.-,-.-.-.-.-X-X-X-.-X-X-.-.-.-.-.-.-.-.-.-.-.-.-E-X---------------------------------------------
--------,-X-.-.-+Q+Q.-.-.-.-,-.-.-.-.-X-,->->->-X-B-,-,-,-,-.-.-.-,-,-,-,-E-X---------------------------------------------
----,-,-,-X-X-X-XQXQ.-.-.-.-,-.-.-.-.-X-------,-X-X-.-.-,-X-.-.-.-X-X-.-.-.-X---------------------------------------------
----,-X-X-X-X-X-X-XQ.-.-.-.-,-.-.-.-.-X---------,-X-.-.-,-XU.-.-.-XUX-.-.-.-X---------------------------------------------
----,-X-E-.-E-.-E-.-.-.-.-.-,-.-.-.-.-X---------,-X4.4.4,4.4.-.-.-.5,-E4.4.4X4--------------------------------------------
----,-X-H-.-.-.-.-.-.-.-.-.-,-.-.-.-.-X---------,-X4E4E4,4XU+O+O+OXUX-.4.4.4X4--------------------------------------------
----,-X-E-.-E-.-E-.-.-.-.-.-,-.-.-.-.-,-X-------,-X4T4.4A4X/./././X/X4.4.4.4X4--------------------------------------------
----,-X-X-X-X-X-X-XQ.-.-.-.-,-,-.-.-.-.-X-------,-X4E4.4E4X-.-.-.-X-X4.4.4.4X4--------------------------------------------
----,-,-,-,-,-,-,-X-.-.-A-.-,-,-,-.-.-.-,-X-,-,-,-X4,4,4,4X-.-.-.-X-X4,4,4,4X4,-,-,-,-------------------------------------
----,-X-X-X-X-X-X-X-.-.-.-.-,-,-,-,-.-.-E-X-X-X-X-X-.-.-.-X-.-.-.-X-X-,-,-.-X-X-X-X-X-------------------------------------
----,-X-.-.-.-.-.-,-.-.-.-.-.-,-.-B-.-.-.-.-.-.-.-.-.-.-.-.-.-.-.-,-,-,-,-.-E-.-B-B-X-------------------------------------
----,-X-t>.-.-.-.-,-.-.-.-.-.-,-,-,-,-,-.-.-.-.-.-.-.-.-.-.-.-.-.-,-,-,-,-.-.-E-.-.-X-------------------------------------
----,-X-.-.-.-.-.-,-.-.-.-.-.-.-,-,-,-,-,-,-,-,-.-.-,-,-,-,-,-,-,-,-,-,-,-,-,-,-,-,-X-------------------------------------
----,-X-X_+_.?+_X-X-.-.-.-.-.-.-.-.-,-,-,-,-.-,-.-,-,-.0.0.0.0.0.-.-.-.-.-.-.-.-.-.-X-------------------------------------
------,-X-.-H-.-X-X-.-.-.-.-A-.-.-.-.-.-.-,-,-,-,-,-.-.0.0.0.0.0.-.-.-.-.-.-.-.-.-.-X-------------------------------------
------,-X-X-X-X-X-X-.-.-.-.-.-.-.-.-.-.-.-.-.-.-,-,-.-.0.0.0.0.0.-.-.-.-.-.-.-.-.-.-X-------------------------------------
,-,-,-,-,-,-X-X-X-X-,-.-.-.-.-.-.-.-.-.-A-.-.-.-,-,-.-.0.0.0.0.0.-.-.-.-.-.-.-.-<-.-X-------------------------------------
X-X-X-X-X-,-X-.-.-.-,-,-.-.-.-.-.-.-.-.-.-.-.-.-,-,-.-.0.0.0.0.0.-.-.-.-.-.-.-.-.-.-X-------------------------------------
X-E-.-E-X-,-X-.-.-.-.-,-,-.-.-,-,-,-,-,-,-,-,-,-,-,-.-.0.0.0.0.0.-.-.-.-.-.-.-.-.-.-X-------------------------------------
X-.-.-.-X-,-X-.-.-.-.-.-X-X-X-X-X-.-.-.-.-.-.-.-.-X-.-.0.0.0.0.0.-.-.-.-.-.-.-.-.-.-X-------------------------------------
X-E-.-E-X-,-X-.-.-.-.-.-X-----,-X-.-.-.-.-.-.-.-.-X-H-,0,0,0,0,0,-,-,-,-,-,-,-,-.-H-X-------------------------------------
X-.-.-.-X-,-X-.-.-.-.-.-X-,-,-,-X-t;A-E-A2E2A-E-t:X-X-X0.-.-.-X0X-X-.-.-.-.-.-X-X-X-X-------------------------------------
X-E-.-E-X-,-X-X-L-L-L-X-X-,-X-X-X-,-,-,2,2,2,2,-,-X-X-X-.-.-.-X-,-X-B-.-W-B-B-X-------------------------------------------
XY.-.-.-XYX-X-X-L-L-L-X-X-,-X-.-.-.-.-.-.-.-.-.-.-.-,-.-.-:-.-X-,-X-X-X-.-X-X-X-,-,-,-------------------------------------
X-.-.-.-.-.-.-.-.-.-.-.-X-,-X-.-.-.-.-.-.-.-.-.-.-.-,-.-.-.-.-X-X-X-X-X-+-X-X-X-X-X-X-------------------------------------
X-.-.-.-.-.-.-.-.-.-.-.-X-,-X-E-.-.-.-.-.-.-.-.-.-E-,-.-.-.-.-X-X-.-.-.-.-.-.-.-.-.-X-------------------------------------
X-.-.-.-.-.-.-.-.-.-.-,-X-,-X-.-,-,-,-,-.-,-,-,-,-,-,-.-E-.-E-X-X-.-E-.-.-.-.-.-.-H-X-------------------------------------
X-.-.-.-.-.-.-.-.-:-.-,-X-,-X-,-,-.-.-,-,-,-.-.-.-,-,-.-.-.-.-X-X-,-,-,-,-,-,-,-,-,-X-------------------------------------
X-.-.-.-.-E-.-.-.-.-.-,-,-X-X-,-,-,-,-,-,-,-,-,-,-,-,-.-.-.-.-X-X-.-.-.-.-.-.-.-.-.-X-------------------------------------
X-.-.-.-.-.-.-E-.-.-.-,-.-X-X-X-X-,-,-,-,-H-,-,-,-X-X-X-.-.-.-X-X-E-.-E-.-E-E-.-E-E-X-------------------------------------
X-.-.-.-.-.-.-.-E-.-.-,-X-,---,-X-,-,-,-,-,-,-,-,-X-,-X-+-+-+-X-X-X-,-,-,-X-X-.-.-.-X-,-,-,-,-,-,-,-,-,-,-,-,-,-----------
X-.-.-,-,-,-,-,-,-.-.-,-X-----,-X-.-.-.-.-.-.-.-.-X-X-X-.-.-.-X-X6X6.-.-.-X-X-+-+-+-X-X-X-X-X-X-X-X-X-X-X-X-X-X-----------
X-.-.-,-.-.-.-.-,-.-.-.-X-----,-X-.-.-.-.-.-.-.-.-.-.-.-.-.-.-.-.6,6.-.-.-.-,-.-.-.-X-X-X-X-X-X-X-X-X-X-X-X-X-X-----------
X-.-.-,-.-:-.9.-,-.-.-.-X-----,-X-.-.-E-.-.-.-.-.-.-.-.-.-.-.-.-X6X6X-.-.-.-,-,-,-,-X---------------------,-X-X-----------
X-.-.-,-.-.9.-.9,-.-.-.-X-----,-X-<-.-.-.-.-.-.-.-.-.-.-.-.-.-.-X-,-X-.-H-.-,-.-.-.-X---------------------,-X-X-----------
X-X-X-X-X9.-K-.-X9X-X-X-X-----,-X-.-.-.-.-.-.-.-.-.-.-.-.-.-.-.-X6X6X-.-.-.-,-.-E-.-X---------------------,-X-X-----------
------,-X-X-X-X-X-------------,-X-E-.-.-.-.-.-.-.-.-.-.-.-.-.-.-.6,6.-.-.-.-,-,-,-,-X---------------------,-X-X-----------
------------------------------,-X-.-.-.-X-X-X-.-.-X-X-X-.-.-.-.-X6X6X-.-.-.-,-.-.-.-X---------------------,-X-X-----------
------------------------------,-X-.-.-.-X-,-X-.-.-X-,-X-.-.-.-.-X-,-X-.-H-.-,-.-E-.-X---------------------,-X-X-----------
------------------------------,-X-,-,-,-X-X-X-,-,-X-X3X-.-.-.-.-X6X6X-.-.-.-,-,-,-,-X---------------------,-X-X-----------
------------------,-,-,-,-,-,-,-X-.-.-.-.-.-.-.-,-.-.3.-.-.-.-.-.6,6.-.-.-:-,-,-.-,-X---------------------,-X-X-----------
------------------,-X-X-X-X-X-X-X-.-.-.-.-.-.-.-,-X-X3X-.-.-.-.-X6X6X-.-.-,-,-,-,-X-----------------------,-X-X-----------
------------------,-X-.-.-.-.-.-,-.-.-.-.-.-.-.-,-X-,-X-.-E-.-.-X-,-X-.-,-,-.-.-,-X-----------------------,-X-X-----------
------------------,-X-E-.-E-.-E-,-.-.-.-.-.-.-.-,-X-X-X-E-.-.-E-X-X-X-,-,-,-.-.-X-------------------------,-X-X-----------
------------------,-X-X-X-X-X-X-X-,-,-,-.-.-.-.-,-.-.-.-.-.-.-.-,-,-.-.-,-,-,-,-X-------------------------,-X-X-----------
------------------------------,-X-t4t4t4.-.-.-.-,-.-.-.-.-.-.-.-,-,-.-.-,-.-,-X---------------------------,-X-X-----------
------------------------------,-X-t4.-t4.-.-.-.-,-.-.-.-.-.-H-.-,-,-.-.-,-X-X-----------------------------,-X-X-----------
------------------------------,-X-X4X4X4X-X-X-X-X-X-X-X-X-.-.-.-X-X-X-X-X---------------------------------,-X-X-----------
------------------------------------------------------,-X-L-L-L-X-----------------------------------------,-X-X-----------
------------------------------------------------------,-X-.-.-.-X-----------------------------------------,-X-X-----------
------------------------------------------------------,-X-W-A-.-X-----------------------------------------,-X-X-----------
--------------------------------------------------,-,-,-X-.-.-,-X-,-,-------------------------------------,-X-X-----------
--------------------------------------------------,-X-X-X-.-.-,-X-X-X-------------------------------------,-X-X-----------
----------------------------------------,-,-,-,-,-,-X-E-,-.-.-,-.-E-X-,-,-,-,-,---------------------------,-X-X-----------
------------------------------------,-,-,-X-X-X-X\X-X-,-,-.-.-,-,-,-X-X\X\X-X-X-,-,-----------------------,-X-X-----------
------------------------------------,-X-X-X>.-.-.-.-.-.-.-E-.-.-.-.-.-+\+\.-,-X=X-X-----------------------,-X-X-----------
------------------------------------,-X-.-t>A-.-.-.-.-.-.-.-.-.-.-.-.-+\+\A-,-t=.-X-----------------------,-X-X-----------
------------------------------------,-X-X-X>.-.-.-,-,-,-,-.-.-,-,-,-,-+\+\.-,-X=X-X-----------------------,-X-X-----------
----------------------------------------,-X-X-X-X\X-X-.-,-.-.-,-.-.-X-X\X\X-X-X---------------------------,-X-X-----------
--------------------------------------------------,-X-E-,-.-<-,-.-E-X-------------------------------------,-X-X-----------
--------------------------------------------------,-X-X-X-.-A-,-X-X-X-------------------------------------,-X-X-----------
------------------------------------------------------,-X-.-.-.-X-----------------------------------------,-X-X-----------
------------------------------------------------------,-X-X<X<X<X-----------------------------------------,-X-X-----------
----------------------------------------------------------------------------------------------,-,-,-,-,-,-,-X-X-,-,-,-,-,-
----------------------------------------------------------------------------------------------,-X-X-X-X-X-X-X-X-X-X-X-X-X-
----------------------------------------------------------------------------------------------,-X-.-.-.-.-.-.-.-.-.-.-.-X-
----------------------------------------------------------------------------------------------,-X-E-.-.-E-.-.-.-.-.-.-.-X-
----------------------------------------------------------------------------------------------,-XY+Y+Y.-.-.-.-.-.-.-.-.-X-
----------------------------------------------------------------------------------------------,-X;t;t;t;t:t:t:.-.-.-.-.-X-
----------------------------------------------------------------------------------------------,-X-.-.-.-.-.-.-.-.-.-.-.-X-
----------------------------------------------------------------------------------------------,-X-.-.-.-.-.-.-.-.-.-.-.-X-
----------------------------------------------------------------------------------------------,-X-X-X-X-X-X-X-X-X-X-X-X-X-
