------------,-X-X-X-X-----------------------------------------------------------------------------------------------------------------------------------------------------------------------
------------,-X-.-.-X-----------------------------------------------------------------------------------------------------------------------------------------------------------------------
------------,-X-.-.-X-----------------------------------------------------------------------------------------------------------------------------------------------------------------------
------------,-X-.-.-X-----------------------------------------------------------------------------------------------------------------------------------------------------------------------
------------,-X-.-.-X-----------------------------------------------------------------------------------------------------------------------------------------------------------------------
------------,-X-.-.-X-------------------------------------------------------------------------------------------------------------------------------------------------,-,-,-,-,-,-,-,-,-,---
------------,-X-.-.-X-------------------------------------------------------------------------------,-,-,-,-,-,-------------------------------------------------------,-X-X-X-X-X-X-X-X-X---
------------,-X-.-.-X-------------------------------------------------------------------------------,-X-X-X-X-X-------------------------------------------------------,-X-.-.-.-.-.-.-.-X---
------------,-X-.-.-X-------------------------------------------------------------------------------,-X-<-<-<-X-------------------------------------------------------,-,-X-.-.-.-.-.-<-X-,-
------------,-X-.-.-X-------------------------------------------------------------------------------,-X-.-<-.-X-------------------------------------------------------,-X-.-.-.-.-.-.-.-X-X-
------------,-X-.-.-X-------------------------------------------------------------------------------,-X-.-.-.-X-------------------------------------------------------,-X-.-.-.-.-.-.-.-,-X-
------------,-X-.-.-X-------------------------------------------------------------------------------,-X-.-.-.-X-------------------------------------------------------,-X-X-.-.-E-.-.-.-,-X0
------------,-X-.-.-X-------------------------------------------------------------------,-,-,-,-,-,-,-X-.-A-.-X-,-,-,-,-,-,-,-----------------------------------------,-X-X-.-.-.-.-.-.-,-X0
------------,-X-.-.-X-----------------------------------------------------------------,-,-X-X-X-X-X-X-X-.-.-.-X-X-X-X-X-X-X-X-,---------------------------------------,-X-.-.-.-.-.-.-.-,-X0
------------,-X-.-.-X---------------------,-,-,-,-,-,-,-,-,-,---,-,-,-,-,-,-----------,-X-.-,-.-.-.-.-.-.-.-.-.-.-.-.-.-,-,-.-X---------------------------------------,-X-X-X-E-.-.-.-E-,-X-
------------,-X-.-.-X-------------------,-,-X-X-X-X-X-X-X-X-X-,-,-X-X-X-X-X---------,-,-X-.-,-,-.-.-.-.-.-.-.-.-.-.-.-.-,-.-.-X-,---------------,-,-,-,-,-,-,-,-,-,-,-,-,-,-X-.-E-.-.-.-X-X-
----------,-,-X-.-,-X-,---------------,-,-X-.-.-E-.-.-.-.-.-.-X-,-X-.-W-.-X-------,-,-X-,-.-.-,-.-.-.-,-,-,-,-,-.-.-.-,-,-,-,-,-X-,-----------,-,-X-X-X-X-X-X-X-X-X-X-X-X-X-,-.-.-.-E-.-X---
----------,-X-,-.-,-.-X---------------,-X-.-.-.-.-.-.-.-.-.-.-B-X-X-.-.-.-X-------,-X-X-,-,-,-X-X-X-X-X-X-,-,-X-X-X-X-X-X-,-,-,-X-X---------,-,-X-.-.-.-,-,-,-,-,-,-.-.-.-,-.-,-.-.-.-.-X---
----------,-X-,-.-,-.-X---------------,-X-.-.-E-.-.-.-.-.-.-.-.-X-X-B-.-.-X-----,-,-X-,-.-,-,-X-X-X-X-X-X-.-.-X-X-X-X-X-X-,-,-,-,-X-,-----,-,-X-.-.-.-.-,-,-,-E-,-,-.-E-.-.-,-.-X-X-X-X-X---
----------,-X-E-.-,-E-X---------------,-X-,-,-E-.-.-.-.-.-.-.-B-X-X-.-A-B-X-----,-X-.-,-,-,-X-X-.-.-.-.-.-W-.-.-.-.-.-.-X-X-,-,-,-,-X-----,-X-.-.-.-,-,-,-,-,-,-,-,-.-.-.-E-.-,-X-----------
----------,-X-,-.-,-.-X---------------,-X-X-,-X-X-.-.-.-.-.-.-.-X-X-.-.-.-X---,-,-X-,-,-,-,-X-X-.-.-.-.-.-.-.-t7.-.-.-.-,-X-,-,-,-,-X-,---,-X-.-.-,-,-.-,-,-,-,-,-,-,-,-.-.-E-.-X-----------
----------,-X-,-E-,-.-X-----------------,-X-,-X-X-X-X-X-X-X-+-X-X-X-.-.-.-X---,-X-.-.-,-,-X-X-.-.-.-.-.-.-.-.-.-.-.-.-.-.-,-X-,-,-,-.-X---,-X-.-.-,-.-.-.-.-.-.-.-.-,-,-.-.-.-.-X-----------
----------,-X-,-.-,-.-X-----------------,-X-,-X---,-,-X-X-X-.-X-X-X-X-.-.-X-,-,-X-,-,-.-X-X-X-.-.-.-.-t7.-.-.-.-.-.-.-.-.-,-X-X-.-.-.-X-,-,-X-.-.-,-.-.-,-,-,-,-,-,-,-,-,-,-,-,-X-----------
----------,-X-,-.-,-.-X-----------------,-X-,-X-,-,-X-.-E-.-.-.-.-.-X-X-+-X-,-.-X-.-,-,-X-X-.-.-.-.-.-.-.-<-.-.-.-.-.-.-.-.-,-X-.-.-.-.-X-,-X-.-.-,-.-.-,-,-,-,-,-,-.-,-,-,-,-,-X-----------
----------,-X-,-.-,-.-X-----------------,-X-.-X-,-X-.-E-.-.-.-.-.-.-.-X-+-X-X-X-.-A-.-X-X-.-.-.-.-.-,-,-,-,-,-,-,-.-.-.-.-.-.-X-X-.-A-.-X-X-X-.-.-,-.-.-,-,-.-.-,-,-.-,-,-,-,-,-X-----------
----------,-X-,-.-,-.-X-,-,-,-,-,-,-,-,-,-X-,-X-,-X-.-.-.-.-.-.-.-.-.-.-.-X-X-.-.-.-.-X-X-.-.-.-.-,-,-.-.-.-.-.-,-,-.-.-.-.-.-X-X-.-.-.-.-X-X-.-.-,-,-.-,-,-.-A-,-,-.-,-,-E-,-,-X-----------
----------,-X-,-.-,-,-.-X-X-X-X-X-X-X-X-X-X-,-X-,-X-.-.-E-.-.-.-.-.-.-.-.-X-X-.-.-.-.-X-X-,-.-.-.-,-.-.-.-.-.-.-.-,-.-.-.-.-,-X-X-.-.-.-.-X-X-.-.-,-,-.-,-,-.-.-,-,-.-,-,-,-,-,-X-----------
----------,-X-,-.-.-,-,-,-,-,-,-,-,-,-,-,-,-,-,-X-X-,-,-,-,-,-.-.-.-.-.-.-X-X-.-.-.-.-X-X-,-.-.-.-,-.-.-.-.-.-.-.-,-.-.-.-.-,-X-X-.-.-.-.-X-X-.-.-,-.-.-,-,-.-W-,-,-.-,-,-,-,-,-X-----------
----------,-X-,-.-.-.-.-.-.-.-.-.-.-.-.-.-.-.-.-.-.-.-.-.-.-,-.-.-.-,/,/,-X-X-.-A-.-.-,-L-,-.-.-.-,-.-.-.-.-.-.-.-,-.-.-.-.-,-L-L-.-.-A-.-.-+-.-.-,-.-.-,-,-.-.-,-,-.-,-.-.-.-.-X-----------
----------,-X-,-.-.-,-,-,-,-,-,-,-,-,-,-,-,-,-,-,-.-.-.-.-.-,-.-.-H-,/,/,/,/+-.-.-.-E-,-L-,-.-.-.-,-.-.-.-.-K-.-.-,-.-.-.-.-,-L-L-E-.-.-.-.-+-.-.-,-.-.-,-,-.-A-,-,-.-,-.-.-.-.-X-----------
----------,-X-,-.-.-,-.-.-.-.-.-.-.-.-.-.-.-.-,-X-X-,-,-.-.-,-.-.-.-././.-X-X-.-.-E-.-,-L-,-.-.-.-,-.-.-.-.-.-.-.-,-.-.-.-.-,-L-L-.-E-.-.-.-+-.-.-,-,-.-,-,-,-,-,-,-.-,-.-.-.-.-X-----------
----------,-X-,-.-,-,-,-X-X-X-X-X-X-X-X-X-X-X-X-,-X-.-,-.-.-,-.-.-.-.-.-.-X-X-.-.-.-.-X-X-,-.-.-.-,-.-.-.-.-.-.-,-,-.-.-.-.-,-X-X-.-.-.-E-X-X-.-.-.-,-.-.-.-.-.-.-.-.-,-.-.-.-.-X-----------
----------,-X-,-.-,-.-X-------------------------,-X-B-B-.-.-,-.-.-.-.-.-.-X-X-E-.-.-.-X-X-.-.-.-.-,-,-.-.-.-.-.-,-.-.-.-.-.-.-X-X-.-.-.-B-X-X-.-.-.-,-,-,-,-,-,-,-,-,-,-.-.-.-.-X-----------
----------,-X-,-.-,-.-X---------------,-,-,-,-,-,-X-A-W-.-.-,-.-.-.-.-.-B-X-X-.-.-.-.-X-X-.-.-.-.-.-,-,-,-,-,-,-,-.-.-.-.-.-.-X-X-X-L-L-L-X-X-.-.-.-.-.-.-.-.-.-.-.-.-.-.-.-.-.-X-----------
----------,-X-,-.-,-.-X-,-,-,-,-,-,-,-,-X-X-X-X-,-X-,-,-.-.-,-.-.-.-,-X-X-X-,-X-X.X.X.X-,-X-.-.-.-.-t6.-.-.-.-.-.-.-.-.-.-,-X-,-X-X-L-L-L-X-X-.-.-.-.-.-.-.-.-.-.-.-.-.-.-.-.-.-X-----------
----------,-X-,-.-,-,-X-,-X-X-X-X-X-,-X-.-.-.-X-,-,-X-B-.-.-,-.-.-,-X-------------------,-X-.-.-.-.-.-.-.-E-E-E-.-.-.-.-,-,-X-X-.-.-.-.-.-.-X-.-.-.-.-.-.-.-.-.-.-.-:-.-.-.-.-H-X-----------
----------,-X-,-.-,-,-X-X-X-,-,-,-X-X-X-.-.-.-.-X-X-,-X-X-.-,-X-X-X-----------------------,-X-.-.-.-.-.-.-.-.-.-.-.-.-.-,-,-X-.-.-.-.-A-.-.-X-X-X-.-.-.-.-:-.-.-.-.-.-.-.-.-.-.-X-----------
----------,-X-,-.-,-,-X-E-.-E-.-.-.-,-,-,-.-.-,-X-X-X-,-X-.-.-X-,-------------------------,-X-.-.-.-.-.-.-.-.-t6.-.-.-.-,-X-.-.-E-.-.-.-.-.-X---,-X-X-XP+P+P+P+P+P+P+P+PXPX-X-X-X-----------
----------,-X-,-.-,-,-X-.-.-.-.-.-.-,-,-,-.-,-X-X-X-,-X-,-.-.-,-X---------------------------,-X-.-.-.-.-.-.-.-.-.-.-.-.-X-X-.-.-.-.-E-.-E-.-X-------,-XP+P+P+P+P+P+P+P+PXP------------------
----------,-X-,-.-,-,-.-E-.-E-.-A-.-H-.-.-,-X---X---,-X-,-.-.-,-X-----------------------------,-X-X-X-X-X-.-.-.-X-X-X-X-X-X-.-.-.-.-,-,-.-.-X-------,-X-.-.-.-H-.-.-.-.-X-------------------
----------,-X-,-.-,-,-.-.-.-.-.-.-E-.-.-.-,-X-X-----,-X-,-.-.-,-X-----------------------------------,-X-X-.-.-.-X-X-----,-X-H-.-.-,-X-X-X-,-X-------,-X-E-.-,-E-,-.-E-.-X-------------------
----------,-X-,-.-,-,-.-E-.-E-.-.-A-.-.-.-.-X-------,-X-,-.-.-,-X-----------------------------------,-X-.-.-.-.-.-X-----,-X-X-X-X-X-X-,-X-X-X-------,-X-X-X-X-X-X-X-X-X-X-------------------
----------,-X-,-.-,-,-X-.-.-.-.-A-.-A-.-.-.-X-------,-X-,-.-.-,-X-----------------------------------,-X-.-.-.-.-.-X---------------------,-X-X---------------,-X-X---------------------------
----------,-X-,-.-,-,-X-.-.-.-.-.-E-.-E-.-E-X-------,-X-,-.-.-,-X-----------------------------------,-X-,-,-,-,-,-X---------------------,-X-X-----------------------------------------------
----------,-X-,-.-,-,-X-.-E-.-.-.-.-.-.-.-.-X-------,-X-,-.-.-,-X-----------------------------------,-X-.-.-.-.-.-X---------------------,-X-X-----------------------------------------------
----------,-X-,-.-,-,-X-W-.-.-.-.-E-.-E-.-.-X-------,-X-,-.-.-,-X-----------------------------------,-X-.-.-.-.-.-X---------------------,-X-X-----------------------------------------------
,-,-,-,-,-,-X-,-.-,-,-X-X-X-X-X-X-,-,-,-X-X-X-,-,-,-,-X-,-.-.-,-X-,-,-,-,-,-,-,-,-------------------,-X-.-,-,-.-.-X---------------------,-X-X-----------------------------------------------
,-X-X-X-X-X-,-.-.-.-,-.-X-X-X-X-XP+P+P+PXPX-X-X-X-X-X-,-,-.-.-.-,-X-X-X-X-X-X-X-X-,-,-,-,-,---------,-X-,-,-A-,-.-X---------------------,-X-X-----------------------------------------------
X-E-,-,-,-,-.-.-.-.-,-,-,-,-,-,-,-,-,-,-,-,-,-,-,-,-,-,-.-.-.-.-.-.-.-.-.-.-E-.-.-X-X-X-X-X---------,-X-,-.-.-,-.-X---------------------,-X-X-----------------------------------------------
X-.-.-E-.-.-.-.-.-.-.-.-.-.-.-.-.-.-.-.-.-.-.-.-.-.-.-.-.-.-.-.-.-.-.-.-E-.-.-.-.-.-.-.-.-X---------,-X-,-.-.-,-.-X---------------------,-X-X-----------------------------------------------
X-E-,-,-,-,-,-,-,-,-,-,-,-,-,-,-,-.-.-.-.-.-.-.-.-.-.-.-.-.-.-.-.-.-.-.-.-E-.-.-.-.-.-.-.-X---------,-X-,-.-.-,-.-X---------------------,-X-X-----------------------------------------------
X-.-.-.-.-.-.-.-.-.-.-.-.-.-.-.-,-,-,-.-.-,-,-,-,-,-,-,-,-,-,-,-,-,-,-,-,-,-,-,-,-X-X-X-X-X---------,-X-,-.-.-,-.-X---------------------,-X-X-----------------------------------------------
,-X-X-X-X-X-X-X-X-X-X-X-X-X-X-X-X-.-,-.-.-,-,-X-X-X-X-X-X-X-X-X-X-X-X-X-X-X-X-X-X-------------------,-X-,-.-.-,-.-X---------------------,-X-X-----------------------------------------------
--------------------------------,-X-,-.-.-,-X-------------------------------------------------------,-X-,-.-.-,-.-X---------------------,-X-X-----------------------------------------------
--------------------------------,-X-,-.-.-,-X---------------------------------------------,-,-,-,---,-X-,-.-.-,-.-X---------------------,-X-X-----------------------------------------------
--------------------------------,-X-,-.-.-,-X---------,-,-,-,-,-,-----------------------,-,-X3X3X3,-,-X-,-.-.-,-.-X---------------------,-X-X-----------------------------------------------
--------------------------------,-X-,-.-.-,-X-------,-,-X-X2X2X2X-,---------------------,-X3X3.3X3X3,-X-,-E-.-,-.-X---------------------,-X-X-----------------------------------------------
--------------------------------,-X-,-.-.-,-X-,-,-,-,-.-X-.-.-.-.-X-,-------------------,-X3E3.3.3X3X-X-,-.-.-,-.-X---------------------,-X-X-----------------------------------------------
--------------------------------,-X-,-.-.-,-X-X-X-X-X-X-.-.-.-.-.-.-X-------------------,-X3.3H3.3.3.-.-,-.-.-,-.-X---------------------,-X-X-----------------------------------------------
--------------------------------,-X-,-.-.-,-.-.-.-.-X-X-.-.-.-E-.-.-X---------------,-,-,-X3E3.3.3X3X-X-,-.-.-,-.-X---------------------,-X-X-----------------------------------------------
--------------------------------,-X-,-.-.-,-.-.-.-.-.-L-.-.-.-.-.-.-X---------------,-X-X-X3X3,3X3X3X-X-,-.-.-,-.-X-,-,-,-,-,-,-,-------,-X-X-----------------------------------------------
--------------------------------,-X-,-E-.-,-.-.-.-<-.-L-.-.-.-.-.-.-X-,-,-,-,-,-,-,-,-X-,-,-,-,-,-,-,-,-.-.-.-,-.-X-X-X-X-X-X-X-X-------,-X-X-----------------------------------------------
--------------------------------,-X-,-.-.-,-.-.-.-.-.-L-.-A-.-A-.-.-X-X-X-X-X-X-X-X-X-X-.-.-.-.-.-.-.-.-.-.-.-,-.-.-E-X-,-.-,-,-X-------,-X-X-----------------------------------------------
--------------------------------,-X-E-.-E-,-.-B-.-.-X-X-.-.-.-.-.-.-X-.-B-.-B-.-.-,-X-X-E-.-.-.-.-.-.-.-.-.-.-,-.-.-E-X-.-.-.-,-X-------,-X-X-----------------------------------------------
--------------------------------,-X-,-.-.-,-X-X-X-X-X-X-.-A-.-A-.-.-X-.-.-.-.-.-.-A-X-X-.-.-.-.-.-.-.-.-.-E-.-,-.-.-.-L-.-.-.-,-X-------,-X-X-----------------------------------------------
--------------------------------,-X-,-.-.-,-X-------,-X-.-.-.-.-.-E-+-.-.-E-B-.-.-A-.-,-E-.-.-.-.-.-.-.-.-.-.-,-.-.-E-L-.-.-.-,-X-------,-X-X-----------------------------------------------
--------------------------------,-X-,-.-.-,-X-------,-X-.-.-.-.-.-.-+-.-.-.-.-.-.-,-.-,-.-.-.-.-.-.-.-.-.-.-.-,-.-.-.-L-.-.-.-,-X-------,-X-X-----------------------------------------------
--------------------------------,-X-,-.-.-,-X-------,-X-.-A-.-A-.-.-+-.-.-B-.-.-.-A-X-X-E-.-.-.-,-,-,-,-,-,-,-,-.-.-E-X-.-.-.-,-X-------,-X-X-----------------------------------------------
--------------------------------,-X-,-.-.-,-X-------,-X-.-.-.-.-.-.-X-.-.-.-.-.-.-B-X-X-.-.-.-.-,-.-.-.-.-.-.-.-.-.-H-X-.-.-.-,-X-------,-X-X-----------------------------------------------
--------------------------------,-X-,-.-.-,-X-------,-X-.-.-E-.-.-.-X-X-X-X-X-X-X-X-X-X-XR+R+R+RX-X-X-X-+-X-X-X-X-X-X-X-.-.-.-,-X-------,-X-X-----------------------------------------------
----------------------------------,-X-.-.-X---------,-X-.-.-.-.-.-.-X-----------------,-X-.-.-.-X-X-X-.-.-,-X-X-X---,-X-.-.-.-,-X-------,-X-X-----------------------------------------------
----------------------------------,-X-.-.-X---------,-X-X-X-+-X-X-X-X-----------------,-X-.-.-.-X-X-A-.-<-A-+-.-X---,-X-.-.-.-,-X-------,-X-X-----------------------------------------------
----------------------------------,-X-.-.-X-------------,-X-H-X-----------------------,-X-.-.-.-X-X-X-,-,-.-X-X-X---,-X-.-E-.-E-X-------,-X-X-----------------------------------------------
----------------------------------,-X-.-.-X-------------,-X-.-X---------------,-,-,-,-,-X-.-.-.-X-,-X-X-A-X-X-------,-X-.-.-.-,-X-------,-X-X-----------------------------------------------
----------------------------------,-X-.-.-X-------------,-X-.-X-------------,-,-X-X-X-X-X-.-.-.-X-X-X-X-.-X-X-------,-X-.-.-.-,-X-------,-X-X-----------------------------------------------
----------------------------------,-X-.-.-X-------------,-X-X-X---------,-,-,-X-X-,-,-.-.-.-.-.-,-,-E-.-.-.-X-------,-X-.-.-.-,-X-------,-X-X-----------------------------------------------
----------------------------------,-X-.-.-X-----------------------------,-X-X-.-,-,-,-.-.-.-.-.-,-,-,-.-.-.-X-------,-X-,-,-,-,-X-------,-X-X-----------------------------------------------
----------------------------------,-X-.-.-X-----------------------------,-X-.-.-.-,-,-.-.-.-.-.-,-E-,-.-.-E-X-------,-X-X->->->-X-------,-X-X-----------------------------------------------
----------------------------------,-X-.-.-X-----------------------------,-X-.-.-,-,-,-.-.-.-.-.-,-,-,-.-.-B-X---------------------------,-X-X-----------------------------------------------
----------------------------------,-X-.-.-X-----------------------------,-X-.-,-,-.-,-.-.-.-.-.-,-,-E-E-.-.-X---------------------------,-X-X-----------------------------------------------
----------------------------------,-X-.-.-X-------------------------------,-X-X-X-,-,-.-.-.-.-.-,-,-,-.-.-B-X---------------------------,-X-X-----------------------------------------------
----------------------------------,-X-.-.-X-----------------------------------,-X-,-.-.-.-.-.-.-,-E-,-,-,-.-X---------------------------,-X-X-----------------------------------------------
----------------------------------,-X-.-.-X-----------------------------------,-X-X-X-X-X-.-.-.-X-X-X-X-X-X-X---------------------------,-X-X-----------------------------------------------
----------------------------------,-X-.-.-X-------------------------------------------,-X-.-.-.-X---,-X-X-------------------------------,-X-X-----------------------------------------------
----------------------------------,-X-.-.-X-------------------------------------------,-X-.-.-.-X---------------------------------------,-X-X-----------------------------------------------
----------------------------------,-X-.-.-X-------------------------------------------,-X-.-.-.-X---------------------------------------,-X-X-----------------------------------------------
----------------------------------,-X-X-X-X-------------------------------------------,-X-.-.-.-X---------------------------------------,-X-X-----------------------------------------------
--------------------------------------------------------------------------------------,-X-.-.-.-X---------------------------------------,-X-X-----------------------------------------------
--------------------------------------------------------------------------------------,-X-.-.-.-X---------------------------------------,-X-X-----------------------------------------------
--------------------------------------------------------------------------------------,-X-.-.-.-X---------------------------------------,-X-X-----------------------------------------------
--------------------------------------------------------------------------------------,-X-.-.-.-X---------------------------------------,-X-X-----------------------------------------------
--------------------------------------------------------------------------------------,-X-.-.-.-X---------------------------------------,-X-X-----------------------------------------------
--------------------------------------------------------------------------------------,-X-.-.-.-X---------------------------------------,-X-X-----------------------------------------------
--------------------------------------------------------------------------------------,-X-.-.-.-X---------------------------------------,-X-X-----------------------------------------------
--------------------------------------------------------------------------------------,-X-.-.-.-X---------------------------------------,-X-X-----------------------------------------------
--------------------------------------------------------------------------------------,-X-.-.-.-X---------------------------------------,-X-X-----------------------------------------------
--------------------------------------------------------------------------------------,-X-.-.-.-X---------------------------------------,-X-X-----------------------------------------------
--------------------------------------------------------------------------------------,-X-.-.-.-X---------------------------------------,-X-X-----------------------------------------------
--------------------------------------------------------------------------------------,-X-X-X-X-X---------------------------------------,-X-X-----------------------------------------------
--------------------------------------------------------------------------------------,-,-,-,-,-,-,-,-,-,-,-----------------------------,-X-X-----------------------------------------------
--------------------------------------------------------------------------------------,-X-X-X-X-X-X-X-X-X-X-----------------------------,-X-X-----------------------------------------------
--------------------------------------------------------------------------------------,-X-.-.-.-.-.-.-.-.-X-----------------------------,-X-X-----------------------------------------------
--------------------------------------------------------------------------------------,-X-.-.-.-.-.-.-.-.-X-----------------------------,-X-X-----------------------------------------------
--------------------------------------------------------------------------------------,-X-,-,-,-.-.-.-.-.-X-----------------------------,-X-X-----------------------------------------------
--------------------------------------------------------------------------------------,-X-.-.-,-.-.-.-.-,-X-,-,-,-,-,-,-,-,-,-,-,-,-,-,-,-X-X-----------------------------------------------
--------------------------------------------------------------------------------------,-X7t7t7t7t6t6t6t6t6X6X-X-X-X-X-X-X-X-X-X-X-X-X-X-X-X-X-----------------------------------------------
--------------------------------------------------------------------------------------,-X-.-.-.-.-.-.-.-,-X-X-X-X-X-X-X-X-X-X-X-X-X-X-X-X-X-X-----------------------------------------------
--------------------------------------------------------------------------------------,-X-.-E-.-.-.-E-.-.-X---------------------------------------------------------------------------------
--------------------------------------------------------------------------------------,-X-.-.-.-.-.-.-.-.-X---------------------------------------------------------------------------------
--------------------------------------------------------------------------------------,-X-.-.-.-.-.-.-.-.-X---------------------------------------------------------------------------------
--------------------------------------------------------------------------------------,-X-.-.-.-.-.-.-.-.-X---------------------------------------------------------------------------------
--------------------------------------------------------------------------------------,-X-.-.-.-.-.-.-.-.-X---------------------------------------------------------------------------------
--------------------------------------------------------------------------------------,-X-.-E-.-.-.-E-.-.-X---------------------------------------------------------------------------------
--------------------------------------------------------------------------------------,-X-.-.-.-.-.-.-.-.-X---------------------------------------------------------------------------------
--------------------------------------------------------------------------------------,-X-.-.-.-.-.-.-.-.-X---------------------------------------------------------------------------------
--------------------------------------------------------------------------------------,-X-X-X-X-X-X-X-X-X-X---------------------------------------------------------------------------------
