------------------------------------------------------------,-,-X-X-X-X-X-X-X-X-X-X-X-X-X-X-,-,-------------------------------------------------------------------------------------------------
--------------,-,-,-,-,-,-,-------------------------------,-,-X-,-.-.-,-,-.-.-A-.-,-,-,-,-,-X-X-,-----------------------------------------------------------------------------------------------
--------------,-X-X-X-X-X-X-------------------------------,-.-X-,-,-.-,-,-.-.-<-.-,-,-,-,-,-.-.-X-----------------------------------------------------------------------------------------------
--------------,-X-.-.-.-.-X-----------------------------,-,-X-.-,-,-X-X-X-X-X-,-X-X-X-X-X-,-,-,-X-,---------------------------------------------------------------------------------------------
--------------,-X-.-.-.-.-X-----------------------------,-.-X-,-X-X-,-,-,-,-X-.-X-,-,-,-,-X-,-.-.-X---------------------------------------------------------------------------------------------
--------------,-X-.-.-.-.-X-----------------------------,-X-,-,-X---,-X-X-X-X3.3X3X-X-X---,-X-,-,-X---------------------------------------------------------------------------------------------
--------------,-X-.-.-.-.-X-----------------------------,-X-.-.-X-,-,-X-.-.-.-.-.-.-.-X-,-,-X-.-.-X---------------------------------------------------------------------------------------------
--------------,-X-.-.-.-.-X-----------------------------,-X-E-.-X-X-X-X-.-.-.-.-.-.-.-X-X-.-X-E-.-X---------------------------------------------------------------------------------------------
--------------,-X-.-.-.-.-X-,-,-,-,-,-,-,-,-,-,---------,-X-.-.-X-.-,-X-.-E-.-K-.-E-.-X-.-X-X-.-.-X---------------------------------------------------------------------------------------------
--------------,-X-.-.-.-.-.-X-X-X-X-X-X-X-X-X-X-,-,-----,-X-.-.-.-.-,-X-.-.-.-.-.-.-,-X-.-.-.-.-.-X---------------------------------------------------------------------------------------------
--------------,-X-.-.-.-.-.-.-.-.-.-.-.-.-.-.-.-X-X-----,-X-.-.-.-.-.-,-,-.-.-.-.-,-,-.-.-.-.-.-.-X---------------------------------------------------------------------------------------------
--------------,-X-.-.-.-.-.-.-.-.-.-.-.-.-.-.-.-.-X---,-,-X-.-.-.-.-.-.-,-X-X-X-X-X-.-.-.-.-.-.-.-X-,-------------------------------------------------------------------------------------------
--------------,-X-X-.-.-.-.-.-.-.-.-E-E-.-.-.-.-.-X---,-X-.-.-.-.-.-.-.-.-.-.-.-.-.-.-.-.-.-.-.-.-.-X-------------------------------------------------------------------------------------------
------------------,-X-X-.-.-.-,-,-,-,-.-.-.-.-.-.-X-,-,-X-.-.-.-.-.-.-.-.-.-.-.-.-.-.-.-.-.-.-.-.-.-X-,-----------------------------------------------------------------------------------------
----------------------,-X-X-X-X-X/t/X/X-X-.-.-.-.-X-,-X-.-.-.-.-.-.-.-.-.-.-.-.-.-.-.-.-.-.-.-.-.-.-.-X-----------------------------------------------------------------------------------------
------------------------------,-X-,-X-,-X-.-.-.-.-X-,-X-.-.-.-.-.-.-.-.-.-.-.-.-.-.-.-.-.-.-.-.-.-.-.-X-----------------------------------------------------------------------------------------
------,-,-,-,-,-,-,-,-,-,-,-,-,-X-X-X-X-X-.-.-.-.-X-,-X-.-.-.-.-.-.-.-.-.-.-.-.-.-.-.-.-.-.-.-.-.-.-.-X-----------------------------------------------------------------------------------------
------,-X-X-X-X-X-X-X-X-X-X-X-X-X-X-X-E-X-.-.-.-.-X-,-X-.-.-.-.-.-.-.-.-.-.-.-.-.-.-.-.-.-.-.-.-.-.-.-X-----------------------------------------------------------------------------------------
------,-X-E-,-,-,-,-,-,-,-,-,-,-,-.-,-.-L-.-.-.-.-X-,-X-.-.-.-.-.-.-.-.-.-XS.-.-.-XS.-.-.-.-,-,-,-,-,-X-----------------------------------------------------------------------------------------
------,-X-.-X-X-X-X-X-X-X-X-X-X-X-X-X-.-X-.-.-.-.-X-,-X-.-.-.-.-.-.-.-,-X-X-E-E-E-X-X-.-.-.-,-.-.-.-.-X-----------------------------------------------------------------------------------------
------,-X-.-X-,-,-,-,-,-,---------,-X-E-X-.-.-.-.-X-,-X-.-.-.-.-.-.-.-X-,-X-E-E-E-X-,-X-.-.-,-,-,-,-,-X-----------------------------------------------------------------------------------------
--,-,-,-X-+-X-X-X-X-X-X-X-,-,-,-,-,-X-X-X-.-.-.-.-X-,-X-.-.-.-.-.-.-E-X-,-X-E-A-E-X-,-X-E-.-,-,-,-,-,-X---------------------------,-,-,-,-------------------------------------------------------
--,-X-X-.-.-.-.-.-.-.-.-.-X-X-X-X-X-X-X-X-.-.-.-.-X-,-X-+-+-+-X-X-X-X-X-,-X-X-+-X-X-,-X-X-X-X-X-L-L-L-X-,-,-,-,-,-,-,-,-,-,-,-,-,-,-X-X-X-,-,-,-,-,---------------------------------------------
--,-X-.-.-.-.-.-.-.-.-.-.-E-X-A-.-.-.-,-X-.-.-.-.-X-X-X-.-.-,-X-X-X-X-X-,-,-X-,-X-X-X-X-X-X-X-X-.-.-.-X-X-X-X-X-X-X-X-X-X-X-X-X-X-X-X-X-X-X-X-X-X-X---------------------------------------------
,-,-X-.-.-.-.-.-.-.-.-.-,-E-,-.-.-.-.-,-.-.-.-.-.-,-,-.-.-.-,-.-.-.-.-X-X-X1X1,-X-.-E-.-.-.-.-.-.-.-.-.-.-.-.-.-.-.-.-.-.-.-.-.-.-E-+U+U.-.-.-.-H-X---------------------------------------------
X-X-XP.-.-.-.-,-,-,-.-,-,-,-,-.-.-.-.-,-.-.-.-.-.-,-,-.-.-.-,-.-.-E-.-+-+-.1,1,-X-.-.-.-.-.-.-.-.-.-.-.-.-.-.-.-.-.-.-.-.-.-.-.-.-.-+U+UE-.-.-.-.-X---------------------------------------------
X-.-.-+P.-.-.-,-.-X0X-X-X-X-.-.-.-.-.-,-.-.-.-.-.-,-,-.-.-.-,-,-.-.-.-+-+-.1,1,-X-E-.-.-.-.-.-.-.-.-.-.-.-.-.-.-.-.-.-.-.-.-.-.-.-E-+U+U.-.-.-.-A-X---------------------------------------------
X-E-.-.-.-.-.-,-.-X0X-.-+-.-.-.-.-.-.-,-.-.-.-.-.-,-,-.-.-.-.-,-,-.-.-X-X-X1X1,-X-.-.-.-.-.-.-.-.-.-.-.-.-.-.-.-.-.-.-.-.-.-.-.-.-.-XUXUX-X-X-X-X-X---------------------------------------------
X-.-H-.-.-.-.-,-H-X0X-.-+-.-.-.-.-.-.-,-.-.-.-.-.-,-,-.-.-.-.-.-,-X4X4X4--,-X-X-X-E-.-.-.-X-X-X-X-X-X-X-,-,-,-X-X-X-X-X-X-X-.-.-.-.-X-X-X-X-X-,-,-----------------,-,-,-,-,-,-------------------
X-.-.-.-.-.-.-,-.-X0X-.-+-.-.-.-.-.-.-,-.-.-.-.-.-,-,-.-.-.-.-.-.-X-----------,-X-.-.-.-.-X-X-X-X-X-X-X-,-,-,-X-X-X-X-X-X-X-.-.-.-.-.-.-.-.-.-X-X-,---------------,->->->->->-------------------
X-E-.-+P.-.-.-,-.-X0X-X-X-,-.-.-.-.-.-,-.-.-.-.-.-,-,-.-.-,-,-,-,-X-,-,-,-,-,-,-X-.-.-.-.-X-X-.-.-.-,-.-.-.-.-,-.-.-.-.-X-X-.-.-.-.-.-.-.-.-.-.-.-X---------------,-X-.-<-.-X-------------------
X-X-XP.-.-.-.-,-,-X-X-X-X-X-,-.-.-.-.-,-.-.-.-.-.-,-,-.-.-,-,-,-,-X-X2X-X-X-X-X-X-.-.-.-.-X-X-.-.-.-,-,-,-,-,-,-.-.-.-.-X-X-.-.-.-.-.-.-.-.-.-.-.-,-X-,-,---------,-X-.-.-.-X-------------------
--,-X-.-.-.-.-.-.-.-.-.-.-E-,-.-.-.-.-,-.-.-.-.-.-,-,-.-.-,-,-,-,-.-.2.-.-.-.-.-.-.-.-.-.-X-X-.-.-.-.-.-.-.-.-.-.-.-.-.-X-X-.-.-.-.-.-.-.-,-,-,-,-,-X-X-X-----,-,-,-X-.-.-.-X-,-,---------------
--,-X-.-.-.-.-.-.-.-.-.-.-E-,-.-.-.-.-,-.-.-.-.-.-,-,-.-.-,-,-,-,-.-.2.-.-.-.-.-.-.-.-.-.-X-X-,-,-.-.-.-.-.-.-.-.-,-,-,-X-X-.-.-.-.-.-,-,-,-.-,-,-.-.-.-X-----,-X-X-X-.-.-.-X-X-X---------------
--,-X-.-.-.-.-.-.-.-.-.-,-E-,-.-.-.-.-,-.-.-.-.-.-,-,-.-.-,-,-,-,-.-.2.-.-.-.-.-.-.-.-.-.-X-X-.-,-.-.-.-.-.-.-.-.-,-.-,-X-X-.-.-.-.-.-,-,-,-.-,-.-.-E-.-X-,-,-,-X-.-.-.-.-.-.-.-X-,-,-,-,-,-,-,-
----,-X-X-X-X-X-X-X-X-X-X-X-.-.-.-.-.-,-..........,.,-.-.-,-,-,-,-.-.2.-.-.-.-.-.-.-.-.-.-,-,-.-,-.-.-,-,-,-,-.-.-,-.-,-,-.-.-.-.-E-.-,-,-,-.-,-.-.-.-.-X-X-X-X-X-.-.-.-.-.-.-.-X-X-X-X-XVXVX-X-
--------,-X-X-X-X-X-X-X-X-X-.-.-.-.-.-,-..........,.,-.-.-,-,-,-,-X-X-X-.-.-.-.-.-.-.-.-.-,-,-.-,-.-.-,-.5.5,5.-.-,-.-,-,-.-.-.-.-.-.-,-,-,-.-,-.-.-.-.-+-.-.-.-.-.-.-.-.-.-.-.-.-.-.-.-+V+V.-X-
------,-,-X-<-<-t/<-<-,-+-,-.-.-.-.-.-,-..........,.,-.-W-,-,-,-,-X-,-X-<-.-.-.-.-.-.-.-.-,-,-.-,-.-.-,-.5W-,5.-.-,-.-,-,-.-.-.-.-.-.-,-,-,-.-,-.-.-E-.-+-.-.-.-.-.-.-.-E-.-.-.-.-.-.-.-+V+V.-X-
--,-,-,-X-X-X-X-X-X-X-X-X-X-.-.-.-.-.-,-..........,.,-.-.-,-,-,-,-X-X2X-.-.-.-.-.-.-.-.-.-,-,-.-,-.-.-,-,5,5,5.-.-,-.-,-,-.-.-.-.-.-.-,-,-,-.-,-.-.-.-.-+-.-.-.-.-.-.-.-.-.-.-.-.-.-.-.-+V+V.-X-
--,-X-X-.-.-.-.-.-.-.-.-,-X-,-.-.-.-.-,-,.......,.,.,-.-.-,-,-,-,-.-.2.-.-.-.-.-.-.-.-.-.-,-,-.-,-.-.-.-.-.-.-.-:-,-.-,-,-.-.-.-.-E-.-,-,-,-.-,-.-.-E-.-X-X-X-X-X-.-.-.-.-.-.-.-X-X-X-X-XVXVX-X-
--,-X-.-.-.-.-.-.-.-.-.-.-E-,-.-.-.-.-.-,-.-.-.-,-.-,-.-.-,-,-,-,-.-.2.-.-.-.-.-.-.-.-.-.-X-X-,-,-.-.-.-.-.-.-.-.-,-,-,-X-X-.-.-.-.-.-,-,-,-,-,-,-,-.-.-X-----,-X-.-.-.-.-.-.-.-X---------------
--,-X-.-.-.-.-.-.-.-.-.-,-E-,-.-.-.-.-.-,-.-.-.-,-.-,-.-.-,-,-,-,-.-.2.-.-.-.-.-.-.-.-.-.-X-X-.-.-.-.-.-.-.-.-.-.-.-.-.-X-X-.-.-.-.-.-.-.-.-,-,-.-,-X-X-X-----,-X-X-X-.-.-.-X-X-X---------------
--,-X-.-.-.-.-,-,-,-.-,-,-,-,-.-.-.-.-.-,-.-.-.-,-.-,-.-.-,-,-,-,-.-.2.-.-.-.-.-.-.-.-.-.-X-X-.-.-.-,-,-,-,-,-,-.-.-.-.-X-X-.-.-.-.-.-.-.-.-.-.-.-X-,-------------,-X-.-.-.-X-------------------
----,-X-.-.-.-,-.-X-X-X-X-X-.-.-.-.-.-.-,-.-.-.-,-.-,-.-.-,-,-,-,-X-X2X-X-X-X-X-X-.-.-.-.-X-X-.-.-.-,-.-.-.-.-,-.-.-.-.-X-X-.-.-.-.-.-.-.-.-.-.-.-X---------------,-X-.-.-.-X-------------------
----,-X-.-.-.-,-.-X---,-X-.-.-.-.-.-.-.-,-.-.-.-,-.-,-.-.-.-.-.-.-X-----------,-X-.-.-.-.-X-X-H-.-.-,-,-,-,-,-,-.-.-.-.-X-X-.-.-.-.-.-.-.-.-.-.-X-,---------------,-X-.-.-.-X-------------------
----,-X-.-<-.-,-H-X---,-X-.-.-.-.-.-.-.-,-.-.-.-,-.-,-.-.-.-.-.-,-X-,-,-------,-X-.-.-.-.-X-X-X-X-X-X-X-,-,-,-X-X-X-X-X-X-X-.-.-.-.-.-.-.-.-,-,-X-----------------,-XW.7.7.7XW------------------
----,-X-.-.-.-,-.-X---,-X-.-.-.-.-.-.-.-,-.-.-.-,-.-,-.-.-.-.-,-,-X-X-X-------,-X-E-.-.-.-X-X-X-X-X-X-X-.-.-.-X-X-X-X-X-X-X-.-.-.-.-X-X-X-X-X-X-,-,---------------,-X-.-.-E-X-------------------
--,-,-X-.-.-.-,-.-X-,-,-X-,-.-.-.-.-.-.-,-.-.-.-,-.-,-.-.-.-,-,-.-.-.-X-------,-X-.-.-.-.-.-.-.-.-.-.-.-.-.-.-.-.-.-.-.-.-.-.-.-.-.-XUXUX-X-X-X-X-X---------------,-X-X-X-X-X-------------------
--,-X-.-.-.-.-,-,-X-X-X-X-X-,-.-.-.-.-.-,-.-.-.-,-.-,-.-.-.-,-.-.-.-.-X-------,-X-E-.-.-.-.-.-.-.-.-.-.-.-.-.-.-.-.-.-.-.-.-.-.-.-E-+U+U.-.-.-.-A-X---------------------------------------------
--,-X-.-.-.-.-.-.-.-.-.-.-E-,-.-.-.-.-.-,-.-.-.-,-.-,-.-.-.-,-.-.-E-.-X-------,-X-.-.-.-.-.-.-.-.-.-.-.-.-.-.-.-.-.-.-.-.-.-.-.-.-.-+U+UE-.-.-.-.-X---------------------------------------------
--,-X-.-.-.-.-.-.-.-.-.-.-E-,-A-.-.-.-,-,-.-.-.-,-,-,-.-.-.-,-.-.-.-.-X-------,-X-.-E-.-.-.-.-.-.-.-.-.-.-.-.-.-.-.-.-.-.-.-.-.-.-E-+U+U.-.-.-.-H-X---------------------------------------------
--,-X-.-.-.-.-.-.-.-.-.-.-E-X-X-X-X-X-X-X-.-.-.-.-X-X-X-+-+-+-X-X-X-.-X-------,-X-X-X-X-X-X-X-X-X-X-X-X-X-.-X-X-X-X-X-X-X-X-X-X-X-X-X-X-X-X-X-X-X-X---------------------------------------------
----,-X-.-.-.-.-.-.-.-.-,-X-----------,-X-.-.-.-.-X-,-X-+-+-+-X-,-X-.-X-,-,-,-,-,-,-,-,-,-,-,-,-,-,-,-X-XT+TXTX-------------------,-X-X-X-------------------------------------------------------
------,-X-+-X-X-X-X-X-X-X-----,-,-,-,-,-X-.-.-.-.-X-,-X-.-.-.-X-,-X-,-X-X-X-X-X-X-X-X-X-X-X-X-X-X-X-X-X-.-.-.-X---------------------------------------------------------------------------------
------,-X-E-X-------------,-,-X-X-X-X-X-X-.-.-.-.-X-,-X-.-.-.-X-,-X-,-,-E-,-,-,-,-,-,-,-,-,-,-,-,-,-,-,-.-H-.-X---------------------------------------------------------------------------------
------,-X-,-X---------,-,-X-X-.-.-.-.-.-.-.-.-.-.-X-,-X-.-.-.-X-,-X-X-X-X-X-X-X-X-X-X-X-X-X-X-X-X-X-X-X-X-X-X-X---------------------------------------------------------------------------------
------,-X-,-X---------,-X-.-.-.-.-.-.-.-.-.-.-.-.-X-,-X-.-.-.-X---------------------------------------------------------------------------------------------------------------------------------
------,-X-,-X---------,-X-.-.-.-.-E-.-.-.-.-.-.-,-X-X-.-.-.-.-X---------------------------------------------------------------------------------------------------------------------------------
------,-X-,-X---------,-X-.-.-.-.-.-.-.-.-.-.-,-X-,-X-.-.-.-.-X-,-,-----------------------------------------------------------------------------------------------------------------------------
------,-X-,-X---------,-X-.-.-.-.-X-X-X-X-X-X-X-X-X-.-.-.-.-.-.-X-X-,---------------------------------------------------------------------------------------------------------------------------
------,-X-,-X-,-,-,-,-,-X-.-.-.-,-X-,-,-,-,-,-X-.-.-.-.-.-.-.-.-.-.-X---------------------------------------------------------------------------------------------------------------------------
------,-X-,-X-,-X-X-X-X-X-.-.-.-,-X-X-X-X-X-,-X-.-.-.-.-.-.-.-.-.-.-X---------------------------------------------------------------------------------------------------------------------------
------,-X-,-X-,-X-,-,-,-,-.-.-.-,-,-,-,-.-X-,-X-.-.-.-.-.-E-E-.-.-.-X---------------------------------------------------------------------------------------------------------------------------
------,-X-,-X-,-X-,-,-,-,-.-.-.-,-,-,-,-.-X-,-X-.-.-,-E-,-,-,-,-.-.-X---------------------------------------------------------------------------------------------------------------------------
------,-X-,-X-,-X-E-,-,-,-.-.-.-,-,-,-E-.-X-,-X-.-.-,-.-.-.-.-,-.-.-X---------------------------------------------------------------------------------------------------------------------------
------,-X-,-X-X-X-,-,-,-,-.-.-.-,-,-,-,-.-X-X-X-.-.-,-.-.-.-.-,-.-.-X---------------------------------------------------------------------------------------------------------------------------
------,-X-,-.-+-+-,-,-,-,-.-.-.-,-,-,-,-.-+-.-.-.-.-A-.-.-.-.-A-.-.-X---------------------------------------------------------------------------------------------------------------------------
------,-X-X-X-X-X-E-,-,-,-.-.-.-,-,-,-,-.-X-X-X-.-.-,-.-.-.-.-,-.-.-X---------------------------------------------------------------------------------------------------------------------------
--------------,-X-,-.-.-,-.-.-.-,-.-.-E-.-X-,-X-.-.-,-,-,-,-,-,-.-.-X---------------------------------------------------------------------------------------------------------------------------
--------------,-X-,-,-,-,-.-.-.-,-,-,-,-.-X-,-X-.-.-.-.-.-A-.-.-.-.-X---------------------------------------------------------------------------------------------------------------------------
--------------,-X-H-,-,-,-.-.-.-,-.-,-E-H-X-,-X-.-.-.-.-.-.-.-.-.-.-X---------------------------------------------------------------------------------------------------------------------------
--------------,-X-X-X-X-X-.-.-.-,-X-X-X-X-X-,-X-X-X-X-X-X-X-X-X-X-X-X---------------------------------------------------------------------------------------------------------------------------
----------------------,-X-.-.-.-.-X-,-,-,-,-,-,-,-----------------------------------------------------------------------------------------------------------------------------------------------
----------------------,-X-.-.-.-.-X-X-X-X-X-X-X-X-----------------------------------------------------------------------------------------------------------------------------------------------
----------------------,-X-.-.-.-.-.-.-.-.-.-.-.-X-----------------------------------------------------------------------------------------------------------------------------------------------
----------------------,-X-.-.-.-.-.-.-.-.-.-.-.-X-----------------------------------------------------------------------------------------------------------------------------------------------
----------------------,-X-X-.-.-.-.-.-.-.-.-.-.-X-----------------------------------------------------------------------------------------------------------------------------------------------
------------------------,-,-X-X-.-.-.-.-.-.-.-.-X-----------------------------------------------------------------------------------------------------------------------------------------------
----------------------------,-.-X-X-X-X-X-X-X-X-X-----------------------------------------------------------------------------------------------------------------------------------------------
