----------------------------------------------------------------------------------------------------------------------------,-X-X-X-----------------------------------------------
--------------------------------------------------------------------------------------------------------------------,-,-,-,-,-X-H-X-,-,-,-----------------------------------------
------------------------------------------------------------------------------------------------------------------,-,-X-X-X-X-X-.-X-X-X-X-,-,-------------------------------------
----------------------------------------------------------------------------------------------------------------,-,-X-.-.-E-.-.-.-.-E-.-.-X-X-,-----------------------------------
----------------------------------------------------------------------------------------------------------------,-X-.-E-.-.-.-.-.-.-.-.-.-E-.-X-----------------------------------
----------------------------------------------------------------------------------------------------------------,-X-.-.-.-.-.-.-.-.-.-.-.-.-.-X-----------------------------------
----------------------------------------------------------------------------------------------------------------,-X-.-.-.-.-.=.=.=.=.=.-.-.-.-X-----------------------------------
----------------------------------------------------------------------------------------------------------------,-X-.-.-.-.-.=.=.=.=.=.-.-.-E-X-----------------------------------
----------------------------------------------------------------------------------------------------------------,-X-.-.-,-,-,=,=W=,=,=,-.-.-.-X-----------------------------------
----------------------------------------------------------------------------------------------------------------,-X-.-.-,>.>.>.>.>.>.>,>.-.-.-X-----------------------------------
----------------------------------------------------------------------------------------------------------------,-X-.-.-,-.-.-.-E-.-.-,-.-.-.-X-----------------------------------
----------------------------------------------------------------------------------------------------------------,-X-.-.-,-.-.-.-.-.-.-,-.-.-.-X-----------------------------------
----------------------------------------------------------------------------------------------------------------,-X-.-.-,-.-.-.-A-.-.-,-.-.-.-X-----------------------------------
----------------------------------------------------------------------------------------------------------------,-X-,-,-,-E-.-.-K-.-E-,-,-,-,-X-----------------------------------
----------------------------------------------------------------------------------------------------------------,-X-.-.-X-X-X-X-X-X-X-X-X-.-.-X-----------------------------------
----------------------------------------------------------------------------------------------------------------,-X-.-.-X-,-,-,-,-,-,-,-X-.-.-X-----------------------------------
--------------------------------------------------------------------------------,-,-----------------------------,-X-,-,-X-X-X-X-X-X-X-X-X-,-,-X-----------------------------------
--------------------------------------------------------------,-,-,-,-,-,-,-,-,-,-X-,---------------------------,-X-E-.-.-.-.-.-.-.-.-.-.-E-.-X-----------------------------------
------------------------------------------------------------,-,-X-X-X0X0X0X-X-,-X-X-X-,-------------------------,-X-.-.-.-.-.-.-.-.-.-.-.-.-.-X-----------------------------------
------------------------------------------------------------,-X-.-.-.-.-.-.-.-X-X-X-.-X-------------------------,-X-X-X-X-X-X-,-,-,-X-X-X-X-X-X-----------------------------------
------------------------------------------------------------,-X-.-.-.-.-.-.-.-X-,-X-.-X-,-,-,-,-,-,-------------------,-,-,-X-.-.-.-X-,-,-----------------------------------------
------------------------------------------------------------,-X-.-.-.-.-.-.-.-X-,-X-.-.-X-,-X-X-X-X-------------------,-X-X-X-,-,-,-X-X-X-----------------------------------------
------------------------------------------------------------,-X-A-.-.-A-.-.-A-X-,-X-H-E-X-,-X-H-E-X-------------------,-X-.-.-.-E-.-.-.-X-----------------------------------------
------------------------------------------------------------,-X-X-.-X-X-.-.-X-X-,-X-A-.-X-,-X-A-.-X-------------------,-X-.-.-.-.-.-.-.-X-----------------------------------------
----------------------------------------------------------,-,-X-X-.-X-X-.-.-X-X-,-X_+_+_X_,-X^+^+^X^,-,-,-,-,-,-,-,-,-,-X-.-.-.-.-.-.-.-X-----------------------------------------
----------------------------------------------------------,-X-X-.-.-.-.-.-.-.-X-X-X_+_+_X_X-X^+^+^X^X-X-X-X-X-X-X-X-X-X-X-.-.-.-.-.-.-.-X-----------------------------------------
--------------------------------------------,-,-,-,-,-,-,-,-X-.-.-.-.-.-.-.-E-.-.-.-E-.-.-.-.-.-.-.-.-.-E-.-,-<-.-.-.-.-.-.-.-.-.-.-.-.-X-----------------------------------------
----------------------------------------,-,-X-X-X-X-X-X-X-X-X-.-.-.-.-.-.-.-.-.-.-.-.-.-.-.-.-.-.-.-.-.-.-.-,-,-,-,-,-,-,-.-.-.-.-.-.-.-X-----------------------------------------
------------------------------------,-,-X-X-,-,-.-,-,-,-.-,-.-.-.-.-.-.-.-.-.-.-.-.-.-.-.-.-.-.-.-.-.-.-.-.-.-,-,-,-,-,-,-.-.-.-.-.-.-.-X-----------------------------------------
----------------------------------,-,-X-.-,-.-,-,-,-,-,-.-,-.-.-.-.-.-.-.-.-.-.-.-.-.-.-.-.-.-.-.-.-.-.-.-.-.-,-,-,-,-,-,-.-.-.-.-.-.-.-X-----------------------------------------
----------------------------------,-.-X-,-,-,-,-,-,-,-,-.-,-.-.-.-.-.-.-.-.-.-.-.-.-.-.-.-.-,-,-,-,-.-.-.-.-.-,-,-,-,-,-,-.-.-.-.-.-.-.-X-----------------------------------------
--------------------------------,-,-X-.-,-,-,-X-X-X-X-X-X-X-X-X-.-.-.-.-.-.-.-,-,-,-,-,-,-,-,-.-.-,-,-,-,-A-X-X-X-X-X-X-X-.-.-.-.-.-.-X-X---,-,-,-,-,-----------------------------
--------------------------------,-X-,-,-,-,-X---------------,-X-.-.-.-.-.-.-.-,-.-.-.-.-.-.-.-.-.-.-.-.-.-.-X.--------,-X-.-.-.-.-.-.-X-,---,-X~X~X~X~----------------------------
--------------------------------,-X-,-,-,-,-X---------------,-X-.-.-.-.-.-.-.-,-.-.-.-.-.-.-.-.-.-.-.-.-.-W-X.--------,-X-.-.-.-.-,-,-X-X---,-X~.~.~X~----------------------------
--------------------------------,-X-,-,-,-X-----------------,-X-.-.-.-H-.-.-.-,-.-,-,-,-.-.-.-.-.-.-.-.-.-A-X.--------,-X-.-.-.-,-,-,-,-X---,-X~.~.~X~----------------------------
--------------------------,-,-,-,-X-.-,-,-X-----------------,-X-X-X-X-.-X-X-X-X-X-X-+-X-X-X-X-,-X-X-X-X-,-X-X-,-,-----,-X-.-.-,-,-.-.-.-X---,-X~.~.~X~----------------------------
------------------------,-,-X-X-X-X-,-,-,-X-----------------------,-X-.-X---,-X-X-X-.-X-X-X-X-,-X-X-X-X-,-X-X-X-X-----,-X-.-,-,-.-.-.-.-X---,-X~.~.~X~----------------------------
------------------------,-X-.-.-.-.-.-.-.-X-----------,-,-,-,-,-,-,-X-.-X-,-,-X-.-.-.-.-.-,-,-,-,-,-,-,-,-.-.-.-X-----,-X-.-,-.-.-.-.-.-X---,-X~.~.~X~----------------------------
------------------------,-X-.-.-.-.-.-A-.-X---------,-,-X-X-X-X-X-X-X-.-X-,-X-X-.-.-.-.-.-,-,-,-,-,-,-,-,-.-.-.-X-----,-X-.-,-,-.-.-.-X-X---,-X~.~.~X~----------------------------
------------------------,-X-.-.-.-.-.-.-.-X---------,-X-X-.-.-A-.-A-.-.-X-,-X-X-<-.-<-.-.-,-,-,-,-,-,-,-,-.-.-<-X-----,-X-.-,-,-.-.-.-X-,---,-X~.~.~X~----------------------------
------------------------,-X-X-.-.-.-.-.-X-X---------,-X-.-.-.-.-.-W-.-.-X---,-X-.-.-.-.-.-,-,-,-,-,-,-,-,-.-.-.-X-----,-X-,-,-.-.-.-.-X-X---,-X~.~.~X~----------------------------
--------,-,-,-,-,-,-,-,-,-,-X-.-.-.-.-.-X-,-,-,-,---,-X-X-.-.-A-.-A-.-.-X---,-X-.-.-.-.-.-,-,-,-,-,-,-<-,-.-.-.-X-----,-X-,-.-.-.-.-.-.-X---,-X~.~.~X~----------------------------
------,-,-X-X-X-X-X-X-X-X-X-X-.-.-.-.-.-X-X^X-X-X-----,-X-X-X-X-X-X-X-X-X-,-,-X-XN+N+N+NXNX-X-X-X-X-X-X-X-X-X-X-X-----,-X-,-.-.-.-.-.-.-X---,-X~.~.~X~----------------------------
------,-X-X-.-.-.-.-.-.-.-.-.-.-.-.-.-.-.-.-.-.-X-------------,-X-X-X-X-X-X-X-X-X-+N+N+NX-X-X-X-X-X-X-X-X-X-X-X-------,-X-,-.-.-A-.-.-.-X---,-X~.~.~X~----------------------------
------,-X-X-.-.-.-.-.-.-.-.-.-.-.-.-.-.-.-.-A-H-X-------------,-X-E-.-.-.-.-E-,-,-.-.-,-,-,-E-.-.-.-.-E-X-.-.-X-------,-X-,-,-,-,-,-,-.-X---,-X~.~.~X~----------------------------
--------,-X-.-.-.-.-.-.-.-.-.-.-.-.-.-.-.-.-E-E-X-,-,-,-,-,---,-X-.-.-.-.-.-.-,-,-.-E-,-.-,-.-.-.-.-.-.-+-.-.-X-------,-X-.-.-.-.-.-,-X-X---,-X~.~.~X~----------------------------
--------,-X-X-X-.-X-X-X-X-X-X-.-.-.-.-.-X-X^X-X-X-X1X3X3X3X1--,-X-.-.-.?.?.-.-,-,-.-.-,-.-,-.-.-.-.-.-.-X-././X/,-,-,-,-X-.-.-.-.-.-.-X-,---,-X~.~.~X~----------------------------
------------,-X-.-X-----,-,-X-.-.-.-.-.-X-,-----,-X-.1.1.1X1,-,-X-.-.-K?.?.-.-,-,-E-.-E-,-,-.-.-H-.-.-.-X/././X/X-X-X-X-X-.-.-.-.-.-.-X-X---,-X~.~.~X~,-,-,-,-,-,-,-,-,-,-,-,-,-,-
------------,-X-A-X-,---,-X-X-.-.-.-.-.-X-X-----,-X-.1A1.1X1X-X-X-.-.-.?.?.-.-,-,-.-.-,-,-,-.-.-.-.-.-,-X/,/,/X/X-A-.-,-.-.-.-.-.-.-.-.-X---,-X~.~.~X~X~X~X~X~X~X~X~X~X~X~X~X~X~X~
--------,-,-X-X<.<X<,-,-,-X-.-.-.-<-.-.-.-X-----,-X-,1,1,1,1.-+-+-.-.-.-.-.-.-,-,-.-.-,-.-,-.-.-.-.-.-,-X-.-.-.-+-.-.-,-.-.-.-.-.-.-.-.-X---,-X~.~.~.~.~.~.~.~.~.~.~.~.~.~.~.~.~X~
--,-,-,-,-X<.<.<.<.<X<X<,-X-A-A-A-,-A-A-A-X-,-,-,-X1.1.1.1X1X-X-X-E-.-.-.-.-A-,-,-.-.-,-.-A-E-,-,-,-,-E-X-.-.-X-X-.-.-,-.-.-.-.-.-.-,-,-X-,-,-X~,~,~,~,~,~.~.~.~.~.~.~.~.~.~.~.~X~
,-,-X-X-X-.<.<.<.<.<.<.<X<X-,-,-,-,-,-,-,-X-X-X-X-X-.-.-.-X-X-X-X-,-,-,-,-,-,-,-,-.-.-,-,-,-,-,-,-,-,-,-X-X-X-X-X-.-.-X-X-.-.-.-.-.-,-.-X-X-X-X~X~X-.~.~X-X~X~X~X~X~X~X~X~X~X~X~X~
,-X-X-H-.-.<.<.<.<.<.<.<.<.-.-.-.-.-.-.-.-.-+-.-.-.-.-.-.-.-.-.-.-.-.-.-.-.-.-.-.-.-.-.-.-.-.-.-.-.-.-.-.-+-.-.-.-.-.-,-.-.-.-.-.-.-,-.-,-.-L-.-.-.-.-.-.-.->---------------------
,-X-.-.-.-.<.<.<.<.<.<.<.<.-E-E-.-W-.-E-E-.-+-.-.-.-.-.-.-.-A-.-A-.-.-.-.-.-.-.-.-.-A-.-.-.-.-.-.-.-.-.-A-+-.-.-.-.-.-,-.-.-.-.-.-.-,-.-,-A-L-.-.-E-.-.-<-.->---------------------
,-X-X-H-.-.<.<.<.<.<.<.<.<.-.-.-.-.-.-.-.-.-+-.-.-.-.-.-.-.-.-.-,-,-,-,-,-,-,-,-,-.-.-,-,-,-,-,-,-,-,-,-.-+-.-.-.-.-.-,-.-.-.-.-.-.-,-.-,-.-L-.-.-.-.-.-.-.->---------------------
--,-X-X-X-.<.<.<.<.<.<.<X<X-,-,-,-,-,-,-,-X-X-X-X-X-X-.-X-X-X-X-X-,-.-.-,-,-.-.-,-.-.-,-.-.-,-,-.-.-,-,-X-X-X-X-X-.-.-X-X-.-.-.-.-.-,-,-X-X-X-X-X-X-X-X-X-X-X---------------------
--------X-.<.<.<.<.<.<X<,-X-,-,-,-,-,-,-,-X-X-X-X-X-X2X2X2X-X-X-X-,-,-,-,-,-,-.-,-.-.-,-.-,-,-,-,-,-,-,-X-X-X-X-X-.-.-X-X-.-.-.-.-.-.-.-X---,-X-,---------------------------------
--------,-X<X<.<.<,<,<X<,-X-A-A-A-.-A-A-A-X-X-.-.-.-.-.-X-.-.-X-X-E-.-.-.-.-A-,-,-.-.-,-,-A-E-.-.-.-.-E-X-.-.-X-X-.-.-,-.-.-.-.-.-.-.-.-X---,-X-X-,-------------------------------
----------,-,-X<,<X<X---,-X-.-.-.-<-.-.-,-,-,-.-E-.-.-.-+-.-E-+-+-.-.-.-.-.-,-,-,-.-.-,-,-,-.-.-.-.-.-.-+-.-E-X-X-A-.-,-.-.-.-.-.-.-.-.-X---,-,-X-X-------------------------------
------------,-X-A-X-----,-X-X-.-.-.-.-.-X-X-X-,-+S+S+S.-X-.-.-X-X-.-.-.-.-.-,-.-,-.-.-,-.-,-.-.-.-.-.-.-X-.-.-X-X-X-X-X-X-.-.-.-.-.-.-X-X-,-,-X-X---------------------------------
--------,-,-,-X-.-X-,-,-,-,-X-.-.-.-.-.-X-,-X-,-.-,-+S.-X-.-.-X-X-.-.-.-H-.-,-.-,-.-.-,-.-,-.-.-H-.-.-.-X-.-.-X-------,-X-.-.-.-.-.-.-X-,-X-X-.-X---------------------------------
------,-,-X-X-X-.-X-X-X-X-X-X-.-.-.-.-.-X-X-X-,-,-,-+S.-X-,-,-X-X-.-E-.-.-.-,-,-,-.-.-,-,-,-.-.-.-.-.-,-X-,-,-X-------,-X-.-.-.-.-.-.-X-X-.-.-.-X---------------------------------
------,-X-X-.-.-.-.-.-.-.-.-.-.-.-.-.-.-,-,-,-E-.-.-.-.-X-,-,-X-X-<-.-.-.-.-E-,-,-.-.-,-,-,-E-.-.-.-.-E-X-,-,-X-------,-X-.-.-.-.-.-.-.-.-A-.-E-X---------------------------------
------,-X-.-.-.-.-.-.-.-.-.-.-.-.-.-.-.-,-X-X-.-.-H-.-.-X-,-,-X-X-X-X-X-X-X-X-X-X-.-A-.-X-X-X-X-X-X-X-X-X-,-,-X-------,-X-.-.-.-.-.-.-.-.-.-.-.-X---------------------------------
------,-X-X-.-.-.-.-.-.-.-.-.-.-.-.-.-.-.-X-X-X-X-X-X-X-X-,-,-X-X-X-X-X-X-X-X-X-X-+-+-+-X-X-X-X-X-X-X-X-X-,-,-X-,-----,-X-.-.-.-A-.-.-.-.-A-E-.-X---------------------------------
--------,-X-X-X-X-X-X-X-X-X-X-.-.-.-.-.-X-X-,-X-X-,-X-X-X-.-.-.-,-,-,-,-,-,-,-,-.-.-.-.-,-.-,-,-,-,-,-,-.-.-.-X-X-----,-X-.-.-.-.-.-.-.-.-A-.-.-X---------------------------------
------------------------,-,-X-.-.-.-.-.-X-,-----------,-X-.-E-.-,-,-,-,-,-,-,-,-.-.-W-.-,-.-,-,-,-,-,-,-.-E-.-X-X-----,-X-.-.-.-.-.-E-X-X_X-X-X-X---------------------------------
------------------------,-X-X-.-.-.-.-.-X-X-----------,-X-X-X-X-X-X-X-X-X-X-X-X-X-.-.-.-X-X-X-X-X-X-X-X-X-.-.-X-------,-X-.-.-.-.-.-.-X-,-----------------------------------------
------------------------,-X-.-.-.-.-.-.-.-X-----------------------------------,-X-.-.-,-X-X-X-X-X-X-X-X-X-+-+-X-------,-X-.-.-.-.-.-.-X-X-----------------------------------------
------------------------,-X-.-.-.-.-.-A-.-X-------------------------,-,-,-,-,-,-,-X-X-X-X-.-.-.-.-.-.-.-.-.-.-X-------,-X-.-.-.-.-.-.-.-X-----------------------------------------
------------------------,-X-.-.-,-,-,-,-,-X---------------------,-,-X-X-X-X-X-X-X-X-X-X-.-.-.-.-.-.-.-.-.-.-.-X-----,-,-X-.-.-.-.-.-.-.-X-----------------------------------------
--------------------------,-X-X-X-X-.-.-.-X-------------------,-,-X-.-.-.-.-.-.-.-.-.-.-.-.-.-.-.-.-.-.-.-E-E-X-----,-.-X-.-.-.-.-.-.-.-X-,-,-------------------------------------
--------------------------------,-X-,-,-,-X-----------------,-,-X-.-.-.-.-.-<-.-.-.-.-.-.-.-.-.-.-.-.-.-X-X-X-X---,-,-X-.-.-.-.-.-.-.-.-X^X-X-------------------------------------
------------------,-,-,-,-,-,-,-,-X-,-,-.-X-,---------------,-.-X-.-.-.-.-.-.-.-,-,-,-E-,-,-,-,-,-E-,-,-X-,-,-,-,-,-.-X-.-.-.-.-.-.-.-.-.-A-X-------------------------------------
------------------,-X-X-X-X-X-X-X-X-.-.-.-,-X---------------,-X-.-.-.-.-.-.-.-.-,-.-,-,-,-,-.-,-,-,-,-,-X-,-X-X-X-X-X-.-.-.-.-.-.-.-.-.-.-.-X-------------------------------------
----------,-,-,-,-,-X-,-,-E-.-H-X-X-.-,-,-,-X-,-,-,-,-,-,-,-,-X-.-.-.-.-A-.-.-.-,-,-.-.-.-.-.-.-.-.-.-.-X-X-X-.-.-.-.-.-.-.-.-.-.-.-.-.-.-E-X-------------------------------------
----------,-X-X-X-,-X-.-X-X-X-.-X-,-X-,-,-,-,-X-X-X-X-X-X-X-X-X-.-.-.-.-.-.-.-.-,-,-.-.-.-.-.-.-.-.-.-.-.-.-.-.-.-.-.-.-.-.-.-.-.-.-.-.-.-A-X-------------------------------------
------,-,-,-X-E-X-,-X-E-X-,-X-E-X---X-,-.-,-.-,-,-.-.-.-,-,-,-,-E-.-E-.-.-.-E-.-E-,-.-.-.-.-.-.-.-.-.-.-.-.-.-.-.-.-.-.-.-.-.-.-.-.-+^.-E-,-X-------------------------------------
------,-X-X-X-.-X-X-X-.-X-X-X-.-X---,-X-X-,-.-,-.-.-.-,-,-.-,-,-.-.-.-.-.-.-.-.-,-,-,-,-,-,-.-.-.-.-.-.-.-.-.-.-.-.-.-.-.-.-.-.-.-+^.-.-A-X---------------------------------------
------,-X-E-.-A-.-A-.-A-.-E-,-.-X-----,-,-X-X-,-.-.-,-,-.-.-,-,-.-.-.-.-A-.-.-.-,-,-,-,-,-,-,-.-.-.-.-.-.-.-.-.-.-.-.-.-.-.-.-.-+^.-.-A-.-X---------------------------------------
------,-X-X-X-.-.-.-.-.-X-X-X-X-X-----------,-X-X-X-X-.-.-.-,-,-.-.-.-.-.-.-.-,-,-,-.-.-.-.-,-,-,-.-.-.-.-.-.-.-.-.-.-.-.-.-.-+^.-.-.-E-,-X---------------------------------------
,-,-,-,-,-,-X-.-.-.-.-.-X-,-,-,-,-,-,-,-----------,-X-.-.-.-,-,-.-.-.-.-.-.-.-,-,-,-.-.-.-.-,-,-,-,-,-.-.-.-.-.-.-.-.-.-.-.-+^+^.-E-H-,-X-----------------------------------------
X-X-X-X:X-X-X-.-.-.-.-.-X-X-X-X-X-X-X-X-----------,-X-.-.-.-,-,-.-.-.-.-.-.-,-,-,-.-.-.-.-.-.-.-.-.-X-X-X-X-X-X-X-X-X^+^+^.-.-.-.-A-X-X-------------------------------------------
X-H-.-.:.-.-.-A-.-A-.-A-.-.-.-.-.-.-+-X---,-,-,-,-,-X-.-.-.-,-,-,-,-,-,-,-,-,-,-,-.-.-.-.-.-.-.-.-,-X-------------,-X^.-.-.-.-A-,-X-----------------------------------------------
X-X-X-.:.-.-.-.-.-.-.-.-.-.-.-.-.-+-.-X---,-X-X-X-X-X-.-.-.-X-X-.-,-.-.-.-.-.-.-.-.-.-.-.-.-.-.-.-X---------------,-X-.-.-A-,-X-X-------------------------------------------------
--,-X-.:.-.-.-.-.-.-.-.-.-.-.-.-+-.-H-X-,-,-X-,-.-+T+T.-.-.-.-.-,-,-.-.-.-.-.-.-.-.-.-.-.-.-.-.-,-X---------------,-X-X-X-X-X-----------------------------------------------------
--,-X-.:.-.-.-.-.-.-.-.-.-.-.-+-.5.-.-X-X-X4X-,-.-+T+T.-.-.-.-.-,-.-.-.-.-.-.-.-.-.-.-.-.-.-.-.-X---------------------------------------------------------------------------------
--,-X5.:.-.-.-.-.-.-.-.-.-.-.-.-.-.-.-,-.-.4+-,-.-+T+T.-.-.-.-.-,-.-.-.-.-.-.-.-,-,-,-,-.-.-.-,-X---------------------------------------------------------------------------------
--,-X5.:E-.-.-.-.-W-.-.-.-.-.-.-.-.-.-,-W-.4+-,-.-+T+T.-E-.-.-E-,-.-.-.-,-,-.-.-,-.-.-,-.-.-,-X-----------------------------------------------------------------------------------
--,-X5.:.-.-.-.-.-.-.-.-.-.-.-.-.-.-.-,-.-.4+-,-.-+T+T.-.-.-.-.-,-.-.-,-,-,-,-,-,-.-.-,-,-,-X-------------------------------------------------------------------------------------
--,-X-.:.-.-.-.-.-.-.-.-.-.-.-+-.5.-.-X-X-X4X-,-.-+T+T.-.-.-.-.-,-.-.-,-.-.-.-.-.-.-.-.-,-X---------------------------------------------------------------------------------------
,-,-X-.:.-.-.-.-.-.-.-.-.-.-.-+-.-.-H-X---,-X-.-.-+T+T.-.-.-.-,-,-.-.-,-.-.-.-.-.-.-,-X-X-----------------------------------------------------------------------------------------
X-X-X-.:.-.-.-.-.-.-.-.-.-.-.-.-+-.-.-X---,-X-X-X-XTX4.-.-.-X-X-X-X-X-X-X-X-X-X-X-X-X---------------------------------------------------------------------------------------------
X-H-.-.:.-.-.-A-.-A-.-A-.-.-.-.-.-+-+-X---------,-,-X-.-.-.-X-,-,-,-,-,-,-,-,-,---------------------------------------------------------------------------------------------------
X-X-X-X:X-X-X-.-.-.-.-.-X-X-X-X-X-X-X-X---------,-X-X-.-.-.-X-X-X-X-X-X-X-X-X-X---------------------------------------------------------------------------------------------------
,-,-,-,-,-,-X-.-.-.-.-.-X-,-,-------------------,-X-.-.-.-.-.-.-,-.-.-.-.-.-<-X---------------------------------------------------------------------------------------------------
X-X-X-X-X-X-X-.-.-.-.-.-X-X-X-------------------,-X-.-.-.-.-.-.-,-.-.-.-A-.-.-X---------------------------------------------------------------------------------------------------
X-A-.-,-.-E-.-A-.-A-.-A-.-E-X-------------------,-X-.-.-.-.-.-.-,-E-.-,-,-.-H-X---------------------------------------------------------------------------------------------------
X-X-X-,-X-X-X-.-X-X-X-.-X-X-X-------------------,-X-.-.-.-.-.-.-,-,-,-,-A-.-.-X---------------------------------------------------------------------------------------------------
--,-X-A-X-,-X-E-X-,-X-E-X-----------------------,-X-.-.-.-.-.-.-.-.-.-A-,-.-H-X---------------------------------------------------------------------------------------------------
--,-X-X-X-,-XZ+ZXZ,-X-.-X-----------------------,-X-X-X-X-X-X-X-X-X-X-X-X-X-X-----------------------------------------------------------------------------------------------------
----------,-X4.4X4X4X4.4X4----------------------------,-X-X-----,-X-X-------------------------------------------------------------------------------------------------------------
----------,-X-E-.-.-.-E-X---------------------------------------------------------------------------------------------------------------------------------------------------------
----------,-X-.-.-.-.-.-X---------------------------------------------------------------------------------------------------------------------------------------------------------
----------,-X-.-.-H-.-.-X---------------------------------------------------------------------------------------------------------------------------------------------------------
----------,-X-X-X-X-X-X-X---------------------------------------------------------------------------------------------------------------------------------------------------------
