--------------------------------------------------------------------------,-,-X~--------------------------------------------------------------------------------------------------------------
----------------------------------------------------------------------,-,-X-X~X~--------------------------------------------------------------------------------------------------------------
--------------------------------------------------------------------,-,-X-.~,~X~--------------------------------------------------------------------------------------------------------------
--------------------------------------------------------------------,-X~.~,~X~----------------------------------------------------------------------------------------------------------------
--------------------------------------------------------------------,-X~.~X~------------------------------------------------------------------------------------------------------------------
--------------------------,-,-,-,-,-,-,-----------------------------,-X~.~X~,-----------------------------------------------------------------------------------------------------------------
--------------------------,-X-X-X-X-X-X-,-,-,-,-------------------,-,-X~.~.~X-,---------------------------------------------------------------------------------------------------------------
--------------------------,-X->->->->->-,-X-X-X-------------------,-X-.~.~.~X~,-,-,-----------------------------------------------------------------------------------------------------------
------------------------,-,-X~,-E-E~,-,-X~X-.-X-------------------,-X-.~.~.~.~X~X~,-,---------------------------------------------------------------------------------------------------------
------------------------,-.-X~.~.~.~.~,~X-.-E-X-------------------,-X-.~.~.~.~.~.~X~X~--------------------------------------------------------------------------------------------------------
------------------------,-X~.~.~.~.~.~.~,~,-,-X-------------------,-X~.~.~.~.~.~.~.~X~,-------------------------------------------------------------------------------------------------------
----------------------,-,-X~.~.~.~.~.~.~.~.~.~X~----------------,-,-X-,~.~.~.~.~.~.~X~,-,-----------------------------------------------------------------------------------------------------
----------------------,-.-X~.~.~.~.~.~.~.~.~.~X~--------------,-,-X-<-,-,~,~.~.~.~.~,~X~X-----------------------------------------------------------------------------------------------------
----------------------,-X-.~.~.~.~.~.~.~.~.~,~X~,-,---------,-,-X-.-,-,-X-X-,~.~.~,~,~.-X-,---------------------------------------------------------------------------------------------------
----------------------,-X~.~.~.~.~.~.~.~.~.~,~X-X-X-------,-,-X-,-.-.-X-,-X-,-.~.~,~.-.-E-X---------------------------------------------------------------------------------------------------
----------------------,-X~.~.~,~,-.~.~.~.~,~,~.-.-,-X-----,-X-.-,-,-X-,-,-X-E-,~.~,~.-.-H-X---------------------------------------------------------------------------------------------------
--------------------,-,-X~.~.~,~,-,~,~.~.~,~X-X-A-.-X-----,-X-.-,-,-X-,-,-X-,-,-.~,~,-.-.-X-----,-,-,-----------------------------------------------------------------------------------------
--------------------,-,-X~,~.~,~,-,~,-,~,~,~X~X-.-.-X-------,-X-,-.-.-X-X-X-,-.~.~.~,~,-,-X---,-,-X-X-----------------------------------------------------------------------------------------
--------------------,-X~.-,-,-,~.-t4,-,~.-,-X~,-X4t4X4------,-X-X-.-.-.-,-.-,-,~.~.~.~.~.~X~,-,-X-.-X-,-,-------------------------------------------------------------------------------------
--------------------,-X-A-.-,-,-.-.-,-,-.-,-A-X-X-.-X-----------,-X-X-,-,-.-W-,-.~.~.~.~,~X~,-X-.-A-X-,-X-------------------------------------------------------------------------------------
----------------------,-X-X-X-X-.-.-.-X-X-X-X-,-X-X-X-------------,-,-X-.-E-.-,-.~.~.~.~,~.-X-.-A-.-.-X-X-,-----------------------------------------------------------------------------------
----------------------------,-X-.-.-.-X---------------,-,-,-,-,-,-,-X-X-,-,-,-,-.~.~.~,~,-.-.-.-E-.-H-.-.-X-----------------------------------------------------------------------------------
----------------------------,-X-.-H-.-X-------------,-,-X-X-X-X-X~X~.~.~.~.~.~.~.~.~.~,~.-.-.-.-.-.-.-A-E-X-----------------------------------------------------------------------------------
----------------------------,-X-,-,-,-X-----------,-,-X-.-.-.-.-,-.~.~.~.~.~.~.~.~.~.~,~,-.-.-.-.-.-.-.-X-------------------------------------------------------------------------------------
------------------,-,-,-,-,-,-X-,-<-,-X-,-,-------,-.-X-.-E-.-.-,-.~.~.~.~.~.~.~.~.~.~.~,~.-.-.-.-.-A-,-X-------------------------------------------------------------------------------------
--------------,-,-,-X-X-X-X-X-X-.-.-.-X-X-X-------,-X-.-.-.-.-.-,-.~.~.~.~.~.~.~.~.~.~.~,~.-.-.-.-.-.-X---------------------------------------------------------------------------------------
------------,-,-X-X-.-.-.-,-.-.-.-.-.-.-,-X-----,-,-X-.-.-E-.-.-,-.~.~.~.~.~.~.~.~.~.~,~,~.-.-.-,-X-X-X-----------,-,-------------------------------------------------------------------------
------------,-X-.-.-.-.-.-,-.-.-.-.-.-.-X-X/----,-.-X-.-.-E-.-.-,-.~.~.~.~.~.~.~.~.~,~,~.-.-.-.-X-,-,-X-,-----,-,-X-X~------------------------------------------------------------------------
,-,-,-,-,-,-,-X-.-.-.-.-.-,-,-,-.-.-.-.-.-X/,-,-,-X-.-.-.-.-.-.-,-,~,~,~.~.~,~,~,~,~,~.-.-.-.-.-.-X-,-X-X-,-,-X-X~X~X~------------------------------------------------------------------------
X-X-X-X-X.X-X-.-.-.-.-.-.-,-,-,-.-.-.-.-X-X-X-X-X-X-.-.-.-E-.-.-,-.-.-,-,~,~,~,-,~.-,-.-.-.-.-.-.-.-X-.-,-X-X~,~X~,---------------------------------------------------------------------------
X-H-.-.-...-.-.-.-.-:-.-.-,-,-,-E-.-E-.-.-.-.-.-.-,5.-.-.-E-.-.-,-.-.-A-,-A~.-A-.-.-,-.-.-.-.-.-.-.-.-.-E-.~,~,~.-X---------------------------------------------------------------------------
X-.-.-.-..E-.-E-.-.-W-.-.-,-,-,-.-E-.-.-A-.-.-.-.-,5.-H-.-A-.-.-,-,-,-,-,-,-,-,-,-,-,-.-.-.-.-.-.-.-E-,-,-.~,~E-.-X-,-------------------------------------------------------------------------
X-H-.-.-...-.-.-.-.-.-.-:-,-,-,-.-.-.-.-.-.-.-.-.-X5.-.-.-E-.-.-,-.~.~.~.~.~.~.~.~.~,~,-.-.-.-.-.-.-,-X~.~.~,~,~.-.-X-------------------------------------------------------------------------
X-X-X-X-X.X-X-.-.-.-.-.-.-,-,-,-.-.-.-.-X-X3X-X-X-X-.-.-.-E-.-.-,-.~.~.~.~.~.~.~.~.~.~,-.-.-.-.-.-X-X-X~.~X~,~.-.-.-X-,-----------------------------------------------------------------------
------------,-X-.-.-.-.-.-,-.-.-.-.-.-.-,-X3--,-X-X-.-.-.-.-.-.-,-.~.~.~.~.~.~.~.~.~.~,~,-.-.-.-.-X-,-X~X~X-.-.-.-.-X-,-,---------------------------------------------------------------------
--------------,-X-.-.-.-.-,-.-.-.-.-.-,-X-X---,-X-.-.-.-.-E-.-.-,-.~.~.~.~.~.~.~.~.~.~.~,-.-.-.-.-X-,-X~X~,-X-.-.-.-.-X-X-------------------,-,-,-,-,-,-,-,-,-,-,-,-,-,-,---------------------
----------------,-X-X-X-X-X-X-X-,-,-,-X-.-X---,-X-.-.-.-.-E-.-.-,-.~.~.~.~.~.~.~.~.~.~.~,~.-.-.-.-X-,-X~X~--,-X-.-.-.-E-,-X---------------,-,-X-X-X-X-X-X-X-X-X-X-X-X-X-X-,-------------------
----------------------------,-X-,-,-,-X-X-X-----,-X-.-.-.-.-.-,-,-.~.~.~.~.~.~.~.~.~.~.~,~.-.-.-,-X-,-X~X~,-,-X-.-.-.-.-.-X---------------,-.-X-.-.-.-.-,-,-A-,-.-.-.-.-.-X-,-----------------
----------------------------,-X-.-.-E-X-----------,-X-X-.-.-.-,-.-.~.~.~.~.~.~.~.~.~.~.~,~,-.-,-X---------,-.-X-.-.-.-.-X-,---------------,-X-E-.-.-.-.-E-.-.-,-.-E-.-.-.-.-X-----------------
----------------------------,-X-.-.-.-X---------------,-X-X-X-X-X~.~.~.~.~.~.~.~.~.~.~.~.~,-.-X-----------,-X-.-.-.-.-.-X-----------------,-X-.-.-.-.-.-,-.-,-,-.-.-.-.-.-.-X-,-,-,-,-,-,-,-,-
------------------------,-,-,-X-.-.-.-X-,-,---------------------,-X~.~.~.~.~.~.~.~.~,~X~X~X~,-X-------,-,-X-X-.-.-.-.-.-X-,-----,-,-,-----,-X-.-.-.-.-.-,-,-,-.-.-.-.-.-.-.-X-X-X-X-X-X-X-X-X-
----------------------,-,-X~X~XU.-.-,-XUX~X~------------,-,-,-,-,-X-.~.~.~.~.~.~.~.~X~----,-X---------,-X-H-.-.-.-.-.-.-.-X-,-,-,-X-X-,-,-,-X-.-.-.-.-.-.-.-.-.-.-.-.-.-.-.-.-.-.-A-.-.-.-.-X-
--------------------,-,-X~.~.~,~,-A-,-.~.~X~----------,-,-X-X-X---,-X~.~.~.~.~.~.~.~X~------------,-,-,-X-.-.-.-.-.-.-.-,-,-X-X-X-X-,-X-X-X-X-.-.-.-.-.-.-.-.-.-.-.-.-.-.-.-.-.-.-.-.-.-.-.-X-
------------------,-,-X~.~.~.~.~.~.~.~.~.~X~,---------,-.-X-.-H-X-,-X~.~.~.~.~.~.~.~X~------------,-X~,-X-A-.-.-.-.-.-.-,-.-.-,-,-,-E-,-,-+-.-.-.-.-.-.-.-.-.-.-.-.-.-.-.-.-.-.-.-<-.-<-.-.-X-
------------------,-.-X~.~.~.~.~.~.~.~.~.~X~X~,---,-,-,-X-.-E-.-X-X-.~.~.~.~.~.~.~.~,~X-----------,-X~X~X-H-.-.-.-.-.-.-,-.-.-,-E-,-E-,-,-+-.-W-.-.-.-.-E-.-.-.-.-.-.-.-.-.-.-.-.-.-.-.-.-W-X-
----------------,-,-X~.~.~.~.~.~.~.~.~.~.~.~.~X-,-,-X~X~X~X-,-,-X-X~.~.~.~.~,~,~.~.~.~X-,-------,-,-X~X-X-.-.-.-.-.-.-.-,-,-,-,-,-,-,-,-,-+-.-.-.-.-.-.-.-.-.-.-.-.-.-.-.-.-.-.-.-<-.-<-.-.-X-
----------------,-.-X~.~.~.~.~.~.~.~E~.~.~.~.~X~X~,-X~.~.~.~.~.~.~.~.~.~.~.~,~,-.~.~.~X~,-,-,-,-,-X-X~--,-X-X-.-,-,-.-.-.-.-X-X-X-X-E-X-X-X-X-.-.-.-.-.-.-.-.-.-.-.-.-.-.-.-.-.-.-.-.-.-.-.-X-
----------------,-X~.~.~.~.~.~A~.~.~.~.~.~.~.~.~.~X~.~E~.~.~.~.~.~.~.~.~.~.~X~X-.~.~.~.~X~X~X-,-,-X~X~------,-X-,-,~,-.-.-,-X---,-X-,-X---,-X-.-.-.-.-.-.-.-.-.-.-.-.-.-.-.-.-.-.-.-.-.-.-.-X-
----------------,-X-.~.~.~.~.~.~.~.~.~.~.~.~.~.~.~.~.~.~.~.~.~.~.~.~.~.~.~X~,-,-X~.~.~.~,~.-,-X-X~,~X~------,-X~.~.~,~,-.-X-----,-X-X-----,-X-.-.-.-.-.-,-,-,-,-.-.-.-.-.-.-X-X-X-X-X-X-X-.-X-
------------,-,---X-.~.~.~.~.~.~.~.~E~.~E~.~E~.~E~.~E~.~.~.~.~.~.~.~.~,~X~X~--,-X~.~.~,~,-,-,-.~,~X~----------,-X~.~.~,~,-X---------------,-X-.-.-.-.-:-,-.-.-,-.-.-.-.-.-.-X---------,-X-X-X-
------------,-X-,-,-X~.~H~.~.~.~.~.~.~,~X~X~X~X~X~.~,~X~X~.~.~.~.~.~X~X-------,-X~.~.~,~,-,-,~,~,~X-------------,-X~.~E~X-----------------,-X-E-.-.-.-.-,-.-,-,-.-.-.-.-.-.-X-----------------
----------,-,-X-X-X-X~.~.~.~.~.~.~,~,~X~--------,-X~X---,-X~.~.~.~,~X~--------,-X~.~,~,-E-,-E~.-.-X---------------,-X~X~X~----------------,-X-.-.-.-.-.-E-,-,-.-.-E-.-.-,-,-X-----------------
----------,-X-.-.-.-+-X~X~.~.~,~,~,~X-,-----------------,-X-.~,~X~X-------------,-X~,~.-,-,~.~.-.-X-----------------------------------------,-X-X-X-X-X-X-X-X-X-+-X-X-X-X-X-------------------
----------,-X-.-.-.-X-,-,-X~X~,~.~.-.-X-,-----------,-,-,-,-X~X-,-,-,-,-----------,-X~X-,-,~E-.-E-X-,-------------------------------------------------------,-X-.-X---------------------------
----------,-X-.-.-.-X-----,-,-X-.-.-.-.-X-,---------,-X-X-X-X-X-X-X-X-X---------------X-,-,~.-.-.-X-X-,-,-,-,-,---------------------------------------------,-X-.-X---------------------------
------------,-X-,-X-X---------X-.-.-.-E-.-X-,-,-,-,-,-X-.-A-E-H-A-.-A-X-,-,-,-,-----,-,-X~.~.-E-.-E-.-X-X-X-X-X---------------------------------------------,-X-X-X---------------------------
------------,-X-X-------------,-X-.-.-.-.-X-,-X-X-X-X-XR.-.-.-.-.-.-.-XRX-X-X-X-----,-X-,~X-X-X-.-.-.-.-.-.-.-X-,-----------------------------------------------------------------------------
----------------------------,-,-X-.-.-E-E-.-X-X-.-.-.-.-.-.-<-.-.-.-.-.-.-.-.-X---,-,-X~X~--,-,-X-.-E-.-.-.-.-.-X-----------------------------------------------------------------------------
------------------------,-,-,-X-X-.-E-.-E-,-X-X-.-.-.-.-.-.-.-.-.-.-.-.-.-.-.-X---,-X~,~X~----,-X-.-.-.-.-.-.-,-X-----------------------------------------------------------------------------
------------------,-,-,-,-X-X-.-.-.-.-,-X-X-,-X-.-.-,-,-,-,-,-,-,-,-,-.-.-.-.-X---,-X~X---------,-X-.-E-.-.-.-X-------------------------------------------------------------------------------
------------------,-X-X-X-.-.-.-.-E-E-X-----,-X-.-.-,-.~.~,~.~,~.~.~,~,-.-.-.-X---------------,-,-X-.-.-.-.-,-X-------------------------------------------------------------------------------
------------------,-X-.-.-.-.-.-.-,-X-------,-X-.-.-,-.~.~,~,~,~.~.~.~,~.-.-.-X---------------,-X-.-.-.-.-.-X---------------------------------------------------------------------------------
------------------,-X-.-.-.-.-.-.-X---------,-X-.-.-H-.~E~.~.~.~.~.~.~H~.-.-.-X-----------,-,-,-X-.-.-.-.-,-X---------------------------------------------------------------------------------
------------------,-X-.-.-.-.-.-.-X-,-,-,-,-,-X-.-.-,-.~.~.~.~.~.~.~,~,~:-.-.-X-,-,-,-,-,-,-X-X-.-.-.-.-.-X-----------------------------------------------------------------------------------
------------------,-X-A-.-.-.-.-.-X-,-X-X-X-X-X-.-.-,-.~.~.~.~.~.~.~,~.-.-.-.-X-X-X-X-X-X-X-.-.-.-.-.-.-.-X-,---------------------------------------------------------------------------------
--------------------,-X-.-.-.-.-.-.-X-,-X-X-.-.-.-.-,-.~.~.~.~.~.~.~,~,-.-.-.-.-.-.-.-X-X-.-.-.-.-.-.-.-.-.-X---------------------------------------------------------------------------------
--------------------,-X-.-.-.-.-.-.-.-,-X-X-.-.-.-A-,-.~.~.~.~,~,~.~.~,~A-.-.-.-.-.-.-X-X-.-.-.-.-.-.-.-.-.-X---------------------------------------------------------------------------------
--------------------,-X-.-.-.-.-.-.-.-,-.-.-.-.-.-A-,-.~.~,~,~,~,1.~.~,~A-.-.-.-.-.-.-+-,-.-.-.-.-.-.-.-.-.-X---------------------------------------------------------------------------------
--------------------,-X-A-.-.-.-.-.-.-,-.-.-.-.-.-.-,-.~.~,~.1K-,1.~.~,~.-.-.-.-.-.-.-+-,-A-.-.-.-.-.-.-.-.-X---------------------------------------------------------------------------------
--------------------,-X-.-.-.-.-.-.-.-,-.-.-.-.-.-.-,-.~.~,~,1,1,1.~.~,~.-.-.-.-.-.-.-+-,-.-.-.-.-.-.-.-.-.-X---------------------------------------------------------------------------------
----------------------,-X-.-.-.-.-.-.-,-X-X-.-.-.-A-,-.~.~.~.~.~.~.~.~,~A-.-.-.-.-.-.-X-X-.-.-:-.-<-.-.-.-,-X---------------------------------------------------------------------------------
------------------------,-X-.-.-.-.-.-.-X-X-.-.-.-A-,-.~.~.~.~.~.~.~,~,~A-.-.-.-.-.-.-X-X-.-.-.-.-.-.-,-,-X-----------------------------------------------------------------------------------
--------------------------,-X-X-X-X-X-X-X-X-X-X-.-.-,-.~.~.~.~.~.~.~,~.-.-.-.-X-X-X-X-X-X-X-.-.-.-.-,-X-X-------------------------------------------------------------------------------------
----------------------------------,-X-X-X-X-XQXQ.-.-,-.~.~.~.~.~.~.~,~,-.-.-.-X-X-X-X-X-,-,-X-X-X-X-X-----------------------------------------------------------------------------------------
----------------------------------,-X-A-.-.-+Q+Q.-.-,-.~.~.~.~.~.~.~.~,~.-.-.-.-.-.-A-X-------------------------------------------------------------------------------------------------------
----------------------------------,-X-.-E-.-+Q+Q.-.-H-.~.~.~.~.~.~E~.~H~.-.-.-.-.-E-.-X-------------------------------------------------------------------------------------------------------
----------------------------------,-X-.-.-.-+Q+Q.-.-,-,~,~,~,~,~,~,~,~,~.-.-.-.-.-.-.-X-------------------------------------------------------------------------------------------------------
----------------------------------,-X-.-E-.-+Q+Q.-.-.-.-.-.-.-.-.-.-.-.-.-.-.-.-.-E-.-X-------------------------------------------------------------------------------------------------------
----------------------------------,-X-.-.-.-+Q+Q.-.-.-.-.-.-.-.-.-.-.-.-.-.-.-.-.-.-.-X-------------------------------------------------------------------------------------------------------
----------------------------------,-X-H-E-.-+Q+Q.-.-.-.-.-.-.-.-.-.-.-.-.-.-.-.-.-.-H-X-------------------------------------------------------------------------------------------------------
----------------------------------,-X-.-.-.-+Q+Q+Q+Q+Q+Q+QXQX2.2X2XQ+Q+Q+Q+Q+Q.-.-.-.-X-------------------------------------------------------------------------------------------------------
----------------------------------,-X-.-E-.-+Q+Q+Q+Q+Q+Q+QXQX-A-X-X-.-.-.-.-.-.-.-.-.-X-------------------------------------------------------------------------------------------------------
----------------------------------,-X-.-.-.-H-.-.-.-.-.-.-X-X-.-X-X-.-.-.-.-.-.-H-.-.-X-------------------------------------------------------------------------------------------------------
----------------------------------,-X-.-.-.-E-.-.-E-.-.-.-X-X-A-X-X-E-.-E-.-E-.-.-E-.-X-------------------------------------------------------------------------------------------------------
----------------------------------,-X-A-.-.-.-.-H-.-.-.-A-X-X-X-X-X-.-.-.-.-H-.-.-.-A-X-------------------------------------------------------------------------------------------------------
----------------------------------,-X-X-X-X-X-X-X-X-X-X-X-X-----,-X-X-X-X-X-X-X-X-X-+-X-------------------------------------------------------------------------------------------------------
----------------------------------------------------------------------------,-X-.-.-.-X-------------------------------------------------------------------------------------------------------
----------------------------------------------------------------------------,-X-.-W-.-X-------------------------------------------------------------------------------------------------------
----------------------------------------------------------------------------,-X-.-.-H-X-------------------------------------------------------------------------------------------------------
----------------------------------------------------------------------------,-X-X-X-X-X-------------------------------------------------------------------------------------------------------
