--------------------------------------------------------------------------------,-,-X-X-X-X-X-X-X-X-X-X-X-X-X-X-X-X-X-,---------------------------------------------------------------------------------------------------
--------------------------------------------------------------------------------,-.-X-.-.-.-.-.-A-.-A-A-.-.-.-.-.-.-.-X---------------------------------------------------------------------------------------------------
--------------------------------------------------------------------------------,-X-.-.-.-.-.-.-.-.-.-.-.-.-.-.-.-.-.-X---------------------------------------------------------------------------------------------------
----------------------------------------------------------------------------,-,-,-X-.-.-.-.-.-.-.-.-.-.-.-.-.-.-.-.-.-X-,-,-----------------------------------------------------------------------------------------------
----------------------------------------------------------------------------,-X-X-X-,-,-X-X-X-X-X-,-,-,-X-X-X-X-X-,-,-X-X-X-----------------------------------------------------------------------------------------------
----------------------------------------------------------------------------,-X-.-.-.-.-.-.-,-.-,-.-.-,-.-,-.-.-.-.-.-.-.-X-----------------------------------------------------------------------------------------------
----------------------------------------------------------------------------,-X-.-.-.-.-,-,-,-.-,-.-.-,-.-,-,-.-.-.-.-.-.-X-----------------------------------------------------------------------------------------------
----------------------------------------------------------------------------,-X-.-.-.-.-,-.-,-,-,-.-.-,-,-,-,-,-.-.-.-.-.-X-----------------------------------------------------------------------------------------------
----------------------------------------------------------------------------,-X-.-E-.-.-E-.-,-.-,-,-,-,-.-,-.-,-E-.-.-.-.-X-----------------------------------------------------------------------------------------------
----------------------------------------------------------------------------,-X-.-.-.-.-,-.-,-.-,-.5.5,5.-,-.-,-.-.-E-.-.-X-----------------------------------------------------------------------------------------------
----------------------------------------------------------------------------,-X-.-.-.-.-,-.-,-.-,-.5K-,5.-,-.-,-.-.-.-.-.-X-----------------------------------------------------------------------------------------------
----------------------------------------------------------------------------,-X-.-.-.-.-,-.-,-E-,-,5,5,5E-,-.-,-.-.-.-.-.-X-----------------------------------------------------------------------------------------------
----------------------------------------------------------------------------,-X-.-.-.-.-,-.-,-,-,-.-.-,-,-,-,-,-.-.-.-.-.-X-----------------------------------------------------------------------------------------------
----------------------------------------------------------------------------,-X-.-.-.-.-,-,-,-.-,-.-E-,-.-,-,-.-.-.-.-.-.-X-----------------------------------------------------------------------------------------------
----------------------------------------------------------------------------,-X-.-.-.-.-.-.-,-.-,-.-.-,-.-,-.-.-.-.-.-.-.-X-----------------------------------------------------------------------------------------------
----------------------------------------------------------------------------,-X-.-.-.-.-.-.-,-.-,-.-<-,-.-,-.-.-.-.-.-.-.-X-----------------------------------------------------------------------------------------------
----------------------------------------------------------------------------,-X-.-.-.-.-.-,-,-X-X-X-X-X-X-X-.-.-.-.-.-.-.-X-----------------------------------------------------------------------------------------------
----------------------------------------------------------------------------,-X-.-.-.-.-.-,-.-X-X-X-X-X-X-X-.-.-.-.-.-.-.-X-----------------------------------------------------------------------------------------------
----------------------------------------------------------------------------,-X-.-.-.-.-.-,-.-,-A-.-A-A-,-,-.-.-.-.-.-.-.-X-----------------------------------------------------------------------------------------------
----------------------------------------------------------------------------,-X-,-,-,-,-.-,-.-,-.-.-.-.-,-,-.-.-,-,-,-,-,-X-------------------------,-,-,-,---------------------------------------------------------------
----------------------------------------------------------------------------,-X-.-.-.-X-X-X-X-X-X-.-.-.-X-X-X-X-X-X-.-.-.-X-------------------------,-X-X-X-,-,-----------------------------------------------------------
----------------------------------------------------------------------------,-XU.-.-.-XU,-,-X-X-X-.-.-.-X-X-X-,-,-XU.-.-.-XU--------------------,-X-X-X-W-X-X-X-,---------------------------------------------------------
----------------------------------------------------------------------------,-X-.-.-.-X-,-X-,-,-.-.-.-.-,-,-X-X-,-X-E-.-E-X-----------------,-X-X-.-X-.-.-X-X-,-X-,-,-----------,-,-,-,-,-,-,-,-,-,-,-,-,-,-,-,-,-,-,-,-,-
----------------------------------------------------------------------------,-X-E-H-E-X-,-X-,-,-.-.-.-,-,-,-,-X-,-X-.-H-.-X---------------X-X-.-.-,-,-.-.-.-,-,-,-X-X-,---------,-X-X-X-X-X-X-X-X-X-X-X-X-X-X-X-X-X-X-X-X-
----------------------------------------------------------------------------,-X-X-X-X-X-,-X-.-X-X-.-.-,-X-.-.-X-,-X-X-X-X-X-------------X-,-.-,-,-,-.-.-E-.-.-.-,-,-,-X-,-------,-X-.-.-.-.-.-.-.-.-.-.-.-.-.-.-.-.-.-.-X-
----------------------------------------------------------------------------------------,-X-.-X-X-.-.-,-X-.-.-X-----------------------,-X-.-,-,-,-,-E-.-.-E-,-,-,-,-,-,-X-,-----,-X-.-.-.-.-.-.-.-.-.-.-.-.-.-.-.-.-.-.-X-
----------------------------------------------------------------------------------------,-X-.-X-X-.-.-,-X-.-.-X-----------------------,-X-.-,-.-.-,-.-.-.-.-,-.-,-.-,-,-.-X-----,-X4t4t4t4t4t4t4t4t4t4t4t4t4t4t4t4t4t4t4X4
----------------------------------------------------------------------------------------,-X-,-X-X-L-L-L-X-.-.-X-------------------,-,-X-.-,-,-,-,-,-.-.-.-.-,-,-,-.-,-,-,-X-,---,-X4t4t4t4t4t4t4t4t4t4t4t4t4t4t4t4t4t4t4X4
----------------------------------------------------------------------------------------,-X-,-.-,-.-.-,-,-.-.-X-------------------,-X-.-.-,-.-.-.-.-.-.-.-.-.-.-.-.-.-,-,-,-X-,-,-X-,-,-,-,-,-,-,-,-,-,-,-,-,-,-,-,-,-,-X-
----------------------------------------------------------------------------------------,-X-E-.-,-.-.-,-,-E-.-X-------,-,-,-,-,-,-,-X-,-,-,-.-.-.-.-.-.-.-.-.-.-.-.-.-,-.-,-X-X-X-X-E-E-.-E-E-E-E-.-E-E-E-E-.-E-E-E-E-.-X-
----------------------------------------------------------------------------------------,-X-,-.-,-.-.-,-,-.-.-X-------,-X-X-X-X-X-X-X-.-.-.-.-.-.-.-.-.-.-.-.-.-.-.-,-,-.-,-.-.-.-,-X-X-X-X-X-X-X-X-X-X-X-X-X-X-X-X-X-X-X-
----------------------------------------------------------------------------------------,-X-,-E-,-.-.-,-,-E-.-X-------,-X-A-.-.-.-.-,-.-.-.-.-.-.-.-.-.-.-.-.-.-.-.-,-.-.-,-X-X-X-X---------------------------------------
------------------------------------------------------,-,-,-,-,-,-,-,-,-,-,-,-,-,-,-,-,-,-X-,-.-,-.-.-,-,-.-.-X-,-,-,-,-X-A-,-,-.-.-,-.-.-.-.-.-,-,-.-.-.-.-.-.-.-,-,-.-.-,-X---------------------------------------------
----------------------------------------------------,-,-X-X-X-X-X-X-X-X-X-X-X-X-X-X-X-X-X-X-E-.-,-.-.-,-,-E-.-X-X-X-X-X-X-,-.-,-.-.-,-.-.-.-.-,-,-,-,-.-.-.-.-.-.-,-.-.-.-,-X---------------------------------------------
----------------------------------------------------,-X-.-.-.-.-.-.-.-.-.-.-.-.-L-L-.-.-.-.-,-.-,-.-.-,-,-E-.-.-.-.-.-L-,-,-.-,-.-X-X-.-.-.-E-,-.-.-,-.-.-.-.-.-,-,-.-.-.-,-X---------------------------------------------
----------------------------------------------------,-X-.-.-.-.-.-.-.-.-.-.-.-.-L-L-.-.-.-.-E-.-,-.-.-,-,-.-.-.-.-.-.-L-,-,-.-,-.-X-X-X-X-.-.-,-X-X-X-.-.-.-.-.-,-.-.-.-.-,-X---------------------------------------------
----------------------------------------------------,-X-.-.-.-.-.-.-.-.-.-.-.-,-L-L-.-.-.-.-,-.-,-.-.-,-,-E-.-.-.-.-,-L-,-,-.-,-.-X---,-X-.-.-.-X-,-X-,-,-,-,-,-X-X-X-X-X-X-X---------------------------------------------
--------------------------------------------------,-,-X-.-.-.-.-.-.-.-,-X-X-X-X-X-X-X-X-X-X-X-X-X-X-.-X-X-X-X-X-X-X-X-X-X-X-X-X-X-X---,-X-.-.-.-X-,-X-.-.-.-.-,-X-X-X-X-X-X-,-,-------------------------------------------
----------------------------------------,-,-,-,---,-X-.-.-.-.-.-.-.-.-X-------,-X-X-,-,-,-,-,-,-,-X-+-X-,-,-,-,-,-,-,-X-X-------------,-X-.-.-.-X-,-X-.-.-.-.-.-,-.-.-.-.-.-X-X-,-----------------------------------------
------------------------------,-,-,-,-,-,-X-X-X-,-,-X-.-.-.-.-.-.-.-.-X-------,-X-X-X-X-X-X-X-X-X-X-,-X-X-X-X-X-X-X-X-X-X-------------,-X-.-.-.-X-,-X-.-.-.-.-.-,-.-.-.-.-.-.-.-X-----------------------------------------
----------------------------,-,-X-X-X-X-X-X-.-X-X-X-.-.-.-.-.-.-.-.-.-X-------,-X-.-,-.-,-.-,-,-,-,-,-,-.-,-.-,-.-,-.-.-X-------------,-X-.-.-.-X-,-X-A-.-.-.-.-,-.-.-.-.-.-.-.-X-,---------------------------------------
----------------------------,-X-,-,-.-.-.-.-.-E-.-.-.-.-.-.-.-.-.-.-.-X-------,-X-.-,-,-,-.-,-,-,-,-,-,-,-,-,-,-,-,-,-,-X-------------,-X-.-.-.-X-,-X-X-X-X-X-X-X-X-X-X-X-.-.-.-.-X---------------------------------------
----------------------------,-X-,-,-X-X-X-X-.-X-X-X-.-.-.-.-.-.-.-.-.-X-------,-X-,-,-,-,-,-,-.-.-.-.-,-,-.-.-.-.-.-.-,-X-,-,-,-,-,-,-,-X-.-.-.-X-,-,-,-,-,-,-,-,-------,-X-.-.-.-X---------------------------------------
----------------------------,-X-,-X-----,-X-+-X---,-X-.-.-.-.-.-.-.-.-X-------,-X-.-.-.-.-.-,-,-.-.-.-,-,-.-.-.-.-.-.-,-X-X-X-X-X-X-X-,-X-.-.-.-X-,-X-X-X-X-X-X-X-------,-X-.-.-.-X---------------------------------------
----------------------------,-X-.-X-----,-X-.-X-----,-X-.-.-.-.-.-.-.-X-------,-X-.-E-.-.-.-.-,-.-.-.-,-.-.-.-.-.-.-.-,-.-,-,-.-,-,-X-X-X-.-.-.-X-X-X-,-,-,-,-.-X-------,-X-.-.-.-X-,-------------------------------------
------------------,-,-,-,-,-,-X-+-X-,-,-,-X-X-X-----,-X-.-.-.-.-.-.-.-X-------,-X-.-.-.-.-E-.-,-.-.-.-,-.-.-.-.-.-.-.-,-.-,-A-.-,-,-,-,-.-.-.-.-.-,-,-,-,-,-,-.-X-------,-X-.-.-,-X-X-------------------------------------
------------------,-X-X-X-X-X-X-,-X-X-X-X-X-X-------,-X-.-.-.-.-.-.-.-X-------,-X-.-.-.-.-.-.-,-.-.-.-,-,-E-.-.-.-.-,-,-.-,-A-.-,-,-.-,-.-.-.-.-.-,-.-.-.-.-.-.-X-------,-X-.-.-,-.-X-------------------------------------
------------------,-X-.-.-.-,-,-A-,-.-.-.-.-X-------,-X-.-.-.-.-.-.-.-X-------,-X-.-.-.-.-.-,-,-.-.-.-.-,-.-.-.-.-.-,-,-.-,-,-.-,-,-.-,-.-.-,-,-,-,-.-,-,-,-,-.-X-----,-,-X-.-.-,-X-X-------------------------------------
------------------,-X-,-,-,-,-,-,-,-,-,-,-,-X-------,-X-.-.-.-.-.-.-.-X-------,-X-.-.-.-.-.-,-.-.-.-.-.-,-,-.-.-.-.-,-,-.-,-,-.-,-,-.-,-.-.-,-.-,-,-.-,-,-,-A-.-X-----,-X-X-.-.-.-X---------------------------------------
------------------,-X-.-.-.-,-,-,-,-.-.-.-.-X-------,-X-.-E-E-.-E-.-E-X-------,-X-.-.-.-.-,-,-.-.-.-.-.-.-,-,-.-.-.-,-,-.-,-,-.-,-,-.-,-.-.-,-.-,-,-.-,-,-.-.-.-X-----,-X-X-.-.-.-X---------------------------------------
,-,-,-,-,-,-,-,-,-,-X-.-.-,-,-.-.-,-.-.-.-.-X-----,-,-X-X-.-.-.-.-.-X-X-,-----,-X-.-.-.-,-,-.-.-.-.-.-.-.-.-,-,-E-.-.-,-.-,-,-.-,-A-.-,-,-,-,-.-,-,-.-,-,-,-,-.-X-------,-X-.-.-,-X-,-------------------------------------
X-X-X-X-X-X-X-X-X-,-X-.-,-,-.-.-.-,-,-.-.-.-X-----,-X-X-X-,-,-,-,-,-X-X-X-----,-X-,-,-,-,-.-.-.-,-,-,-,-.-.-.-,-.-.-.-,-.-,-,-.-.-.-.-.-.-,-,-.-,-A-.-,-,-,-,-.-X-------,-X-.-.-,-X-X-------------------------------------
X-.-.-.-.-.-.-.-X-,-X-,-,-.-.-.-.-.-,-E-,-,-X-,-,-,-X-H-.-.-.-.-.-.-.-H-X-,-,-,-X-,-.-.-.-.-.-,-,-,-A-,-,-.-.-,-.-.-.-,-.-,-,-,-,-,-,-,-,-,-,-.-.-.-.-.-.-,-,-.-X-------,-X-.-.-,-.-X-------------------------------------
X-.-.-.-.-.-.-.-X-X-X-.-.-.-.-.-.-.-.-.-.-.-X-X-X-X-X-.-.-.-.-.-.-.-.-.-X-X-X-X-X-.-.-.-.-.-.-,-,-,-,-,-,-.-.-,-.-.-.-,-.-,-.-,-,-,-,-,-,-,-,-,-,-,-.-,-,-,-,-.-X-------,-X-.-.-,-X-X-------------------------------------
X-.-.-.-.-.-.-.-+-.-.-.-.-.-.-.-.-.-.-.-.-.-.-.-.-.-.-.-.-.-.-.-.-.-.-.-.-.-+-.-.-.-.-.-.-.-.-,-.-,-.-,-,-.-.-,-,-.-.-,-,-,-.-,-.-.-.-.-.-,-,-,-,-A-.-,-,-,-,-.-X-------,-X-.-.-.-X---------------------------------------
X-<-<-.-.-.-.-W-+-.-.-.-.-.-.-.-.-.-.-.-.-.-.-.-.-.-.-.-.-.-.-.-.-.-.-.-.-W-+-.-.-.-.-.-.-.-.-A-,-,-,-,-,-A-.-.-,-,-.-,-.-.-.-,-.-,-,-.-.-.-.-.-.-.-.-,-,-.-.-.-X-,-,-,-,-X-.-.-.-X---------------------------------------
X-.-.-.-.-.-.-.-+-.-.-.-.-.-.-.-.-.-.-.-.-.-.-.-.-,-,-.-.-.-.-.-.-.-.-.-.-.-+-.-.-.-.-.-.-.-.-,-,-,-,-,-,-.-.-.-.-E-,-,-+O./.-,-.-,-<-.-,-,-,-.-,-,-,-,-,-,-,-,-X-X-X-X-X-.-.-.-.-X-,-------------------------------------
X-.-.-.-.-.-.-.-X-X-X-,-,-,-.-.-.-,-,-,-,-,-X-X-X-X-X-.-.-.-.-.-.-.-.-,-X-X-X-X-X-,-,-,-,-.-.-.-,-,-,-,-.-.-.-.-.-.-.-.-+O./.-,-.-,-,-,-,-.-,-,-,-.-.-.-.-.-.-.-.-.-.-.-.-.-.-.-.-X-X-------------------------------------
X-<-.-.-.-.-.-.-X-,-X-.-.-,-,-.-.-,-.-E-.-.-X-----,-X-H-,-,-,-,-,-,-,-H-X-----,-X-.-.-.-,-.-.-.-.-.-A-.-.-,-,-,-,-,-.-.-+O./.-,-.-,-H-,-,-,-K-t4,-.-.-.-.-.-.-A-.-.-.-.-.-.-.-.-.-,-X-------------------------------------
X-X-X-X-X-X-X-X-X-,-X-.-.-.-,-,-,-,-.-.-.-.-X-----,-X-X-X-.-.-.-.-.-X-X-X-,-,-,-X-.-.-.-,-,-.-.-.-.-.-.-,-,-.-.-.-,-,-,-+O./.-,-.-,-,-.-,-,-,-.-,-,-,-,-,-,-,-,-.-.-.-.-.-.-.-.-.-X-X-------------------------------------
------------------,-X-,-.-.-.-.-.-.-.-,-,-,-X-------,-X-X-.-.-.-.-.-X-X-X-X-X-X-X-.-.-.-.-,-.-.-.-.-.-,-,-.-.-.-E-.-.-,-.-.-.-,-.-.-.-.-.-.-.-.-.-.-.-.-.-,-,-,-X-X-X-X-X-X-.-.-.-X---------------------------------------
------------------,-X-,-,-,-,-,-,-,-,-,-.-,-X-------,-X-.-.-.-.-.-.-.-X-X-.-.-X-X-.-.-.-.-,-,-.-.-.-.-,-.-.-.-.-.-.-.-,-,-,-.-,-.-,-,-,-,-,-.-,-,-.-,-,-,-,-,-.-X-------,-X-.-.-.-X---------------------------------------
,-,-,-,-,-,-,-,-,-,-X-.-.-.-.-.-A-.-.-.-.-.-X-------,-X-.-.-.-.-.-.-.-+-.-.-.-X-X-.-.-.-.-.-,-.-.-.-,-,-.-.-.-.-.-.-.-,-.-,-.-,-.-,-A-,-,-,-.-,-A-.-,-,-,-,-,-.-X-------,-X-.-.-.-X-,-------------------------------------
X-X-X-X-X-X-X-X-X-X-X-.-.-.-,-,-,-,-.-.-.-.-X-------,-X-.-.-.-.-.-.-.-X-X-.-.-X-X-.-.-.-.-.-,-.-.-.-,-.-.-.-.-.-.-.-.-,-.-,-.-,-.-.-.-.-,-,-,-,-,-.-,-,-.-.-.-.-X-------,-X-.-.-.-X-X-------------------------------------
X-,-,-,-,-,-,-,-,-X-X-X-X-X-X-X-+-X-X-X-X-X-X-----,-,-X-.-.-.-.-.-.-.-X-X-.-.-X-X-.-.-.-.-.-,-.-.-.-,-.-.-.-E-.-.-.-.-,-.-,-.-,-,-,-,-.-,-,-,-,-,-.-,-,-,-,-,-.-X-------,-X-.-.-.-,-X-------------------------------------
X-A-.-.-.-.-.-.-.-X-,-,-,-,-,-X-.-X-,-,-,-,-,-,-,-,-X-,-,-,-.-.-.-.-.-X-X-.-.-X-X-.-.-.-.-.-,-.-.-.-,-.-.-.-.-.-.-.-,-,-.-,-,-,-,-,-,-.-.-.-.-,-,-.-,-,-,-,-,-.-X-----,-,-X-.-.-.-X-X-------------------------------------
X-,-,-.-.-.-,-,-,-X-,-X-X-X-X-X-.-X-X-X-X-X-X-X-X-X-X-,-,-,-,-,-.-.-.-X-X-.-.-X-X-.-.-.-.-.-,-.-.-.-,-,-.-.-.-.-.-.-,-,-.-,-,-.-.-,-,-.-,-,-,-,-,-.-.-.-.-,-,-.-X-----,-X-X-.-.-.-X---------------------------------------
X-.-,-.-.-.-,-.-.-X-,-X-.-.-.-.-.-.-.-.-.-.-.-.-.-,-,-.-.-,-,-,-,-,-.-X-X-.-.-X-X-.-.-.-.-.-,-,-.-.-.-,-.-.-.-.-.-.-,-,-.-,-,-.-,-,-,-.-,-,-,-,-,-.-,-,-,-,-,-.-X-----,-X-X-.-.-.-X---------------------------------------
X-,-,-.-.-.-,-,-,-X-X-X-.-.-.-.-.-.-.-.-.-.-.-.-.-,-,-,-.-.-,-,-.-,-,-X-X-.-.-X-X-.-.-.-.-E-.-,-.-.-.-,-.-.-.-.-.-.-,-,-.-,-,-.-,-,-,-.-,-,-.-,-A-.-,-,-,-,-,-.-X-------,-X-.-.-.-X-,-------------------------------------
X-W-,-<-.-E-,-,-,-,-+-+-.-.-.-.-.-.-.-.-.-.-.-.-.-,-.-,-,-.-.-,-,-,-,-X-X-.-A-X-X-.-.-.-.-.-.-,-.-.-.-,-.-.-.-.-.-.-.-,-.-,-A-.-,-,-.-.-,-,-.-.-.-.-.-,-,-.-.-.-X-------,-X-.-.-.-X-X-------------------------------------
X-.-,-.-.-.-,-.-.-X-X-X-.-.-.-.-.-.-.-.-.-.-.-.-.-,-,-.-,-,-.-.-.-,-X-,-X-.-A-X-X-.-.-.-.-.-.-,-.-.-.-,-.-.-.-.-.-.-.-,-.-,-A-.-,-,-,-,-,-,-,-,-,-,-,-,-,-,-,-.-X-------,-X-.-.-.-,-X-------------------------------------
X-.-,-.-.-.-,-.-.-X-,-X-.-.-.-.-.-.-.-.-.-.-.-.-.-.-,-.-.-,-.-.-.-,-X-,-X-.-E-X-X-.-.-.-X-X-X-X-X-.-.-,-X-X-X-X-X-.-.-,-.-,-,-.-,-,-,-.-.-.-.-.-.-,-,-,-,-,-A-.-X-------,-X-E-.-E-X-X-------------------------------------
X-,-,-.-.-.-,-,-,-X-,-X-.-.-.-.-.-.-.-.-.-.-.-.-.-.-,-,-.-,-,-,-X-X---,-X-.-A-X-X-.-.-.-X-----,-X-.-.-.-X-----,-X-.-.-,-.-,-.-.-.-.-X-X-X-.-.-.-X-X-X-.-.-.-.-.-X-------,-X-.-.-.-X---------------------------------------
X-A-,-,-,-,-,-,-,-X---,-X-.-.-.-.-.-.-.-.-.-.-.-.-.-.-,-.-,-X-X-------,-X-X.X.X.X-X-X-X-X-----,-X-+-+-+-X-----,-X-X-X-X-X-X-X-X-X-X-X-,-XO+O+O+OXO,-X-X-X-X-X-X-X-------,-X-L-L-L-X---------------------------------------
X-.-.-.-.-.-.-.-.-X-----,-X-X-X-.-.-.-X-X-X-X-X-X-X-X-X-X-X-------------------,-X-X-X-X-X-,-,-,-X-.-.-,-X-,-,-,-X-X-X-X-X---------,-,-,-X-.-.-,-X-,-,-------------------,-X-.-.-.-X---------------------------------------
X-X-X-X-X-X-X-X-X-X---------,-X-.-.-.-X---------------------------------------,-X-.-E-.-X-X-X-X-X-.-.-,-X-X-X-X-X-.-E-.-X-------,-,-X-X-X-.-A-,-X-X-X-,---------------,-,-X-,-,-,-X---------------------------------------
----------------------------,-X-.-.-.-X---------------------------------------,-X-.-.-.-,-H-.-.-,-.-.-,-.-,-.-H-.-.-.-.-X-----,-,-X-X-.-.-.-.-,-.-.-X-X-,---------,-,-,-X-X-.-.-.-X-,-------------------------------------
--------------------,-,-,-,-,-X-.-.-.-X-,-,-,-,-------------------------------,-X-.-.-.-,-,-,-,-,-.-.-,-,-,-.-,-.-.-.-.-X-----,-X-,-A-.-.-.-.-,-,-.-A-.-X---------,-X-X-X-.-.-.-.-.-X-,-----------------------------------
--------------------,-X-X-X-X-X-.-.-.-X-X-X-X-X-------------------------------,-X-.-.-.-,-,-,-,-,-.-.-,-,-,-,-,-.-.-.-.-X-----,-X-,-.-.-.-.-.-.-,-,-.-,-X-,-,-,-,-,-X-.-.-.-.-.-.-.-.-X-,---------------------------------
--------------------,-X-A-.-.-.-.-.-.-.-.-.-A-X-------------------------------,-X-.-.-.-.-.-.-.-,-.-H-,-.-.-.-.-.-.-.-.-X-----,-X-,-.-.-.-.-.-.-.-,-,-,-X-X-X-X-X-X-.-.-.-.-.-.-.-.-.-.-X-,-,-----------------------------
--------------------,-X-.-.-.-.-.-.-.-.-.-.-.-X-------------------------------,-X-,-,-,-,-,-,-,-,-.-.-,-,-,-,-,-,-,-,-.-X-----,-X-,-.-.-.-.-.-.-.-.-.-.-.-E-L-.-,-.-.-.-.-,-,-,-,-,-.-.-.-X-X-----------------------------
--------------------,-X-.-.-.-.-.-.-.-.-.-.-.-X-------------------------------,-X-,-,-,-,-,-,-,-,-,-,-,-,-,-,-,-,-,-,-.-X-----,-X-,-,-.-.-.-H-.-.-.-.-.-.-.-L-.-,-.-.-.-,-,~.~,~,~,-.-.-E-.-H-X---------------------------
--------------------,-X-.-.-.-.-.-.-.-.-.-.-.-X-------------------------------,-X-,-,-.-,-,-.-.-.-.-.-.-.-.-,-,-.-,-,-.-X-----,-X-.-,-.-.-.-.-.-.-.-,-,-.-E-L-.-,-.-.-.-,-.~E~,~.~,-,-.-.-.-.-X---------------------------
--------------------,-X-A-,-,-H-.-H-,-H-,-,-A-X-------------------------------,-X-,-A-.-,-,-.-,-,-,-,-,-,-.-,-,-.-,-,-.-X-----,-X-.-,-.-.-.-.-,-,-,-,-,-X-X-X-X-X-X-,-X-,-.~.~,~.-.-,-.-E-.-H-X---------------------------
----------------,-,-,-X-X-X-.-X-X-X-X-X-.-X-X-X-,-,---------------------------,-X-.-.-.-,-,-.-,-A-,-W-,-A-.-,-,-.-,-,-.-X-----,-X-.-,-,-.-.-.-,-.-.-.-.-X-,-X-X-,-X-X-,-X-,~,~,~,-,-X-.-.-.-.-X---------------------------
----------------,-X-X-X-X-X-,-X-X-X-X-X-,-X-X-X-X-X---------------------------,-X-,-,-,-,-,-.-,-,-.-.-,-,-.-,-,-.-,-,-.-X-----,-X-.-A-,-.-.-.-,-.-.-A-.-X-----------,-,-X-.-X-X~X-,-X-X-,-.-,-X---------------------------
----------------,-X-.-,-.-.-.-.-.-.-.-.-.-.-,-.-,-X---------------------------,-X-,-,-,-,-,-.-,-,-.-.-,-,-.-,-,-.-,-,-.-X-----,-X-X-.-,-.-.-.-,-.-.-,-X-X-----------,-X-.-.-X-,-X-.-X-X-,-,-X-----------------------------
----------------,-X-.-,-.-.-.-.-.-.-.-.-.-.-,-.-,-X---------------------------,-X-,-,-.-.-.-.-,-,-,-,-,-,-.-,-,-.-,-,-.-X---------,-X-,-,-,-,-,-.-.-X-------------,-,-X-.-,-X-,-X-.-X-X-.-X-------------------------------
----------------,-X-.-,-.-.-.-.-.-.-.-.-.-.-,-.-,-X---------------------------,-X-,-,-,-,-,-.-,-,-.-E-,-,-.-,-,-.-,-,-.-X---------,-X-X-X-.-.-.-X-X-X-------------,-X-.-<-X-,-X-,-,-X-X-,-X-------------------------------
----------------,-X-.-,-.-.-.-.-.-.-.-.-.-.-,-.-,-X---------------------------,-X-,-,-,-,-,-.-.-,-.-.-,-.-.-,-,-.-,-,-.-X---------,-,-,-X-+-+-+-X-,-,-----------,-,-X-.-.-X-,-X-,-X-,-X-.-X-------------------------------
----------------,-X-.-,-,-,-,-,-,-,-,-,-,-,-,-.-,-X---------------------------,-X-,-,-.-,-,-,-,-,-.-.-,-,-,-,-,-.-,-,-.-X---,-,-,-,-X-X-X-.-,-,-X-X-X-----------,-X-.-.-.-X-,-X-,-.-X-X-,-X-------------------------------
----------------,-X-.-.-.-.-.-.-.-.-.-.-.-.-.-.-,-X---------------------------,-X-,-,-.-,-.-.-.-.-.-.-.-.-.-.-,-.-,-E-.-X---,-X~X~X~.-.-.-.-,-.-,-.-X-----------,-X-.-.-.-X-,-X-.-,-X-,-X---------------------------------
----------------,-X-,-,-,-,-,-,-,-,-,-,-,-,-,-,-,-X---------------------------,-X-,-A-.-,-,-,-,-,-,-,-,-,-,-,-,-.-,-A-.-X-,-,-X~.~,~,-,-.-,-,-,-,-.-X-----------,-X-.-.-.-.-X-,-X-,-.-,-X---------------------------------
----------------,-X-X-X-X-X-X-X-X-X-X-X-X-X-X-X-X-X---------------------------,-X-.-.-.-.-.-.-.-,-,-,-,-.-.-.-.-.-.-.-.-X-,-X-.~E~.~.~,~,-,-,-,~,~,-X-,-----------,-X-.-.-.-.-X-,-X-X-X-,---------------------------------
------------------------------------------------------------------------------,-X-X-X-X-X-X-X-X-X-.-.-,-X-X-X-X-X-X-X-X-X-X-,-,~.~.~.~.~.~.~.~.~,~,-.-X-----------,-X-.-.-.-.-.-X-X-X-X-X-,-------------------------------
------------------------------------------------------------------------------,-X-.-.-.-X-----,-X-.-.-,-X-X-X-.-.-X-,-,-X-.-.-,-.~.~.~.~.~.~.~.~E~,-,-X-,-----------,-X-.-.-.-.-.-.-.-.-.-X-------------------------------
------------------------------------------------------------------------------,-X-.-.-.-X-----,-X-X-.-X-X-X-.-H-.-.-X-.-X-.-.-,-,~,~,~,~,~.~.~.~.~,~,-,-X-,-----------,-X-X-.-.-.-.-.-.-.-X-------------------------------
------------------------------------------------------------------------------,-X-.-.-.-X-------,-X-.-X-X-X-H-H-.-H-,-X-.-H-.-,-X-,~t1t1t1.~.~.~.~,~.-,-,-X---------------,-X-.-.-.-.-.-.-,-X-----------------------------
------------------------------------------------------------------------------,-X-.-.-.-X-------,-X-.-X-X-E-.-E-.-E-.-X-X-,-X-X-X~,~t1.-t1.~.~.~.~,~,-.-X-,-----------------X-.-.-.-.-.-.-.-X-----------------------------
--------------------------------------------------------------------------,-,-,-X-.-.-.-X-,-,-,-,-X-.-X-X-.-.-.-.-.-X-,-,-X-,-X~.~,~t1t1t1.~.~.~,~,~,-,-X-----------------,-,-X-.-.-.-.-.-.-X-----------------------------
----------------------------------------------------------------------,-,-X-X-X-X-.-.-,-X-X-X-X-X-X-.-X-XS.-.-.-.-.-XSX-,-,-,-X~.~.~.~.~.~.~.~,~,~,-,-X-------------------,-X-.-A-.-A-.-.-A-X-----------------------------
------------------------------------------------------------------,-,-X-X-,-,-.-,-.-.-,-.-.-.-.-.-.-.-.-.-.-.-.-.-.-.-X-X-X-X-.~.~.~.~.~.~.~,~,~,-,-,-X-------------------,-X-.-.-.-.-.-.-.-X-----------------------------
----------------------------------------------------------------,-,-X-,-.-,-,-.-,-.-.-,-.-.-.-.-.-.-.-.-.-.-.-.-.-.-.-+-.-.-,-.~.~.~.~.~.~.~,~.-,-,-X---------------------,-X-.-A-.-.-.-.-H-X-----------------------------
----------------------------------------------------------------,-,-X-,-,-,-,-,-,-.-.-,-.-.-.-.-.-.-.-.-.-.-.-.-.-.-.-+-H-.-,-,-.~.~.~.~.~.~,~.-.-,-X---------------------,-X-,-,-.-.-,-,-.-X-----------------------------
----------------------------------------------------------------,-X-,-,-,-,-,-,-,-.-.-,-.-.-.-.-.-.-t1.-.-.-.-.-.-.-.-+-.-.-.-,-.~.~.~.~.~.~,~,-,-X-----------------------,-X-X-X-.-.-,-X-X-X-----------------------------
----------------------------------------------------------------,-X-,-,-,-,-,-,-,-.-.-,-,-.-.-.-.-,-,-,-,-,-,-.-.-.-.-X-X-X-X-,-,-,~.~.~.~E~,~.-,-X---------------------------,-X-,-,-,-X---------------------------------
----------------------------------------------------------------,-X-.-.-.-.-.-X-X-.-.-.-X-X-X-X-X-X-X-,-,-,-X-X-X-X-X-X---,-X-,-,-,-.~.~,~,~,-,-,-X---------------------------,-X->->->-X---------------------------------
----------------------------------------------------------------,-X-.-.-.-.-.-X-X-.-.-.-X---,-,-X-X-X-.-.-.-X---------------,-X-.-,-.~,~,~,~,-.-,-X---------------------------,-X-.-.-.-X---------------------------------
----------------------------------------------------------------,-X-.-E-.-.-E-X-X-.-.-.-X-,-,-X-.-.-.-.-.-.-,-X-------------,-X-,-,-,~,~,~.~,~,-,-X---------------------------,-X-X-X-X-X---------------------------------
----------------------------------------------------------------,-X-.-.-.-.-.-X-X-.-.-.-X-,-X-<-.-.-.-.-.-.-,-X-------------,-X-,-.-,~,~,-.~.~,~X-------------------------------------------------------------------------
----------------------------------------------------------------,-X-.-.-.-.-.-X-X-.-.-.-X-,-X-.-.-.-.-.-,-,-,-X-------------,-X-.-.-,-.-,-,-,~X~--------------------------------------------------------------------------
----------------------------------------------------------------,-X-.-.-.-.-.-X-X-.-.-.-X-,-X-,-,-X-,-,-,-A-.-X-------------,-X-.-.-,-.-.-,-X~----------------------------------------------------------------------------
----------------------------------------------------------------,-X-.-.-.-.-.-X-X-.-.-.-X---,-X-X-,-X-.-.-.-.-X-------------,-X-.-,-,-.-,-X-------------------------------------------------------------------------------
----------------------------------------------------------------,-X-.-.-.-.-.-X-X-.-.-.-X---------,-X-.-W-.-.-X---------------,-X-X-,-X-X---------------------------------------------------------------------------------
----------------------------------------------------------------,-X-X-X-.-X-X-X-X-.-.-.-X-,-,-,-,-,-X-A-,-.-.-X-------------------,-X-------------------------------------------------------------------------------------
----------------------------------------------------------------,-X-X-X-+-X-X-X-X-.-.-.-X-X-,-,-X-X-.-.-,-A-X-,-----------------------------------------------------------------------------------------------------------
----------------------------------------------------------------,-X-.-.-.-.-.-,-.-.-A-.-,-.-X-X-.-.-E-.-.-,-X-------------------------------------------------------------------------------------------------------------
----------------------------------------------------------------,-X-.-.-.-.-.-,-.-E-.-E-,-.-.-.-.-.-.-.-.-,-X-------------------------------------------------------------------------------------------------------------
----------------------------------------------------------------,-X-.-.-.-.-.-,-.-.-.-.-,-.-.-.-.-.-E-.-,-X---------------------------------------------------------------------------------------------------------------
----------------------------------------------------------------,-X-.-.-.-.-.-,-.-.-.-.-,-.-.-.-.-.-.-.-X-----------------------------------------------------------------------------------------------------------------
------------------------------------------------------------------,-X-.-.-.-.-,-.-.-.-.-,-.-.-.-.-.-.-.-X-----------------------------------------------------------------------------------------------------------------
------------------------------------------------------------------,-X-.-.-.-.-,-.-.-.-.-,-.-.-.-.-.-.-.-X-----------------------------------------------------------------------------------------------------------------
------------------------------------------------------------------,-X-.-.-.-,-,-,-.-.-,-,-.-.-.-.-.-E-,-X-----------------------------------------------------------------------------------------------------------------
------------------------------------------------------------------,-X-.-.-.-,-,-,-,-,-,-,-.-.-.-.-,-X-X-------------------------------------------------------------------------------------------------------------------
------------------------------------------------------------------,-X-.-.-.-,-,-,-.-.-,-,-.-.-.-,-X-----------------------------------------------------------------------------------------------------------------------
------------------------------------------------------------------,-X-X-.-.-,-.-,-,-,-,-,-.-.-,-X-------------------------------------------------------------------------------------------------------------------------
----------------------------------------------------------------------,-X-X-X-X-X-X3,3X3X-X-X-X---------------------------------------------------------------------------------------------------------------------------
--------------------------------------------------------------------------------,-X-K-X-----------------------------------------------------------------------------------------------------------------------------------
--------------------------------------------------------------------------------,-X-X-X-----------------------------------------------------------------------------------------------------------------------------------
