--------------------------------------------------------------------------------------------------------,-,-X-X-X-,-,-,-,-,-,---------------,-X-X-X-X-X-X-X5X-X5X-X-------------------------------------------------
--------------------------------------------------------------------------------------------------------,-X-.-A-.-X-X-X?X-X-X---------------,-X-W-E-A-E-E-.5.5.5.5X5------------------------------------------------
--------------------------------------------------------------,-,-,-,-,-,-,-,-,-,-,-,-,-,---------------,-X-.-.-.-+-.-t?.-.-X---------------,-X-A-.-.-.-.-.5.5.5.5X5------------------------------------------------
------------------------------------------------------------,-,-X.X.X.X.X.X-X-X-X-X-X-X-X---------------,-X-E-.-E-X-X-X?X-X-X---------------,-X-.-.-E-.-,-,5,5,5,5X5------------------------------------------------
------------------------------------------------------------,-X-X-<.....,....-.-.-.-E-A-X.--------------,-X-.-.-.-X-------------------------,-X-X-.-.-.-E-.5.5.5.5X5------------------------------------------------
------------------------------------------------------------,-X-<-<.....,...<-.-.-.-E-W-X.--------,-,-,-,-X-L-L-L-X-,-,-------------------------,-X-.-.-,-,-,-,-,-X-------------------------------------------------
------------------------------------------------------------,-X-X-<.....,....-.-.-.-E-A-X.----,-,-X-X-X-X-X-H-.-H-X-X-X-,-,-,-------------------,-X-.-.-.-,-.-.-.-X-------------------------------------------------
--------------------------------------------------------------,-X.X.X.X.X.X-X-X-X-.-.-.-X-,-,-X-X-.-.-.-.-.-.-.-.-.-.-,-X-X-X-,-,-----------------,-X-.-.-,-,-,-,-X-------------------------------------------------
------------------------------------------------------------------------------,-X-.-.-.-X-X-X-.-.-.-.-.-.-.-E-.-E-.-,-,-,-,-X-X-X-,-,---------------,-X-.-,-.-.-.-X-------------------------------------------------
------------------------------------------------------------------------------,-X-.-.-.-X-.-.-.-.-.-.-,-,-,-,-,-,-,-,-,-,-,-,-.-.-X-X-,-,-,-,-,-,-,-,-X-.-,-.-.-E-X-------------------------------------------------
--------------------------------------------,-,-,-,---------------------------,-X-.-.-.-.-.-.-.-.-,-,-,-.-.-.-.-.-.-.-.-,-,-,-,-E-.-.-X-X-X-X-X-X-X-X-X-.-,-.-.-.-X-----,-,-,-,-,-,---------------------------------
--------------------------------------------,->->->---------------------------,-X-.-.-.-.-.-,-,-,-,-,-,-,-,-,-E-,-,-.-.-.-.-.-,-.-.-.-.-.-.-H-+-.-.-.-.-.-,-.-.-.-X-,-,-,-X-X-,-X-X-,-,-,-,-,-----------------------
--------------------------------------,-,-,-,-X-H-X-,-,-,-------------------,-,-X-.-.-.-,-,-,-.-,-,-,-,-.-.-.-A-.-,-,-,-.-.-.-,-,-.-E-.-.-.-.-+-.-.-.-.-.-,-A-.-E-X-,-X-X-X-X-X-X2X-X-XRX-X-X-----------------------
--------------------------------------,-X-X-X-X-.-X-X-X-X-------------------,-X-X-.-.-.-,-.-.-,-,-,-,-.-.-.-.7.7.7.-.-,-,-,-.-.-,-,-.-.-tE.-.-+-.-.-.-.-,-,-A-A-,-X-,-X-.-.-.-.2.-.-.-.-.-.-X-----------------------
----------------------------------,-,-,-X-.-E-.-E-E-E-.-X-----------------,-,-X-,-.-.-,-,-.-,-,-,-.-.-.-.-.-.7.7.7.-.-.-.-,-,-,-.-,-,-.-.-.-.-X-X-X-X-X-X-X-,-,-,-X-,-X-.-.-.-A2.-.-.-.-H-.-X-----------------------
----------------------------------,-X-X-XB.-.-.-.-.-.-.-X---------------,-,-X-,-,-,-,-,-.-,-,-.-.-.-.-.-.-.-.7.7.7.-.-.-.-.-.-,-,-.-,-,-.-E-.-,-X-,-,-,-,-X-,-,-,-X-,-X-.-.-.2.-.-.-.-.-E-H-X-----------------------
----------------------------------,-X-,-tB.-.-.-.-.-.-.-X---------------,-X-X-,-,-,-,-.-,-,-.-.-.-.-.-.-.-.-.7.7.7.-.-.-.-.-.-.-,-,-.-,-,-,-,-,-X-X-X-X-X-X-,-,-,-X-X-X-.-.-.2.-.-.-.-XRX-X-X-----------------------
----------------------------------,-X-X-XB.-,-,C,C,C.-.-X---------------,-X-,-,-,-,-,-,-,-.-.-.-.-.-,-,-,-,7.7.7,7,7,-,-.-.-.-.-.-,-,-.-,-,-.-.-,-.-,-,-.-.-.-.-.-.-+-.-.-.2.-t?.-.-.-X-----------------------------
--------------------------------------,-X-A-,-HCHC,CH-,-X---------------,-X-,-,-,-,-,-,-.-.-.-.-,-,-,~.~.~,~,7,7,7.~.~,~,~,-.-.-.-.-,-.-.-.-.-.-,-,-.-,-.-.-.-.-.-.-+-.-.2.-.4.4.-.-.-X-----------------------------
----------------------------------------,-X-,-.C.C,C,-X-,-,-----------,-,-X-,-,-,-,-,-.-.-.-.-,-,-.~.~.~.~.~.~.~.~.~.~.~.~,~,-.-.-.-,-,-.-.-.-.-.-,-,-,-.-.-.-.-.-.-+-.-.2.-.-.-.-.-.-X-----------------------------
----------------------------------,-,-,-,-,-X-.-.-.-X-X-X-X-,-,-------,-X-,-.-,-,-,-.-.-.-.-.-,-.~.~.~.~.~.~.~.~.~.~.~.~.~.~,~.-.-.-.-,-.-.-E-.-.-,-X-X-X-X0.0.0.0X0X-X2.-.-.-.-.-.-.-X-----------------------------
----------------------------------,-X-X-X-X-X-,-,-,-X-X-,-XAX-X-,-,---,-X-.-.-.-,-,-.-.-.-.-,-,~.~.~.~.~.~.~.~.~.~.~.~.~.~.~,~,~.-.-.-,-,-.-.-.-.-.-X---,-X0.0.0.0X0,-X-.-.-.-.-.-.-<-X-,-,-,-,-,-,-,-,-,-,-,-,-,-,-
----------------------------------,-X-A-E-.-,-E-,-,-E-,-,A,-.-.-X-X-----,-X-X-H-,-,-.-.-.-.-,-.~.~.~.~.~.~.~.~.~.~.~.~.~.~.~.~,~.-.-.-.-,-.-.-.-.-A-X---,-X0.0.0.0X0,-X-.-,-,-,-,-.-.-X-X-X-X-X-X-X-X-X-X-X-X-X-X-X-
----------------------------------,-X-.-E-.-,-,-,-.-,-,A--,-.-.-.-X-,-,-,-,-,-X-X-.-.-.-.-.-,~.~.~.~.~.~.~.~.~.~.~.~.~.~.~.~,~X~X-X-X-X-X-X-X-X-X-X-X-,-,-X0.0.0.0X0,-X-.-,-t3t3t3.-.-X-X-.-.-.-.-.-.-.-.-.-.-.-.-X-
------------------------------,-,-,-X-.-E-.-,-,-.-.-,A,-,-,-.-.-.-X-X-X-X-X-X-X-X-X-.-.-.-.-,~,~.~.~E~.~.~,~,~,~,~,~.~E~.~.~X~X-X-X-X-X-X-X-X-X-X-X-X-X-X-X0,0,0,0X0,-X-.-,-t3.-t3.-,-X-X9t9t9t9t:t:t:t:t;t;t;t<t<X<
------------------------------,-X-X-X-.-.-X-XaX-.-.A.-.-.-.-A-.-.-L-.-.-.-.-.-.-.-.-.-.-.-.-.-,-.~.~.~.~.~,~.-.-,-,-.~.~.~.~X~X-.-.-.-.-.-.-.-.-.-.-.-.-.-.-.-.-.-X-,-,-X-X-X3X-X3X-X-,-X-E-.-E-E-.-E-.-E-E-.-E-.-X-
------------------------------,-X-tB,-.-E-X-,-X-H-.A.-.-.-.-W-.-.-L-.-.-.-.-.-.-.-.-.-tG.-.-.-,-.~.~.~.~.~,~.-K-,-,-A~.~.~.~X~X-A-.-E-.-.-.-.-.-.-H-.-.-.-.-.-.-.-.-X-----------------,-X-.-.-.-.-.-.-.-.-.-.-.-.-X-
------------------------------,-X-X-X-.-.-X-X-X-.-.A.-.-.-.-A-.-.-L-.-.-.-.-.-.-.-.-.-.-.-,-,-,-.~.~.~.~.~,~,-,-,-,-.~.~.~.~X~X-.-.-.-.-.-.-.-.-.-.-.-.-.-.-.-.-.-X-X-----------------,-X-X-X-X-X-X-X-X-X-X-X-X-X-X-
----------------------------------,-X-.-E-,-.-.-.-.-.A.-.-.-.-.-.-X-X-X-X-X-X-X-X-X-.-.-.-,-.~.~.~.~.~.~.~.~.~.~.~.~.~.~.~.~X~X-.-.-.-.-.-.-.-.-X-X-X-.-,-,-,-,-,-X-------------------------------,-X-X-------------
----------------------------------,-X-.-E-,-.-.-.-.-.-.A.-.-.-.-.-X-----,-,-,-,-X-X-.-.-.-,-,~.~.~.~E~.~.~.~.~.~.~.~.~E~.~.~.~X~X-X-L-X-X-X-X-X-X-X-X-X-X-X0.0.0.0X0------------------------------,-X-X-------------
----------------------------------,-X-.-E-,-.-.-.-.-.-.-.A.-.-,-X-X-,-,-,-X-X-X-,-,-.-.-.-.-,-.~.~.~.~.~.~.~.~.~.~.~.~.~.~.~,~,~.-.-.-,-,-.-.-.-.-A-X---,-X0.0.0.0X0------------------------------,-X-X-------------
----------------------------------,-X-X-X-X-X-E-,-,-X-X-.-XAX-X-----,-X-X-.-.-.-.-,-.-.-.-.-,-,~.~.~.~.~.~.~.~.~.~.~.~.~.~.~,~.~.-.-.-,-.-.-.-.-.-,-X---,-X0.0.0.0X0------------------------------,-X-X-------------
------------------------------------------,-X-.-.-.-X-X-X-X-----,-,-,-X-H-.-t3.-.-,-,-.-.-.-.-,-,~.~.~.~.~.~.~.~.~.~.~.~.~,~,~.-.-.-,-,-.-.-.-.-.-X-----,-X0.0.0.0X0,-,-,-,-,-,-,-,-,-,-,-,-,-,-,-,-X-X-------------
--------------------------------------,-,-,-X-,-,-,-X-,-,---,-,-,-X-X-.-.-.-.-.-.-.-,-,-.-.-.-.-,-,~,~.~.~,~,~,~,~.~.~.~,~,~.-.-.-.-,-.-.-.-.-.-.-X-----,-X0,0,0,0X0X-X-X-X-X-X-X-X-X-X-X-X-X-X-X-X-X-X-------------
------------------------------------,-,-X-X-.-.-A-.-.-X-X-,-,-X-X-.-.-.-.-.-.-.-.-.-.-,-,-.-.-.-.-.-,~,~,~,~.1.1,1.~,~,~,~.-.-.-.-,-,-.-.-.-.-.-.-X---,-,-X-.-.-,-X---------------,-,-X-X-X-X-X-X-X-X-X-------------
------------------------------------,-X-.-.-.-.-.-.-.-.-.-X-X-X`.-.-.-.-.-.-.-,-,-,-,-.-,-,-.-.-.-.-.-.-.~.~.1.1,1,~,~.-.-.-.-.-,-,-.-.-.-.-.-.-,-X---,-X-.-.-.-X---------------------------------------------------
----------------------------------,-,-X-.-.-.-.-.-.-.-.-.-.-,-+`+-.-.-.-.-X-,-,-,-,-,-E-.-,-,-.-.-.-.-.-.-.1.1.1.1.1.-.-.-.-.-,-,-.-E-.-.-.-.-.-X-----,-X-.-.-.-X---------------------------------------------------
----------------------------------,-X-.-.-.-.-,-,-.-.-.-.-.-.-,-+`.-,-X-X-X-X-,-,-,-,-,-,-.-,-,-,-.-.-.-.-.-.1E1.1.-.-.-.-,-,-,-.-.-.-.-.-.-.-,-X---,-,-X-.-E-,-X---------------------------------------------------
--------------------------------,-,-X-.-E-,-,-,-,-,-,-.-.-.-.-,-X`X-X-------,-X-,-,-,-,-,-E-.-.-,-,-,-.-.-.-.1.1.1.-.-,-,-,-.-.-.-E-.-.-.-.-,-X-----,-X-.-.-.-X-----,-,-------------,-,-----------------------------
----------------,-,-,-,-,-,-,-,-,-X-.-.-.-,-,-,-,-,-.-,-.-.-.-.-X-----------,-X-X-,-,-,-,-,-,-.-.-.-,-,-,-,-,-,-,-,-,-,-.-.-.-.-.-.-.-.-.-.-X-,-,-,-,-X-.-.-.-X-,-,-X-X-,-,-,-,-,-,-X-X-,---------------------------
----------------,-X-X-X-X-X-X-X-X-X-.-.-.-,-,-.-.-.-,-,-.-.-.-.-X-------------,-X-X-,-,-,-,-,-,-E-.-E-.-.-.-.-.-.-.-.-.-.-E-.-.-.-.-.-.-.-.-.-X-X-,-X-.-.-E-,-X-,-X-.-.-X-X-X-X-X-X-.-.-X---------------------------
----------------,-X-.-.-.-.-.-.-.-.-.-.-.-,-,-,-K-,-,-,-.-.-.-.-X---------------,-X-X-,-,-,-,-,-,-,-.-.-.-E-.-A-E-.-.-E-.-.-.-.-.-.-.-.-.-.-.-+-X-X-.-.-.-.-X---,-X-.-.-.-.-.-.-.-.-.-.-X---------------------------
----------------,-X-X-X-X-X-X-X-X-X-.-.-.-,-,-,-,-.-,-,-.-.-.-,-X-,-,-,-,---------,-X-X-,-,-,-,-.-,-,-.-.-.-.-.-.-.-.-.-.-.-.-.-.-.-,-,-X-.-+-,-,-.-.-E-.-,-X-,-,-X-X-t<.-.-.-.-.-.-.-t9X-,-------------------------
----------------,-X-X-----------,-X-.-.-.-.-,-,-,-,-.-.-.-.-,-,-X-X-X-X-X-------------,-X-,-,-,-,-,-,-,-,-,-,-,-,-,-.-.-.-.-.-.-,-X-X-X-,-X-,-,-.-.-.-.-,-X---,-X-.-.-.-.-.-.-E-.-.-.-.-.-X-------------------------
----------------,-X-X-------------,-X-.-.-.-.-,-,-.-.-.-.-.-,-.-,-.-.-.-X---------------,-X-X-.-,-.-.-.-.-E-.-E-.-E-,-.-.-.-,-X-X---------,-X-.-.-.-.-.-X---,-,-X-H-.-.-.-.-.-.-.-.-.-.-.-X-,-----------------------
----------------,-X-X-------------,-X-,-.-.-.-.-.-.-.-.-,-,-,-,-,-A-.-.-X-------------------,-X-X-X-.-.-.-.-.-.-.-.-,-.-,-X-X-------------,-X-.-.-.-.-.-X-,-,-X-.-.-.-.-.-,-,-,-,-.-.-.-.-.-X-,-,-------------------
,-,-,-,-,-,-,-,-,-X-X-,-,---------,-,-X-<-,-.-.-.-.-,-,-,-,-X-X-.-.-.-.-X-,-,---------------------,-X-X-X-X-+-+-+-X-X-X-X-----------------,-X-.-.-.-.-.-X-X-X-X=.-.-.-.-.-,-.>.>,>.-.-.-.-.-X-X-X-------------------
X-X-X-X-X-X-X-X-X-X-X-X-X---------,-.-X-.-,-,-.-E-,-,-.-.-.-.-X-X-.-.-.-X-X-X-,-,-,-,-,-,-,-,-,-,-,-,-,-,-X-+-+-+-X-,-,-,-,-,-,-----------,-X-.-.-.-.-.-+-+].-.=.-.-.-.-.-,-.>K-,>.-E-.-.-.-.-H-X-------------------
X-.-.-.-.-.-.-.-.-.-.-.-X---------,-X-H-.-.-X-X-X-X-X-.-.-H-.-X-X-.-.-.-X-X-.-X-X-X-X-X-X-X-X-X-X-X-X-X-X-X-,-,-,-X-X-X-X-X-X-X-,---------,-X-.-.-.-.-.-X-X]X-X=.-.-.-.-.-,-,>,>,>.-.-.-.-.-,-,-X-------------------
X-E-.-E-.-E-.-E-.-E-.-E-X---------,-X-.-.-X-,-----,-X-.-A-.-.-X-X-.-.-.-.-.-E-,-.-,-,-,-,-,-,-,-.-.-.-,-.-,-.-.-,-.-.-.-.-.-.-X-X-----,-,-,-X-.-.-.-.-,-X-,-,-X-.-.-.-.-.-.-.-.-.-.-.-.-.-.-X-X---------------------
X-,-,-,-,-,-,-,-,-,-,-,-X---------,-X-X-,-X---------,-X-X-.-,-X-X-.-.-.-.-.-.-,-.-,-,-,-,-,-,-,-.-.-.-,-.-,-,-,-,-.-.-.-.-.-.-,-X-----,-X-X-X-.-.-<-.-,-X-X-X-X-.-.-.-.-.-.-.-.-.-.-.-.-.-X-,-----------------------
X-,-,-,-,-,-,-,-,-,-,-,-X-----------,-,-X---------------,-X-X-,-X-.-.-.-.-.-.-,-.-,-,-,-,-,-,-,-.-.-.-,-.-.-.-.-.-.-.-.-.-.-.-H-X-----,-X-H-,-.-.-.-.-,-.-H-X-,-X-H-.-.-.-.-.-E-.-.-.-.-.-X-------------------------
XGtGtGtGtGtGtGtGtGtGtGtGXG------------------------------------,-X-.-.-.-.-.-E-,-.-,-,-,-,-,-,-,-.-.-.-,-.-.-.-.-.-.-.-.-.-.-.-,-X-----,-X-.-,-.-.-.-.-,-.-E-X---X-.-.-t;.-.-.-.-.-.-.-t:X-,-------------------------
X-.-.-.-.-.-.-.-.-.-.-.-X-------------------------------------,-X-H-.-.-.-.-.-,-.-,-,-,-,-,-,-,-.-.-.-,-.-.-.-.-.-.-.-.-.-.-.-X-X-----,-X-E-,-,-,-,-,-,-.-,-X---,-X-X-.-.-.-.-.-.-.-.-.-X---------------------------
X-.-.-.-.-.-.-.-.-.-.-.-X-------------------------------------,-X-X-X-X-X-X-,-X-X-X-X-X-X-X-X-X-.-.-.-X-X-X-X-X-X-.-.-.-.-.-.-X-,-----,-X-.-.-.-.-.-.-.-.-E-X---,-.-X-.-.-.-.-.-.-.-.-.-X---------------------------
X-X-X-X-X-X-X-X-X-X-X-X-X-----------------------------------------------,-X-X---------------,-X-.-.-.-X-------,-X-.-.-.-.-.-E-X-X-----,-X-.-,-,-E-,-E-,-,-,-X---,-X-X-,-X-X^.-.-.-X^X-,-X---------------------------
--------------------------------------------------------------------------------------------,-X-.-.-.-X-------,-X-.-.-.-.-.-.-,-X-----,-X-+-+-.-X-X-X-.-X-X-X-----,-,-X-,-X-A-H-A-X-,-X-----------------------------
----------------------------------------------------------------------,-,-,-,-,-,-----------,-X-.-.-.-X-------,-X-.-.-.-.-.-.-,-X-----,-X-+-X-X-X-,-X-X-X---------------,-X-X=X=X=X---------------------------------
----------------------------------------------------------------------,-X-X-X-X-X-----------,-X-.-.-.-X-------,-X-.-E-.-E-.-.-<-X-----,-X-.-X-----------------------------------------------------------------------
--------------------------------------------------------------------,-,-X-.-.-.-X-,-------,-,-X-.-.-,-X-------,-X-.-.-.-.-.-.-X-X-----,-X-.-X-----------------------------------------------------------------------
--------------------------------------------------------------------,-X-X-,-,-,-X-X-----,-,-X-.-.-.-X---------,-X-.-.-.-H-.-.-X-------,-X-.-X-----------------------------------------------------------------------
------------------------------------------------------------------,-,-X-.-.-.-.-.-X-,-,-,-X-.-.-.-.-X-----------,-X-X-X-X-X-X-X-------,-X-X-X-----------------------------------------------------------------------
--------------------------------------------------------------,-,-,-,-X-.-E-.-.-.-X-X-X-X-.-.-.-.-,-X---------------------------------------------------------------------------------------------------------------
--------------------------------------------------------------,-X-X-XE.-.-.-.-.-.-,-.-.-.-.-.-.-,-X-----------------------------------------------------------------------------------------------------------------
--------------------------------------------------------------,-X-.-tE.-E-.-H-H-.-,-.-.-.-.-,-X-X-------------------------------------------------------------------------------------------------------------------
--------------------------------------------------------------,-X-X-XE.-E-.-.-.-.-,-.-.-,-X-X-----------------------------------------------------------------------------------------------------------------------
--------------------------------------------------------------------X-.-.-.-E-.-.-X-X-X-X---------------------------------------------------------------------------------------------------------------------------
--------------------------------------------------------------------,-X-.-.-.-.-.-X---------------------------------------------------------------------------------------------------------------------------------
--------------------------------------------------------------------,-X-X-X-X-X-X-X---------------------------------------------------------------------------------------------------------------------------------
