X-X-X-X-X-X-X-X-X-X-X-,-,-,-,-,-X-X-X-X-X-X-,-,-,-,-,-,-,-,-,-,-,-,---------------------------------------------------------------------------------------------------------------
X-.-.-.-.-.-.-.-.-.-X-X-X0X0X0X-X-.-.-.-.-.-X-X-X-X-X-X-X-X-X-X-X-X-,-,-,-,-,-,-,-,-,-,-,-----------------------------------------------------------------------------------------
X-.-.-.-.-.-.-.-.-.-X-X-.-A-.-X-X-.-.-.-.-.-.-.-.-.-.-.-.-.-.-.-.-.-X-X-X-X-X-X-X-X-X-X-X-,-,-,-,-,-,-,-,-,-,-,-------------------------------------------------------------------
X-.-.-.-.-.-.-.-.-.-X-X-.-W-.-X-X-.-.-.-.-.-.-.-.-.-.-.-.-.-.-.-.-.-.-.-.-.-.-.-.-.-.-.-.-X-X-X-X-X-X-X-X-X-X-X-,-,-,-,-,-,-,-,-,-,-,-,-------------------------------------------
X-.-.-.-,-,-,-,-,-.-X-X-.-.-.-X-X-,-,-,-,-,-.-.-.-.-.-.-.-.-.-.-.-.-.-.-.-.-.-.-.-.-.-.-.-.-.-.-.-.-.-.-.-.-.-.-X-X-X-X-X-X-X-X-X-X-X-X-,-,-,-,-,-,-------------------------------
X-.-.-.-,-.-.-.-X-X-X-X-XN.-XNX-X-X-X-.-.-,-.-.-.-.-.-.-.-.-.-.-.-.-.-.-.-.-.-.-.-.-.-.-.-.-.-.-.-.-.-.-.-.-.-.-.-X-X-X-X-X-X-X-X-X-X-X-X-X-X-X-X-X-------------------------------
X-.-.-.-,-.-:-,-X-X-X-X-X-.-X-X-X-X-X-:-.-,-.-.-.-.-.-.-.-.-.-.-.-.-.-.-.-.-.-.-.-.-.-.-.-.-.-.-.-.-.-.-.-.-.-.-.-X---,-X-,-:-X-X-,-X-,-:-X-X-------------------------------------
X-.-.-.-,-.-,-.-.-.-.-.-.-.-.-.-.-.-.-,-.-,-.-.-.-.-.-.-.-.-.-,-,-,-,-,-,-.-.-,-,-,-,-,-,-.-.-,-,-,-,-,-,-.-.-.-.-X-,-,-X-.-.-.-X-,-X-.-.-.-X-,-,---------------------------------
X-.-.-.-,-X-X-.-<-.-.-.-.-.-.-.-.-.-<-,-X-X-.-.-.-.-.-.-.-.-X-X-X-,-,-,-X-X-X-X-X-,-,-,-X-X-X-X-X-,-,-,-X-X-X-X-X-X-X-X-X-.-.-.-X-X-X-.-.-.-X-X-X---------------------------------
X-.-.-.-.-X-X-.-.-.-.-,-,-,-,-.-.-.-.-.-X-X-.-,-,-,-,-.-.-.-X-,-X-.-.-.-X-X-,-X-X-:-.-.-X-X-,-X-X-:-.-.-X-X-----,-X-,-.-.-.-.-.-.-.-.-.-.-.-.-,-X---------------------------------
X-X-X-X-X-X-X-.-.-.-,-,-.-.-,-,-.-.-.-.-X-X-X-X-X-X-X-X-X-X-X-,-X-.-.-:-.-X-X-X-.-.-.-.-.-X-X-X-.-.-.-:-.-X-,-,-,-X-,-.-.-.-A-.-.-W-.-.-A-.-.-:-X---------------------------------
,-X-X-X-X-X-X-.-.-.-,-H-.-.-.-H-,-.-.-.-X-X-X-XPX-.-XOXOX-X-X-X-.-.-.-.-.-.-.-.-.-.-.-.-.-.-.-.-.-.-.-.-.-X-X-X-X-X-X-.-.-.-.-,-,-:-,-.-.-.-.-,-X---------------------------------
,-X..-.-.-X-X-.-.-.-,-.-,-,-,-,-,-.-.-.-X-X-.-+P.-.-+O+O.-+-.-.-.-.-.-.-.-.-.-.-.-.-.-.-.-.-.-.-.-.-.-.-.-.-,-,-.-.-.-.-.-.-.-,-t2t2t2.-.-.-X-X-X---------------------------------
,-X..-W-.-+-.-.-<-.-,-.-,-,-,-,-,-.-.-.-.-+-.-+P.-H-+O+O.-+-.-.-.-.-.-.-.-.-.-.-.-.-.-.-.-.-.-.-.-.-.-.-E-.-,-,-.-.-.-H-.-.-W-:-t2.-t2.-W-.-X-,-,---------------------------------
,-X..-.-.-X-X-.-.-.-,-.-.-.-.-,-,-.-.-.-X-X-.-+P.-.-+O+O.-+-.-.-.-.-.-.-.-.-.-.-.-.-.-.-.-.-.-.-.-.-.-.-.-.-,-,-.-,-,-.-.-.-.-,-t2t2t2.-.-.-X-X-X---------------------------------
,-X-X-X-X-X-X-.-.-.-,-H-.-.-,-H-.-.-.-.-X-X-X-XPX-X-XOXOX-X-X-X-.-.-.-.-.-:-X-,-.-.-.-.-.-,-X-,-.-.-.-.-.-X-X-X-X-X-X-.-.-.-.-.-.-.-.-.-.-.-.-,-X---------------------------------
X-X-X-X-X-X-X-.-.-.-.-,-,-,-,-.-.-.-.-.-X-X-X-X-X-X-X-X-X-X-X-X-,-,-,-,-,-X-,-X-:-,-,-:-,-X-,-X-,-,-:-,-,-X-----,-X-,-.-.-.-A-.-.-W-.-.-A-.-.-:-X---------------------------------
X-.-.-.-,-X-X-.-.-.-.-.-.-.-.-.-.-.-.-,-X-X-.-.-.-.-.-.-.-.-X-,-X-.-.-.-X-X-,-X-X-.-.-.-X-X-,-X-X-.-.-.-X-X-,-,-,-X-,-.-.-.-.-.-.-.-.-.-.-.-.-,-X---------------------------------
X-.-.-.-,-X-X-.-<-.-.-.-.-.-.-.-.-.-<-,-X-X-.-.-.-.-.-.-.-.-X-X-X-,-,-,-X-X-X-X-X-,-,-,-X-X-X-X-X-,-,-,-X-X-X-X-X-X-X-X-X-.-.-.-X-X-X-.-.-.-X-X-X---------------------------------
X-.-.-.-,-.-:-,-,-.-.-.-.-.-.-.-.-,-,-:-.-,-.-.-.-.-.-.-.-.-.-.-.-.-.-.-.-.-.-.-.-.-.-.-.-.-.-.-.-.-.-.-.-.-.-.-.-X---,-X-,-:-,-X-,-X-,-:-,-X-------------------------------------
X-.-.-.-,-.-.-.-X-X-X-X-X-.-X-X-X-X-X-.-.-,-.-.-.-.-.-.-.-.-.-.-.-.-.-.-.-.-.-.-.-.-.-.-.-.-.-.-.-.-.-.-.-.-.-.-.-X-,-,-X-X-X-X-X-,-X-X-X-X-X-,-,-,-------------------------------
X-.-.-.-,-,-,-,-X-X-X-X-XN.-XNX-X-X-X-,-,-,-.-.-.-.-.-.-.-.-.-.-.-.-.-.-.-.-.-.-.-.-.-.-.-.-.-.-.-.-.-.-.-.-.-.-.-X-X-X-X-X-X-X-X-X-X-X-X-X-X-X-X-X-------------------------------
X-.-.-.-.-.-.-.-.-.-X-X-.-.-.-X-X-.-.-.-.-.-.-.-.-.-.-.-.-.-.-.-.-.-.-.-.-.-.-.-.-.-.-.-.-.-.-.-.-.-.-.-.-.-.-,-X-X-X-X-X-X-X-X-X-X-X-X-------------------------------------------
X-.-.-.-.-.-.-.-.-.-X-X-.-W-.-X-X-.-.-.-.-.-.-.-.-.-.-.-.-.-.-.-.-.-.-.-.-.-.-.-.-.-.-.-,-X-X-X-X-X-X-X-X-X-X-X-------------------------------------------------------------------
X-.-.-.-.-.-.-.-.-.-X-X-.-A-.-X-X-.-.-.-.-.-.-.-.-.-.-.-.-.-.-.-.-,-X-X-X-X-X-X-X-X-X-X-X-----------------------------------------------------------------------------------------
X-.-.-.-,-,-X-X-X-X-X-X-X/X/X/X-X-.-.-.-.-,-X-X-X-X-X-X-X-X-X-X-X-X---------------------------------------------------------------------------------------------------------------
X-X-X-X-X-X-------------------,-X-X-X-X-X-X---------------------------------------------------------------------------------------------------------------------------------------
----------------------------------------------------------------------------------------------------------------------------------------------------------------------------------
----------------------------------------------------------------------------------------------------------------------------------------------------------------------------------
----------------------------------------------------------------------------------------------------------------------------------------------------------------------------------
----------------------------------------------------------------------------------------------------------------------------------------------------------------------------------
----------------------------------------------------------------------------------------------------------------------------------------------------------------------------------
----------------------------------------------------------------------------------------------------------------------------------------------------------------------------------
----------------------------------------------------------------------------------------------------------------------------------------------------------------------------------
----------------------------------------------------------------------------------------------------------------------------------------------------------------------------------
----------------------------------------------------------------------------------------------------------------------------------------------------------------------------------
----------------------------------------------------------------------------------------------------------------------------------------------------------------------------------
----------------------------------------------------------------------------------------------------------------------------------------------------------------------------------
----------------------------------------------------------------------------------------------------------------------------------------------------------------------------------
----------------------------------------------------------------------------------------------------------------------------------------------------------------------------------
----------------------------------------------------------------------------------------------------------------------------------------------------------------------------------
----------------------------------------------------------------------------------------------------------------------------------------------------------------------------------
----------------------------------------------------------------------------------------------------------------------------------------------------------------------------------
----------------------------------------------------------------------------------------------------------------------------------------------------------------------------------
----------------------------------------------------------------------------------------------------------------------------------------------------------------------------------
----------------------------------------------------------------------------------------------------------------------------------------------------------------------------------
----------------------------------------------------------------------------------------------------------------------------------------------------------------------------------
----------------------------------------------------------------------------------------------------------------------------------------------------------------------------------
----------------------------------------------------------------------------------------------------------------------------------------------------------------------------------
----------------------------------------------------------------------------------------------------------------------------------------------------------------------------------
----------------------------------------------------------------------------------------------------------------------------------------------------------------------------------
------------------------------------------------------------------------------,-,-,-,-,-,-,-,-,-,-,-,-,-,-,-,-,-,-,-,-,-,-,-,-,-,-,-,-,-,-,-,-,-,-,-,-,-,-,-,---------------------
----------------------------------------------------------------------------,-,-X-X-X-X-X-X-X-,-X-X-X-X-X-,-X-X-X-X-X-X-X-X-X-X-X-X-X-,-X-X-X-X-X-,-X-X-X-X-X---------------------
--------------------------------------------------------------------------,-,-X-.-.-.-.-.-.-X-X-X-.-.-.-X-X-X-.-.-.-.-.-.-.-.-.-.-.-X-X-X-.-.-.-X-X-X-.-.-A-X---------------------
------------------------------------------------------------------------,-,-X-.-.-.-.-.-.-.-.-.-.-.-.-.-.-.-.-.-.-.-.-.-.-.-.-.-.-.-.-.-.-.-.-.-.-.-.-.-.-.-X8--------------------
----------------------------------------------------------------------,-,-X-.-.-.-.-.-.-.-.-.-.-.-.-.-.-.-.-.-.-.-.-.-.-.-.-.-.-.-.-.-.-.-.-.-.-.-.-.-<-.-A-X8--------------------
----------------------------------------------------------------------,-X-.-.-.-.-.-.-.-.-.-.-.-.-.-.-.-.-.-.-.-.-.-.-.-.-.-.-.-.-.-.-.-.-.-.-.-.-.-.-.-.-.-X8--------------------
----------------------------------------------------------------------,-X-.-.-.-.-.-.-.-.-.-.-.-.-.-.-.-.-.-.-.-.-.-.-.-.-.-.-.-.-.-.-,-,-,-,-,-.-.-.-.-.-A-X---------------------
----------------------------------------------------------------------,-X-.-.-.-.-.-X-X-X-X-X-X-X-,-,-,-X-X-X-,-,-,-,-,-,-,-,-,-,-,-X-X-X-.-.-,-X-X-X-X-X-X-X---------------------
----------------------------------------------------------------------,-X-.-.-.-.-.-X-,-,-,-,-,-X-.-.-,-X-,-X-.-.-.-.-.-.-.-.-.-.-,-X7X7X7.-.-.-X-,-,-,-,-------------------------
----------------------------------------------------------------------,-X-.-.-.-.-.-X-,-X-X-X-X-X-.-.-,-X-X-X-.-.-.-.-.-:-.-.-.-.-,-XY,-XY.-.-.-X-X-X-X-X-------------------------
----------------------------------------------------------------------,-X-.-.-.-.-.-X-,-X-.-.-.-.-.-.-,-.-.-.-.-.-.-.-.-.-.-.-.-.-.-.-.-,-.-.-.-.-.-.-.-X-,-,---------------------
----------------------------------------------------------------------,-X-X-.-.-.-.-X-,-X-.-.-.-.-.-.-,-.-.-.-.-.-.-.-.-.-.-.-.-.-.-.-.-,-.-.-.-.-.-.-.-X-X~X~--------------------
----------------------------------------------------------------------,-,-X-.-.-.-.-X-,-X-.-.-.-.-.-.-,-.-.-.-.-.-.-.-.-.-.-.-.-.-.-.-.-,-.-.-.-.-.-.-.-,-.~X---------------------
----------------------------------------------------------------------,-X5X-.-.-.-.-X-X-X-.-.-.-.-.-.-,-.-.-.-.-.-.-.-.-.-.-.-.-.-.-.-.-,-.-.-.-.-.-.-.-,-.~X---------------------
----------------------------------------------------------------------,-X5.5.5.5.5.5,5.-.-.-.-.-.-.-.-,-.-.-.-.-.-.-.-.-.-.-.-.-.-.-.-.-,-.-.-.-.-.-.-.-,-,~X---------------------
----------------------------------------------------------------------,-X5E5.5.5.5.5,5.-.-.-.-.-.-.-.-,-.-.-.-.-.-.-.-.-.-.-.-.-.-.-.-.-,-.-.-.-.-.-.-.-,-X~,---------------------
----------------------------------------------------------------------,-X5.5.5.5.5.5,5.-,-,-,-,-,-.-.-,-.-.-.-.-.-.-.-.-.-.-.-.-.-.-.-.-,-.-.-.-.-.-.-.-,-X~----------------------
----------------------------------------------------------------------,-X5X-.-.-.-.-X-X-X-.-.-.-,-,-,-,-.-.-.-.-.-.-.-.-.-.-.-.-.-.-.-.-,-,-.-.-.-.-.-,-,-X~----------------------
----------------------------------------------------------------------,-,-X-.-.-.-.-X-,-X-.-.-.-.-.-,-,-.-.-.-.-.-.-.-.-.-.-.-.-.-.-.-.-.-,-,-,-.-,-,-,-,-X~----------------------
----------------------------------------------------------------------,-X-X-.-.-.-.-X-,-X-,-,-,-,-,-.-,-.-.-.-.-.-.-.-.-.-.-.-.-.-.-.-.-.-.-.-,-,-,-,-,~.~X~----------------------
------------------------------------------------------------------,-,-,-X-,-,-,-,-,-X-,-X-,-,-,-.-,-.-,-.-.-.-.-.-.-.-.-.-.-.-.-.-.-.-.-.-.-.-.-,-.-,-,~,~X~----------------------
------------------------------------------------------------------,-X-X-X6.6.6.6.6.6X6X-X---A-,-.-,-.-,-.-.-.-.-.-.-.-.-.-.-.-.-.-.-.-.-.-.-.-.-,-.-,-.~.~X~,-,-,-,-,-,-,-,-,-,-,-
------------------------------------------------------------------,-X-H-.6.6.6.6.6.6.6.-,-----,-.-,-.-,-.-.-.-.-.-.-.-.-.-.-.-.-.-.-.-.-.-.-.-.-,-.-,-.~E~X~X-X-X-X-X-X-X-X-X-X-X-
------------------------------------------------------------------,-X-A-.6.6.6.6.6.6.6<-,-E---,-A-,-<-,-.-.-.-.-.-.-.-.-.-.-.-.-.-.-.-.-.-.-<-.-,-E-,-.~E~,~.-.-E-.-E-E-,-.-.-.-X-
------------------------------------------------------------------,-X-H-.6.6.6.6.6.6.6.-,-,-A-,-.-,-.-,-.-.-.-.-.-.-.-.-.-.-.-.-.-.-.-.-.-.-.-.-,-.-,-.~E~X~X-X-X-X-X-X-X-X-X-X-X-
------------------------------------------------------------------,-X-X-X6,6,6,6,6,6X6X-X-.-.-.-.-,-.-,-.-.-.-.-.-.-.-.-.-.-.-.-.-.-.-.-.-.-.-.-,-.-,-,~,~X~----------------------
----------------------------------------------------------------------,-X-.-.-.-.-.-X-,-X-,-,-,-,-,-,-,-.-.-.-.-.-.-.-.-.-.-.-.-.-.-.-.-.-.-.-,-,-,-,-,~.~X~----------------------
----------------------------------------------------------------------,-X-X-.-.-.-.-X-,-X-.-.-.-.-.-,-,-.-.-.-.-.-.-.-.-.-.-.-.-.-.-.-.-.-,-:-,-.-,-,-,-,~X~----------------------
----------------------------------------------------------------------,-,-X-.-.-.-.-X-,-X-.-.-.-.-,-,-,-.-.-.-.-.-.-.-.-.-.-.-.-.-.-.-.-,-,-.-.-.-.-.-,-,-X~----------------------
----------------------------------------------------------------------,-X5X-.-.-.-.-X-X-X-,-,-,-,-,-.-,-.-.-.-.-.-.-.-.-.-.-.-.-.-.-.-.-,-.-.-.-.-.-.-.-,-X~----------------------
----------------------------------------------------------------------,-X5.5.5.5.5.5,5.-.-.-.-.-.-.-.-,-.-.-.-.-.-.-.-.-.-.-.-.-.-.-.-.-,-.-.-.-.-.-.-.-,-X~,---------------------
----------------------------------------------------------------------,-X5E5.5.5.5.5,5.-.-.-.-.-.-.-.-,-.-.-.-.-.-.-.-.-.-.-.-.-.-.-.-.-,-.-.-.-.-.-.-.-,-.~X---------------------
----------------------------------------------------------------------,-X5.5.5.5.5.5,5.-.-.-.-.-.-.-.-,-.-.-.-.-.-.-.-.-.-.-.-.-.-.-.-.-,-.-.-.-.-.-.-.-,-.~X---------------------
----------------------------------------------------------------------,-X5X-.-.-.-.-X-X-X-.-.-.-.-.-.-,-.-.-.-.-.-.-.-.-.-.-.-.-.-.-.-.-,-.-.-.-.-.-.-.-,-.~X---------------------
----------------------------------------------------------------------,-,-X-.-.-.-.-X-,-X-.-.-.-.-.-.-,-.-.-.-.-.-.-.-.-.-.-.-.-:-.-.-.-,-.-.-.-.-.-.-.-,-.~X---------------------
----------------------------------------------------------------------,-X-X-.-.-.-.-X-,-X-.-.-.-.-.-.-,-.-.-.-.-.-.-.-.-.-.-.-.-:-.-.-.-,-.-.-.-.-.-.-.-X-X~X~--------------------
----------------------------------------------------------------------,-X-.-.-.-.-.-X-,-X-.-.-.-.-.-.-,-.-.-.-.-.-.-.-.-.-.-.-.-.-,-,-,-,-.-.-.-.-.-.-:-X-------------------------
----------------------------------------------------------------------,-X-.-.-.-.-.-X-,-X-X-X-X-X-.-.-,-X-X-X-.-.-.-.-.-.-.-.-.-.-,-XXX-XX.-.-.-X-X-X-X-X-------------------------
----------------------------------------------------------------------,-X-.-.-.-.-.-X-,-,-,-,-,-X-,-,-,-X-,-X-.-.-.-.-.-.-.-.-.-.-.-X-,-X-.-.-,-X-,-,-,-,-,-,---------------------
----------------------------------------------------------------------,-X-.-.-.-.-.-.-X-X-X-X-X-X-.-.-.-X-X-X-,-,-,-,-,-,-,-,-,-,-,-X-X-X-,-,-,-X-X-X-X-X-X-X---------------------
----------------------------------------------------------------------,-X-.-.-.-.-.-.-.-.-.-.-.-.-.-.-.-.-.-.-.-.-.-.-.-.-.-.-.-.-.-.-.-.-.-.-.-.-.-.-.-.-A-X---------------------
----------------------------------------------------------------------,-X-.-.-.-.-.-.-.-.-.-.-.-.-.-.-.-.-.-.-.-.-.-.-.-.-.-.-.-.-.-.-.-.-.-.-.-.-.-.-.-.-.-X9--------------------
------------------------------------------------------------------------,-X-.-.-.-.-.-.-.-.-.-.-.-.-.-.-.-.-.-.-.-.-.-.-.-.-.-.-.-.-.-.-.-.-.-.-.-.-.-<-.-A-X9--------------------
--------------------------------------------------------------------------,-X-X-.-.-.-.-.-.-.-.-.-.-.-.-.-.-.-.-.-.-.-.-.-.-.-.-.-.-.-.-.-.-.-.-.-.-.-.-.-.-X9--------------------
------------------------------------------------------------------------------,-X-X-.-.-.-.-X-X-X-.-.-.-X-X-X-.-.-.-.-.-:-.-.-.-.-.-X-X-X-.-.-.-X-X-X-.-.-A-X---------------------
----------------------------------------------------------------------------------,-X-X-X-X-X-,-X-X-X-X-X-,-X-X-X-X-X-X-X-X-X-X-X-X-X-,-X-X-X-X-X-,-X-X-X-X-X---------------------
