--------------------------------------------------------------------------------------------,-X-X-X---------------------------------------------------------------------
--------------------------------------------------------------------------------------------,-X-,-X---------------------------------------------------------------------
------------------------------------------------------------------------------------,-,-,-,-,-X<t<X<,-,-,-,-------------------------------------------------------------
----------------------------------------------------------------------------------,-,-X-X-X-X-X-+-X-X-X-X-X-,-----------------------------------------------------------
--------------------------------------------------------------------------------,-,-X-.-.-.-,-.-,-,-.-.-.-.-X-,-,-,-,-,-,-,-,-,-,-,-,-,-,-,-,-,-,-,---------------------
--------------------------------------------------------------------------------,-X-.-.-.-.-,-,-,-,-.-.-.-.-.-X-,-X-X-X-X-X-X-X-X-X-X-X-X-X-X-X-X-X---------------------
--------------------------------------------------------------------------------,-X-.-.-.-,-,-,-,-,-,-.-.-.-.-X-,-X-H-,-.-.-.-.-.-.-.-.-.-.-<-.-.-X---------------------
--------------------------------------------------------------------------------,-X-.-.-,-,-.->->-.-,-.-.-.-.-X-,-X-,-,-.-.-.-.-.-.-.-.-.-.-,-,-,-X---------------------
--------------------------------------------------------------------------------,-X-,-,-,-.-.-.-H-.-,-,-,-,-.-X-,-X-.-.-.-.-.-.:.:E-.-.-.-.-.-.-.-X---------------------
--------------------------------------------------------------------------------,-X-.-,-,-.-.-.-.-.-.-,-.-,-.-X-,-X-.-.-.-.-.-.-.-.-.-.-.-.-.-.-.-X---------------------
--------------------------------------------------------------------------------,-X-.-.-,-.-.-.-E-.-.-,-.-,-.-X-,-X-.-.-.-.-.-.-.-H-.-.-.-.-E-.-.-X-,-,-,---------------
--------------------------------------------------------------------------------,-X-,-,-,-.-.-.-.-.-,-,-,-,-.-X-,-X-.-.-.-.-.-.-.-H-.-.-.-.-.-.-.-XZX-X-X---------------
--------------------------------------------------------------------------------,-X-.-.-,-.-.-.-.-.-,-.-.-.-.-X-,-X-.-.-.-.-.-.-.-.-.-.-.-.-.-.-.-.-.-.-X-,-,-,-,-,-,-,-
--------------------------------------------------------------------------------,-X-.-.-,-,-,-,-,-,-,-.-.-.-.-X-,-X-.-.-.-.-.-.-.-H-.-.-.-.-.-.-.-XZX-X-X-,-X-X-X-X-X-X-
--------------------------------------------------------------------------------,-X-.-.-.-.-.-.-.-.-.-.-.-.-.-X-,-X-,-,-.-.-.-.-.-.-.-.-.-.-,-,-,-X-------,-X-.-.-.-.-X-
----------------------------------------------------------------------,-,-,-,---,-X-.-.-.-.-.-.-.-.-.-.-.-.-,-X-,-X-.-,-.-.-.-.-.-.-.-.-.-.-,-.-.-X-------,-X-.-.-.-.-X-
----------------------------------------------------------------------,-X-X-X-,---,-X-.-.-.-.-.-<-.-.-,-,-,-X-,-,-X-.-,-.-.-.-.-,-,-E-,-,-,-E-,-.-X-------,-X-.-.-.-.-X-
----------------------------------------------------------------------,-X-.-.-X-,-,-,-X-X-X-X-.-.-.-X-X-X-X-X-X-,-X-X-X-X-X-.-X-X-X-.-X-X-X-.-X-X-X-,-,-,-,-X-.-.-.-.-X-
----------------------------------------------------------------------,-X-.-.-E-X-X-X-X-X-X-X-+-+-+-X-X-X-.-A-,-X-X-X-X-X-X-+-X-X-X-,-X-X-X-,-X-X-X-X-X-X-X-X-.-.-.-.-X-
----------------------------------------------------------------------,-X-.-.-,-X-X-.-.-.-.-.-.-.-.-,-X-X-.-t<,-X-.-.-,-.-,-A-,-,-,-,-,-,-.-.-.-.-.-.-.-H-,-,-.-.-.-.-X-
----------------------------------------------------------------------,-X-.-.-E-.-,-.-.-.-.-.-.-.-.-.-,-,-,-,-,-,-.-.-,-.-.-.-.-,-.-.-.-.-.-.-.-.-.-.-.-.-,-,-.-.-.-.-X-
----------------------------------------------------------------------,-X-.-.-E-X-X-.-.-.-.-.-.-.-.-.-,-,-,-,-,-.-.-.-,-,-,-,-,-,-.-.-.-.-.-.-.-.-.-.-.-.-,-,-.-.-.-.-X-
----------------------------------------------------------------------,-X-.-.-,-X-X-,-,-,-,-,-,-,-,-,-,-,-,-,-,-,-,-,-,-,-,-,-,-,-,-,-,-,-,-,-,-,-,-,-,-,-,-,-.-.-.-.-X-
----------------------------------------------------------------------,-X-.-,-X-X-.-.-.-.-.-.-.-.-.-.-.-.-.-.-.-.-.-.-.-.-.-.-.-.-.-.-.-.-.-.-.-.-.-.-.-.-,-,-.-.-.-.-X-
--------------------------------------------------------------------,-,-X-X-X-X-X-,-.-.-.-.-.-.-.-.-.-.-.-.-.-.-.-.-.-.-.-.-.-.-.-.-.-.-.-.-.-.-.-.-.-.-.-,-,-.-.-.-.-X-
--------------------------------------------------------------------,-X-X-X-X-.-,-,-.-.-.-.-.-.-.-.-.-.-.-.-.-.-.-.-.-.-.-.-.-.-.-.-.-.-.-.-.-.-.-.-.-.-.-,-,-.-.-.-.-X-
--------------------------------------------------------------------,-X-.-.-,-H-,-,-.-.-.-.-.-.-.-.-.-.-.-.-.-.-.-.-.-.-.-.-.-.-.-.-.-.-.-.-.-.-.-.-.-.-.-,-,-.-.-.-.-X-
--------------------------------------------------------------------,-X-X-X-X-X-,-,-.-.-.-.-.-.-.-.-.-.-.-.-.-.-.-.-.-.-.-.-.-.-.-.-.-.-.-.-.-.-.-.-.-.-.-,-,-.-.-.-.-X-
----------------------------------------------------------------------,-X-X-X-,-X-,-.-.-.-.-.-.-.-.-.-.-.-.-.-.-.-.-.-.-.-.-.-.-.-.-.-.-.-.-.-.-.-.-.-.-.-,-,-.-.-.-.-X-
----------------------------------------------------------------------,-X-.-.-X-X-,-,-,-,-,-,-,-,-,-,-,-,-,-,-,-,-,-,-,-,-,-,-,-,-,-,-,-,-,-,-,-,-,-,-,-,-,-,-.-.-.-.-X-
----------------------------------------------------------------------,-X-.-.-,-X-X-.-.-.-.-.-.-.-.-.-.-.-.-.-.-.-.-.-.-.-.-.-.-.-.-.-.-.-.-.-.-.-.-.-.-.-,-,-.-.-.-.-X-
----------------------------------------------------------------------,-X-.-.-E-X-X-.-.-.-.-.-.-.-.-.-.-.-.-.-.-.-.-.-.-.-.-.-.-.-.-.-.-.-.-.-.-.-.-.-.-.-,-,-.-.-.-.-X-
----------------------------------------------------------------------,-X-.-.-E-.-,-.-.-.-.-.-.-.-.-.-.-.-.-.-.-.-.-.-.-.-.-.-.-.-.-.-.-.-.-.-.-.-.-.-.-.-,-,-.-.-.-.-X-
----------------------------------------------------------------------,-X-.-.-,-X-X-.-.-.-.-.-.-.-.-.-.-.-.-.-.-.-.-.-.-.-.-.-.-.-.-.-.-.-.-.-.-A-.-.-.-H-,-,-.-.-.-.-X-
----------------------------------------------------------------------,-X-.-.-E-X-X-.-.-.-.-.-.-.-.-.-.-.-.-.-.-.-X-X-,-X-X-X-,-X-X-X-,-X-X-X-L-L-L-X-X-X-X-X-.-.-.-.-X-
----------------------------------------------------------------------,-X-.-,-X-,-X-.-.-.-.-.-.-.-X-X-X-X-X-X-X-X-X-X-E-X-,-X-E-X-,-X-E-X-,-X-L-L-L-X-----,-X-.-.-.-.-X-
----------------------------------------------------------------------,-X-X-X---,-X-.-A-.-.-A-.-.-X---------------,-X-X-X-,-X-X-X-,-X-X-X-,-X-.-.-,-X-,-,-,-X-.-.-.-.-X-
--------------------------------------------------------------------------------,-X-.-.-.-.-.-.-.-X-----------------------,-X/X/X/X-X-X-X-X-X-,-,-,-X-X-X-,-X-.-.-.-.-X-
--------------------------------------------------------------------------------,-X-E-,-E-H-E-E-A-X-----------------------,-X-W-.-.-,-.-.-.-.-.-.-,-.-,-X-,-X-.-.-.-.-X-
--------------------------------------------------------------------------------,-X-X-X-XY.9XYX-X-X-----------------------,-X.,....-,-.-.-E-.-E-.-,-,-.-X-,-X-X-X-X-X-X-
--------------------------------------------------------------------------------,-X-X-X-X-,-X-X-X-X-----------------------,-X.E..-.-,-.-.-.-.-.-.-.-,-,-X---------------
------------------------,-,-,-,-------------------------------------------------,-X-A-H-.-H-H-.-A-X-----------------------,-X.,.,.,-,-.-.-.-.-.-.-.-.-.-X---------------
------------------------,-X-X-X-------------------------------------------------,-X-A-E-.-.-.-E-A-X-----,-,-,-,-,-,-------,-X-.-.-.-.-.-.-.-.-.-.-W-.-.-X---------------
--------------------,-,-,-X-.-X-,-,-,-,-----------------------------------------,-X-.-.-.-.-.-.-.-X-----,-X-X-X-X-X-------,-X-.-.-.-.-.-.-E-.-.-.-.-.-.-X---------------
------------------,-,-X-X-X-,-X-X-X-X-X-,---------------------------------------,-X-.-.-.-W-.-.-.-X-----,-X-.-<-<-X-------,-X-E-,-,-,-.-.-.-.-.-.-A-.-.-X---------------
----------------,-,-X-.-,-A-.-,-.-.-,-.-X-,-------------------------------------,-X-.-.-.-.-.-.-.-X-----,-X-.-<-.-X-------,-X-,-.-.-,-.-.-.-.-.-.-.-.-.-X---------------
----------------,-X-.-H-,-.-.-,-,-,-,-.-H-X-------------------------------------,-X-.-E-.-.-.-E-.-X-----,-X-.-<-.-X-------,-X-,-.-E-,-.-.-A-A-.-A-.-.-.-X---------------
----------------,-X-.-.-,-.-.-,-A-.-E-.-.-X-------------------------------------,-X-.-.-.-.-.-.-.-X-----,-X-.-.-.-X-------,-X-,-,-,-,-.-.-.-.-.-.-.-.-.-X---------------
----------------,-X-,-E-,-,-,-,-.-.-.-.-.-X-------------------------------------,-X-.-.-.-:-.-.-.-X-----,-X-.-.-.-X-------,-X-.-E-,-.-.-.-.-.-.-.-.-.-.-X-,-,-,-,-,-,-,-
----------------,-X-.-,-.-.-.-.-.-.-,-,-E-X-------------------------------------,-X-.-.-.-.-.-.-.-X-----,-X-.-.-.-X-------,-X-,-,-,-.-.-.-.-.-.-.-.-,-,-X-,-X-X-X-X-X-X-
----------------,-X-.-,-.-.-.-.-.-.-,-,-,-X-------------------------------------,-X-.-E-.-.-.-E-.-X-----,-X-.-.-.-X-,-,-,-,-X-,-,-.-.-.-.-.-.-.-.-.-,-.-X-,-X-.-.-.-.-X-
----------------,-X-,-,-.-.-.-.-.-.-,-,-.-X-------------------------------------,-X-.-.-.-.-.-.-.-X-----,-X-.-W-.-X-X-X-X-,-X-X-X-X-X-X-X-X-X-,-,-,-X-X-X-,-X-.-.-.-.-X-
----------------,-X-X-X-X-X-X-.-X-X-X-X-X-X-------------------------------------,-XX+X+X+X+X+X+X+XXX,-,-,-X-.-.-.-X-X-E-X-,-X-E-X-,-X-E-X-,-X-.-.-.-X-----,-X-.-.-.-.-X-
--------------,-,-X-X-X-X-X-X-+-X-X-X-X-X-X-,-,-,-,-,-,-,-,---------------------,-XX+X+X+X+X+X+X+XXXX-X-X-X-.-.-.-X-X-,-X-,-X-,-X-,-X-,-X-,-X-+-+-+-X-,-,-,-X-.-.-.-.-X-
--------------,-X-.-.-E-.-.-.-.-.-.-.-.-.-.-X-X-X-X-X-X-X-,-,-------------------,-X-E-.-.-.-.-.-.-.-.-.-.-.-.-.-.-X-X-,-X-X-X-,-X-X-X-,-X-X-X-,-,-,-X-X-X-X-X-.-.-.-.-X-
--------------,-X-.-.-.-.-.-.-.-.-.-.-.-.-.-X-X-.-.-,-,-.-X-X-,-----------------,-X-.-.-.-.-.-.-.-.-.-.-.-.-.-.-.-.-.-.-.-.-.-.-.-.-.-.-.-.-.-:-.-.-.-.-,-.-,-.-.-.-.-X-
--------------,-X-.-.-.-E-.-.-.-.-.-.-.-.-.-.-.-.-.-,-.-.-,-,-X-,-----,-,-,-,-,-,-X-E-.-.-.-.-.-.-.-.-.-.-.-.-.-.-.-.-.-.-.-.-.-.-.-.-.-.-.-.-.-.-.-.-.-,-.-,-.-.-.-.-X-
----------,-,-,-X-.-.-.-E-.-.-.-.-,-,-,-,-.-X-X-.-.-,-.-,-,-,-,-X-----,-X-X-X-X-X-X-.-.-.-.-.-.-.-.-.-.-.-.-.-.-.-.-.-.-.-.-.-.-.-.-.-.-.-.-.-.-.-.-.-E-,-.-,-.-.-.-.-X-
--------,-,-X-,-X-X-X-,-X-X-X-,-X-X-X-.-X-X-X-X-X-X-X-X-X-,-,-,-,-X---,-X-,-.-E-,-,-.-.-.-,-,-,-,-,-,-,-,-,-,-,-,-,-,-,-,-,-,-,-,-,-,-,-,-,-,-,-,-,-,-,-,-.-,-.-.-.-.-X-
------,-,-X-E-X-X-X-X-,-X-X-X-,-X-X-X-,-X-X-X---------,-X-,-,-.-.-X---,-X-,-.-.-X-X-.-.-.-,-.-.-.-.-.-.-.-.-.-.-.-.-.-.-.-.-.-.-.-.-.-.-.-.-.-.-.-.-.-.-,-.-,-.-.-.-.-X-
----,-,-X-X-.-X-X-.-.-.-.-.-.-.-.-.-.-.-.-.-X-----------,-X-.-.-.-X---,-X-,-.-.-X-X-.-.-.-,-.-.-.-.-.-.-.-.-.-.-.-.-.-.-.-.-.-.-.-.-.-.-.-.-.-.-.-.-.-.-,-.-,-.-.-.-.-X-
--,-,-X-.-X-X-,-.-.-.-.-.-.-.-.-.-.-.-.-.-.-X-----------,-X-.-.-.-X---,-X-,-.-E-X-X-.-.-.-,-.-.-.-.-.-.-.-.-.-.-.-.-.-.-.-.-.-.-.-.-.-.-.-.-.-.-.-.-.-.-,-.-,-.-.-.-.-X-
,-,-X-X-E-X-.-,-,-,-,-,-,-,-,-,-,-,-.-.-.-.-X-----------,-X-.-.-.-X---,-X-,-,-,-,-.-.-.-.-,-.-.-.-.-.-.-.-.-.-.-.-.-.-.-.-.-.-.-.-.-.-.-.-.-.-.-.-.-.-.-A-.-,-.-.-.-.-X-
,-X-.-X-X-.-,-,-.-.-.-.-.-.-.-.-.-,-.-.-.-.-X---------,-,-X-,-,-,-X-,-,-X-X-X-,-,-.-.-.-.-,-.-.-.-.-.-.-.-.-.-.-.-.-.-.-.-.-.-.-.-.-.-.-.-.-.-.-.-.-.-.-,-.-,-.-.-.-.-X-
X-X-.-X-.-,-,-.-.-.-.-.-.-.-.-.-.-,-.-.-.-.-X-,-,-,-,-,-X-.-.-.-.-.-X-,-X-X-X-,-.-.-.-.-.-,-.-.-.-.-.-.-.-.-.-.-.-.-.-.-.-.-.-.-.-.-.-.-.-.-.-.-.-.-.-.-,-.-,-.-.-.-.-X-
,-,-X-,-,-,-.-A-,-,-,-A-,-,-,-A-.-,-.-.-.-.-X-X-X-X-X-X-.-.-.-.-.-.-.-X-X-.-.-.-.-.-.-.-.-,-.-.-.-.-.-.-,-,-,-,-,-,-,-,-,-,-,-,-,-,-,-,-,-,-,-,-,-,-,-,-,-.-,-.-.-.-.-X-
,-,-X-.-,-.-.-,-,-,-,-,-,-,-,-.-.-,-.-.-.-,-X-X-E-,-.-.-,-,-,-,-,-,-.-X-X-.-.-.-.-.-.-.-.-,-.-.-.-.-.-.-,-.-.-.-.-.-.-.-.-.-.-.-.-.-.-.-.-.-.-.-.-.-.-.-,-.-,-.-.-.-.-X-
,-X-.-E-,-.-.-,-,-,-,-,-,-,-,-.-.-,-.-.-.-,-X-X-,-,-.-.-,-.-.-.-.-,-.-X-X-.-.-.-.-.-.-.-.-,-.-.-.-.-.-.-,-.-.-.-.-.-.-.-.-.-.-.-.-.-.-.-.-.-.-.-.-.-.-.-,-.-,-.-.-.-.-X-
,-X-.-.-,-.-.-,-,-,-E-.-E-,-,-.-.-,-.-.-.-,-.-+-,-,-.-E-,-.-.-.-.-,-A-.-+-.-.-.-.-.-.-.-.-,-.-.-.-.-.-.-,-.-.-.-.-.-.-.-.-.-.-.-.-.-.-.-.-.-.-.-.-.-.-E-,-.-,-.-.-.-.-X-
,-X-.-.-,-.-.-A-,-,-.-E-.-,-,-A-.-,-.-.-.-,-.-+-H-,-.-.-,-.-.-.-.-,-W-.-+-.-.-.-.-.-.-.-.-,-.-.-.-.-.-.-,-.-.-.-.-,-,-,-,-,-,-,-,-,-,-,-,-,-,-,-,-.-.-.-H-.-,-.-.-.-.-X-
,-X-.-E-,-.-.-,-,-,-E-.-E-,-,-.-.-,-.-.-.-<-.-+-,-,-.-E-,-.-.-.-.-,-.-.-+-.-.-.-.-.-.-.-.-:-.-.-.-.-.-.-,-.-.-.-,-,-X-X-X-X-,-,-,-X-X-X-.-.-.-X-X-X-X-X-X-X-X-.-.-.-.-X-
,-X-.-E-,-.-.-,-,-,-,-,-,-,-,-.-.-,-.-.-.-,-X-X-,-,-.-.-,-,-,-,-,-,-A-X-X-.-.-.-.-.-.-.-.-,-.-.-.-.-.-.-,-.-.-.-,-X-.-.-,-.-.-.-.-,-.-.-.-.-.-.-.-X-------,-X-.-.-.-.-X-
,-X-.-.-,-.-.-,-,-,-,-,-,-,-,-.-.-,-.-.-.-.-X-X-.-,-.-.-.-.-.-.-.-.-.-X-X-.-.-.-.-.-.-.-.-,-.-.-.-.-.-.-,-.-.-.-,-X-.-.-A-.-E-.-E-,-.-.-.-E-E-.-.-X-------,-X-.-.-.-.-X-
,-X-.-.-,-.-.-A-.-.-.-A-.-.-.-A-.-,-.-.-.-.-X-X-E-,-.-.-.-.-.-.-.-.-,-X-X-.-.-.-.-.-.-.-.-,-.-.-.-.-.-.-,-.-.-.-,-X-.-.-,-,-,-,-,-,-.-.-.-.-.-.-.-X-------,-X-.-.-.-.-X-
,-X-.-E-,-.-.-.-.-.-.-.-.-.-.-.-.-,-.-.-.-.-X-X-X-X-X-X-X-.-.-.-.-.-X-,-X-B-,-,-.-.-.-.-.-,-.-.-.-.-.-.-,-.-.-,-X-X-,-,-,-,-,-,-,-,-,-,-,-,8,8,8,8X8------,-X-.-.-.-.-X-
,-X-.-.-,-,-,-,-,-,-,-,-,-,-,-,-,-,-.-.-.-.-X-----------,-X-,-,-,-X-X-,-X-X-X-,-,-.-.-.-.-,-.-.-.-.-.-.-,-.-,-X-X-.-,-,-,-,-,-,-,-,-,-,-,-.8,-,-.-X-------,-X-X-X-X-X-X-
,-X-.-.-.-.-.-.-.-.-.-.-.-.-.-.-.-.-.-.-.-.-X-----------,-X2.2.2.2X2--,-X-,-.-,-,-,-.-.-.-,-.-.-.-.-.-.-,-.-,-X-X-E-,-,-,-,-,-,-,-,-,-,-,-,8.-,-,-X-,-------------------
,-X-.-.-.-.-.-,-,-,-.-.-,-,-,-.-.-.-.-.-.-.-X-----------,-X2.2.2.2X2--,-X-,-.-E-X-X-.-.-.-,-.-.-.-.-.-.-,-.-,-L-.-E-,-,-,-,-,-,-,-,-,-,-.-,-.8,-,-X-X-----,-,-,-,-------
,-X-.-.-.-.-,-,-.-X-X-.-X-X-,-,-.-.-.-.-.-.-X-----------,-X2.2.2.2X2--,-X-,-.-.-X-X-.-.-.-,-.-.-.-.-.-.-,-.-,-L-.-A-,-,-,-,-,-,-,-,-,-,-.-,-.8,-,-X-X-----,-X-X-X-------
,-X-.-.-.-,-,-.-,-X-X-.-X-X-,-,-,-.-.-.-.-,-X-----------,-X2.2.2.2X2--,-X-,-.-.-X-X-.-.-.-,-.-.-.-.-.-.-,-.-,-L-.-E-,-,-,-,-,-,-,-,-,-,-.-,-,8,-,-X-------,-X-.-X-------
--,-X-.-.-,-X-X-,-E-.-.-,-,-E-,-X-.-.-.-,-X-------------,-X2.2.2.2X2--,-X-,-,-E-,-,-.-.-.-,-.-.-.-.-.-.-,-.-,-X-X-E-,-,-,-,-,-,-,-,-,-,-,-,-,8,-.-X-------,-X-.-X-------
----,-X-X-X-X-X6.6,6.-.-.-,-.6.6X6X-X-X-X-------------,-,-X-.-.-.-X---,-XQ+QXQX-X-X-.-.-.-,-.-.-.-.-.-.-,-.-.-,-X-,-,-,-,-,-,-,-,-,-,-,-,-,8,-.-,-X-,-,-,-,-X-.-X-------
------------,-X6.6,6.-.-.-,-.6.6X6--------------------,-X-X-.-.-.-X---,-XQ+QXQ--,-X-.-.-.-,-.-.-.-.-.-.-,-.-.-.-X-X-.-.-.-.-.-.-.-.-.-.-,-,8,8,8,8X8X-X-X-X-X-.-X-------
------------,-X6A6,6.-.-.-,-.6A6X6--------------------,-X-.-.-.-.-X---,-X-.-X---,-X-.-.-.-,-.-.-.-.-.-.-,-.-.-.-,-X-.-.-.-.-.-.-.-.-.-.-.-.-.-.-,-,-.-.-.-,-.-.-X-------
------------,-X6X6X6X-.-X-X-X6X6X6--------------------,-X-X-.-.-.-X---,-X-.-X---,-X-.-.-,-,-,-,-,-,-,-,-,-,-.-.-,-X-.-.-A-.-.-.-.-.-.-.-.-,-,-,-,-,-.-.-.-,-.-.-X-------
------------------,-X-.-X-------------------------------,-X-.-.-.-X---,-X-.-X---,-X-X-X-X-X-,-,-X-X-X-,-,-X-X-X-X-X-X-X-X-X-X-.-.-.-X-X-X-X-X-,-,-.-.-.-.-,-.-.-X-------
,-,-,-,-,-,-,-,---,-X-.-X-----,-,-,-,-,-,-,-,-----------,-X-.-.-.-X-,-,-XQ+QXQ----,-,-X-X-X-.-.-X-X-X-.-.-X-X-,-,-X-X-X-X-X-X-L-L-L-X-X-X-X-X-.-.-.-.-.-.-,-.-.-X-------
X-X-X-X-X-X-X-X---,-X-.-X-----,-X-X-X-X-X-X-X-----------,-X-.-.-.-.-X-X-X1.1X1,---,-X-.-,-E-,-E-,-,-E-,-E-,-.-X-,-X-.-.-.-.-.-.-.-.-.-.-.-X-X-.-.-.-.-.-.-,-.-.-X-------
--,-,-X-X-.-.-X-,-,-X-+-X-,-,-,-X-.-X-X-X---------------,-X-.-.-.-.-.-.-.-.-.-X-,-,-X-.-.-E-.-E-.-.-.-.-.-.-.-.-X-X-.-.-.-.-E-.-.-.-.-.-.-X-X-.-.-.-.-.-.-,-.-.-X-------
------,-X-.-.-X-X-X-X-+-X-X-X-X-X-.-X-------------------,-X-.-.-.-.-.-.-.-E-.-.-X-X-.-.-.-.-.-.-.-.-E-.-E-.-.-.-.-X-.-.-.-.-.-.-.-:-.-.-.-,-,-.-.-.-.-.-.-,-.-.-X-------
------,-X-,-,-,-A-.-.-<-.-.-.-A-,-,-X-------------------,-X-.-.-.-.-:-.-.-.-.-.-+-.-.-.-.-.-A-.-.-W-.-A-.-.-.-.-.-+-.-.-.-.-E-.-H-.-.-.-<-,-,-.-.-.-.-.-.-,-.-.-X-------
------,-X-.-.-,-.-.-.-.-.-.-.-,-.-.-X---------------------,-X-.-.-.-.-.-.-E-.-,-X-X-.-.-.-.-.-.-.-.-.-.-.-.-.-.-.-X-.-.-.-.-.-.-.-.-.-.-.-,-,-.-.-.-.-.-.-,-.-.-X-------
------,-X-.-E-,-.-.-A-E-.-W-.-,-.-E-X-----------------------,-X-X-.-.-.-.-.-,-X---,-X-.-.-.-.-.-.-.-.-.-.-.-.-,-X-X-.-.-.-.-E-.-.-.-.-.-.-X-X-.-.-.-.-.-.-,-.-.-X-------
------,-X-.-.-,-.-,-,-,-,-.-.-,-.-E-X---------------------------,-X-X-X-X-X-X-------,-X-X-X-X-X-X-X-X-X-X-X-X-X-,-X-.-.-.-.-.-.-.-.-.-.-,-X-X-.-.-.-.-.-.-,-.-.-X-------
------,-X-.-E-,-.-,-.-.-,-.-.-,-.-.-X---------------------------------------------------------------------------,-X-X-X-X-X-X-X-X-X-X-X-X-X-X-,-,-,-,-,-,-,-.-.-X-------
------,-X-.-E-,-.-,-.-K-,-.-.-,-.-E-X-----------------------------------------------------------------------------------------------,-X-.-.-.-.-.-.-.-.-.-.-.-.-X-------
------,-X-,-,-,-.-,-,-,-,-.-.-,-,-,-X-----------------------------------------------------------------------------------------------,-X-X-X-X-X-X-X-X-X-X-X-X-X-X-------
------,-X-.-.-,-H-,-,-H-,-,-,-H-.-.-X-----------------------------------------------------------------------------------------------------------------------------------
------,-X-.-.-.-.-.-.-.-.-.-.-.-.-.-X-----------------------------------------------------------------------------------------------------------------------------------
------,-X-X-X-X-X-X-X-X-X-X-X-X-X-X-X-----------------------------------------------------------------------------------------------------------------------------------
