------------------------------------------------------------------------------------------------------------------------,-X-X-X-----------------------------------------------------------------------------------------------------
------------------------------------------------------------------------------------------------------------------------,-X-.-X-----------------------------------------------------------------------------------------------------
------------------------------------------------------------------------------------------------------------------------,-X-A-X-----------------------------------------------------------------------------------------------------
----------------------------------------------------------------------------------------------------------------------,-,-X-W-X-,---------------------------------------------------------------------------------------------------
----------------------------------------------------------------------------------------------------------------------,-X-X-+-X-X---------------------------------------------------------------------------------------------------
----------------------------------------------------------------------------------------------------------------------,-X-.-.-.-X---------------------------------------------------------------------------------------------------
----------------------------------------------------------------------------------,-,-,-,-,-,-,-,-,-,-----------------,-X-.-.-.-X---------------------------------------------------------------------------------------------------
----------------------------------------------------------------------------------,-X-X-X-X-X-X-X-X-X-----------------,-X-.-.-.-X---------------------------------------------------------------------------------------------------
------------------------------------------------------------------------------,-,-,-X-.-.-.-W-.-.-.-X-,-,-------------,-X-<-.-<-X---------------------------------------------------------------------------------------------------
------------------------------------------------------------------------------,-X-X-X-.-.-.-.-.-.-.-X-X-X-------------,-X-.-<-.-X---------------------------------------------------------------------------------------------------
------------------------------------------------------------------------------,-X-.-.-.-.-.-.-.-.-.-.-.-X-----,-,-,-,-,-X-<-,-<-X-,-,-,-,-------------------------------------------------------------------------------------------
------------------------------------------------------------------------------,-X-E-.-E-.-.-H-.-.-E-.-E-X-----,-X-X-X-X-X-,-,-,-X-X-X-X-X-------------------------------------------------------------------------------------------
------------------------------------------------------------------------------,-X-X-X-.-.-.-.-.-.-.-X-X-X-----,-X-.-E-,-.-.-.-.-,-.-E-.-X-------------------------------------------------------------------------------------------
----------------------------------------------------------------------,-,-,-,-,-,-,-X-.-.-.-.-.-.-.-X-,-,-----,-X-.-.-,-,-,-,-,-,-.-.-.-X-------------------------------------------------------------------------------------------
----------------------------------------------------------------------,-X-X-X-X-X-X-X-.-.-.-H-.-.-.-X-X-X-----,-X-X-.-.-,-,-,-,-.-.-.-X-X-------------------------------------------------------------------------------------------
----------------------------------------------------------------------,-X-.-.-H-+-.-.-.-.-.-E-.-.-.-.-.-X-----,-,-X-A-,-,-.-.-,-,-.-A-X-,-------------------------------------------------------------------------------------------
----------------------------------------------------------------------,-X-.-.-.-+-E-.-.-.-.-.-.-.-.-.-E-X-----,-X-X-,-,-.-.-.-.-,-,-.-X-X-------------------------------------------------------------------------------------------
----------------------------------------------------------------------,-X-X-X-X-X-X-X-.-.-.-.-.-.-.-X-X-X-----,-X-,-,-.-.-.-.-.-.-,-,-.-X-------------------------------------------------------------------------------------------
----------------------------------------------------------------------------------,-X-.-.-.-.-.-.-.-X-------,-,-X-,-.-.-.-.-.-.-.-.-,-,-X-,-----------------------------------------------------------------------------------------
----------------------------------------------------------------------------------,-X-X-X-.-.-.-X-X-X-------,-X-,-,-.-.-.-.-W-.-.-.-,-,-,-X-----------------------------------------------------------------------------------------
--------------------------------------------------------------------------------------,-X-.-.-.-X-------------,-X-,-,-.-.-.-.-.-.-,-,-.-X-------------------------------------------------------------------------------------------
--------------------------------------------------------------------------------------,-X-.-.-.-X-------------,-X-.-,-,-.-.-.-.-,-,-.-.-X-------------------------------------------------------------------------------------------
--------------------------------------------------------------------------------------,-X-,-,-,-X-------------,-X-X-.-,-,-.-.-,-,-.-.-X-X-------------------------------------------------------------------------------------------
------------------------------------------------------------------------------------,-,-X-.~.~,~X:,-----------,-,-X-A-.-,-,-,-,-.-.-A-X-,-------------------------------------------------------------------------------------------
------------------------------------------------------------------------------------,-X~.~.~.~.~.~X~----------,-X-X-.-,-,-,-,-,-,-.-.-X-X-------------------------------------------------------------------------------------------
----------------------------------------------------------------------------,-,-,-,-,-X~.~.~.~.~.~X~,-,-,-,-,-,-X-.-.-,-,-,-,-,-,-.-.-.-X-------------------------------------------------------------------------------------------
----------------------------------------------------------------------------,-X-X-X-X-X-.~.~E~.~.~X~X-X-X-X-X-,-X-.-.-,-,-,-,-,-,-.-.-.-X-------------------------------------------------------------------------------------------
----------------------------------------------------------------------------,-X-t2t2t2,-.~.~.~.~.~,~.-.-,-.-.-X-X-X-X-X-X-.-.-.-X-X-X-X-X-,-,---------------------------------------------------------------------------------------
----------------------------------------------------------------------------,-X-t2<-t2,-.~.~E~.~.~,~.-H-,-.-.-.-X-,-,-,-X-+-+-+-X-,-,-X-X-X-X-,-,-,-,-,-----------------------------------------------------------------------------
,-,-,-,-,-,-,---------------------------------------------------------------,-X-t2t2t2,-.~.~.~.~.~,~,-,-,-.-.-.-X-,-X-X-X-.-A-.-X-X-X-X-t1t1t1XPX-X-X-X-----------------------------------------------------------------------------
X-X-X-X-X-X-X---------------------------------------------------------------,-X-X-X-X-X-.~.~E~.~.~X~X-X-.-.-.-.-X-,-X-.-.-.-.-.-.-.-X-X-t1t2t1.0A-A-.-X-----------------------------------------------------------------------------
X-E-.-.-E-.-X-----------------------------------------------------------------------,-X~.~.~.~.~.~X~--,-X-.-.-.-X-,-X-.-.-.-.-.-.-.-X-X-t1t1t1XPX-X-X-X-----------------------------------------------------------------------------
X-.-.-.-.-.-X-,-,-,-,---------------------------------------------------------------,-X~.~.~.~.~,~X~,-,-X-+-+-+-X-,-X-.-.-.-.-.-.-,-X-X-.-X-X-,-,-,-,-------------------------------------------------------------------------------
X-E-.-.-E-.-X-X-X-X-X-----------------------------------------------------------------,-X~.~.~,~X~,-X-X-X-.-.-.-X-X-X-.-.-.-.-.-.-,-X3X3.3X3X3X-X-X-X-,-----------------------------------------------------------------------------
X-E-.-.-E-.-X-X-X-X-X-------------------------------------------------------------------,-X~X~X~,-X-,-,-.-.-.-.-E-,-.-.-.-.-.-.-.-,-.3.3E3.3,3,-.-,-.-X-,---------------------------------------------------------------------------
X-.-.-.-.-.-X---,-X-X-----------------------------------------------------------------------,-,-X-,-,-,-,-.-.-.-.-,-.-.-.-.-.-.-.-,-.3.3H3.3,3,-,-,-.-,-X-,-------------------------------------------------------------------------
X-E-.-.-E-.-X---,-X-X---------------------------------------------------------------------,-,-X-,-,-,-,-,-,-,-,-,-,-.-.-.-.-.-.-.-,-.3.3.3.3,3,-,-.-,-,-,-X-,-----------------------------------------------------------------------
X-.-.-.-+W+WXW--,-X-X-------------------------------------------------------------------,-,-X-,-,-,-,-,-,-.-.-.-.-.-.-.-.-.-.-.-.-,-,3,3,3,3,3,-,-,-,-,-,-,-X-,---------------------------------------------------------------------
XFtFtFtFtEtEXE--,-X-X-----------------------------------------------------------------,-,-X-,-,-E-,-,-,-.-.-.-.-.-.-.-.-.-.-.-.-.-.-.-.-.-.-.-.-,-,-,-,-E-,-,-X-,-------------------------------------------------------------------
XFtFtFtEtEtEXE--,-X-X---------------------------------------------------------------,-,-X-,-,-,-,-,-,-.-.-.-.-.-.-.-.-.-.-.-.-.-.-.-.-.-.-.-.-.-.-,-,-,-,-,-,-,-X-,-----------------------------------------------------------------
XX.-.-.-.-.-X---,-X-X-------------------------------------------------------------,-,-X-,-,-,-,-,-,-.-.-.-.-.-.-.-.-.-.-.-.-.-.-.-.-.-.-.-.-.-.-.-.-.-,-,-,-E-,-,-X-,-,-------------------------------------------------------------
X-E-.-.-E-.-X-,-,-X-X-,-,-,-,-,-,-,-,-,-,-,-,-,-,-,-,-,-,-,-,-,-,-,-,-,-,-,-----,-,-X-,-,-,-,-,-,-.-.-.-.-.-.-.-.-.-.-.-.-.-.-.-.-.-.-.-.-.-.-.-.-.-.-.-,-,-,-,-,-,-X-X~,-----------------------------------------------------------
X-.-.-.-.-.-X-X-X-X-X-X-X-X-X-X-X-X-X-X-X-X-X-X-X-X-X-X-X-X-X-X-X-X-X-X-X-X---,-,-X-,-,-,-,-,-,-.-.-.-.-.-.-.-.-.-.-.-.-.-.-.-.-.-.-.-.-.-.-.-.-.-.-.-.-.-,-,-,-,-,-.~.~X-----------------------------------------------------------
X-E-.-.-E-.-X-X-X-X-X-X-X-X-X-X-X-X-X-X-X-X-X-X-X-X-X-X-X-X-X-X-X-X-X-X-X-X-,-,-X-.-,-E-,-,-,-.-.-.-.-.-.-.-.-.-.-,-,-,-,-,-,-,-,-,-,-.-.-.-.-.-.-.-.-.-.-.-,-,-,-.~.~.~X~,---------------------------------------------------------
X-.-.-.-E-.-X-------------------,-,-,-,-,-,---------------------------,-X-X-,-X-,-,-.-,-,-,-.-.-.-.-.-.-.-.-.-.-.-,-,-,-,-,-,-,-,-,-,-.-.-.-.-.-:-.-.-.-.-.-,-.~.~.~.~.~.~X~--------------------------------------------------------
X-X-X-X-X-X-X-------------------,-X-X-X-X-X-------------,-,-,-,-,-,---,-X-X-X-X-.-,-,-,-,-.-.-.-.-.-.-.-.-.-.-.-.-,-,-,-,-,-,-,-,-,-,-.-.-.-.-.-.-.-.-.-.-.-,-.~.~.~.~.~,~X~,-,-,-,-,-,-,-,-,-,-,-----------------------------------
--------------------------------,-X-.-:-.-X-----------,-,-X-X-X-X-X---,-X-X-X-X-.-.-.-,-.-.-.-.-.-.-.-.-.-.-.-.-.-,-.-.-.-.-.-.-.-.-,-.-.-.-.-.-.-.-.-.-.-,-,-.~.~.~.~.~,~X-X-X-X-X-X-X-X-X-X-X-X-,-,---,-,-,-,-,-,-----------------
--------------------------------,-X-E-A-E-X---------,-,-X-.-.-.-.-X-,-,-X-X-,-X-.-.-.-,-.-.-.-.-.-.-.-.-.-.-.-.-.-,-,-,-,-,-,-,-,-,-,-.-.-.-.-.-.-.-.-,-,-,-.-.~.~.~.~.~,~.-+-,-,-,-.-,-.-.-.-.-.-X-X-,-,-X-X-X-X-X-----------------
----------------------,-,-,-,-,-,-X-.-.-.-X-,-,-,-,-,-X-.-.-.-.-.-X-X-X-X8X-X-X-.-.-.-,-.-.-.-.-.-.-.-.-.-.-.-.-.-,-,~H~,~,~H~,~,~H~,~.-.-.-.-.-.-,-,-,-.-.~.~.~.~.~.~.~,~.-+-A-,-E-.-,-.-.-.-tF.-.-.-X-,-X-.-H-.-X-----------------
----------------------,-X~X~X~X~X~X-,-,-,-X-X~X~X~X~X~X-E-.-H-A-.-.-L-E-.8.-A-+-.-.-.-,-.-.-.-.-.-.-.-.-.-.-.-.-,-,-.-.-.-.-.-.-.-.-,-,-.-.-.-,-,-,-.-.~.~.~.~.~.~.~.~.~,~.-+-,-,-,-.-,-.-.-.-.-.-.-.-.-X-X-A-W-A-X-----------------
----------------------,-X~.~.~.~X~X~.~.~.~X~X~.~.~.~X~X-.-.-.-.-.-X-X-X-X8X-X-X-.-E-.-,-.-.-.-.-.-.-.-.-.-.-.-,-,-.-.-.-.-.-A-.-.-.-.-,-,-,-,-,-.-.~.~.~.~.~.~.~.~.~.~.~,~X-X-X-X-X-X-X-X-X-.-.-.-.-.-.-X-X-.-.-.-X-----------------
----------------------,-X~.~.~.~.~,~,~,~,~,~.~.~.~.~X~,-X-.-.-.-.-X---,-,-,-,-X-.-A-.-,-.-.-.-.-.-.-,-,-,-,-,-,-.-.-.-.-.-.-.-.-.-.-.-.-,-,-.-.~.~.~.~.~.~.~.~.~.~.~.~.~.~X~--,-,-X-X-X-X-,-X-X-.-.-.-.-.-X-XV+VXVX-----------------
----------------------,-X~.~.~.~,~,~.-.-.-,-,~.~.~.~X~--,-X-X-X-X-X---,-X-X-X-X-,-,-,-,-.-.-.-.-.-.-,-.~.~.~,~.-.-,-,-,-.-.-.-.-.-.-.-.-.-,-.~.~.~.~.~.~.~.~.~.~.~.~.~.~.~X~,-,-X-.-.-.-.-X-X-,-X-.-.-.-.-X-XV+VXVX-----------------
------------,-,-,-,-,-,-X~X~.~,~,~.-.-A-.-.-,~,~,~X~X~,-,-,-,-,-,-,-,-,-X-.-.-,-.4.4,4.-.-.-.-.-.-.-,-.~A~.~A~.-.-,-.-,-.-E-.-.-.-.-.-.-.-,-.~.~.~.~.~.~.~.~.~.~X~X~X~X~X~X~,-X-.-.-.-.-.-.-.-X-X-.-.-.-.-.-.-.-.-X-----------------
------------,-X-X-X-X-X-X-X~.~,~.-A-,-,-,-A-.-.-.-X-X]X]X-X-X=X-X-X-X-X-X-.-.-,-.4.4,4.-.-.-.-.-.-.-,-.~.~.~,~.-.-,->->-.-.-.-.-.-.-.-.-.-,-.~.~.~.~.~.~.~.~.~.~X~X-X-X-X-X-X`X-.-,-,-,-,-.-.-,-X-X-,-,-,-,-,-,-,-X-----------------
------------,-X-t<t<t<.-,-.~.~,~.-,-.-.-,-.-.-.-.-,-+]+].-.-.=.-.-.-.-+-.-.-.-,-.4.4,4.-.-.-.-.-.-.-,-.~.~.~,~.-.-,->->-.-.-.-.-.-.-.-.-.-,-.~.~.~.~.~.~.~.~.~.~X~X-tDtDtD.-.-.-.-,-t?t?t?.-.-.-X-X-.-.-.-.-.-.-,-X-----------------
------------,-X-t<.-t<A-,-.~.~,~.-A-.-.-,-A-.-.-t<,-+]+]E-.-.=.-.-<-.-+-.-.-.-,-.4.4,4.-.-.-.-.-.-.-,-.~.~.~,~.-.-,->->-.-.-.-.-.-.-.-T-.-,-.~.~.~.~.~.~E~.~.~.~X~X-tD.-tDE-.-<-.-,-t?t>t?.-A-.-X-X-,-,-,-,-,-,-,-X-----------------
------------,-X-t<t<t<.-,-.~.~,~.-,-,-,-,-.-.-.-.-,-+]+].-.-.=.-.-.-.-+-.-.-.-,-.4.4,4.-.-.-.-.-.-.-,-.~.~.~,~.-.-,->->-.-.-.-.-.-.-.-.-.-,-.~.~.~.~.~.~.~.~.~.~X~X-tDtDtD.-.-.-.-,-t?t?t?.-.-.-X-X-.-.-.-.-.-.-.-X-----------------
------------,-X-X-X-X-X-X-X~.~,~,-A-.-A-.-A-,-,-,-X-X]X]X-X-X=X-X-X-X-X-X-.-.-,-.4.4,4.-.-.-.-.-.-.-,-.~.~.~,~.-.-,->->-.-E-.-.-.-.-.-.-.-,-.~.~.~.~.~.~.~.~.~.~X~X-X-X-X-X-X`X-.-.-.-.-.-.-.-X-,-X-.-.-E-.-.-.-.-,-X---------------
----------------------,-X~X~.~.~.~,~,-,-,-,-.~.~.~X~X~----------------,-X-.-.-,-,4,4,4,-,-,-,-,-,-,-,-.~.~.~,~.-.-,-,-,-.-.-.-.-.-.-.-.-.-,-.~.~.~.~.~.~.~.~.~.~X~X~X~X~X~X~,-X-.-.-.-.-.-.-,-X-X-.-.-.-.-.-.-.-E-.-X---------------
----------------------,-X~.~.~.~.~.~.~.~.~.~.~.~.~.~X~----------------,-X4X4X4X-,-,-,-.-.-.-.-,-.-.-,-.~.~.~,~,-.-.-.-.-.-.-.-.-.-.-.-.-,-,-.~.~.~.~.~.~.~.~.~.~.~.~.~.~.~X~--,-X-X-.-.-,-,-X-.-X-.-.-.-.-.-.-.-.-.-X---------------
----------------------,-X~.~.~.~.~.~.~.~.~.~.~.~.~.~X~----------------------,-X-.-A-,-,-,-,-,-,-.-.-,-.~.~.~.~,~,-.-.-.-.-.-.-.-.-.-.-,-,-.~.~.~.~.~.~.~.~.~.~.~.~.~.~.~,~X~,-,-,-,-X-X-X-X-X-X-.-.-.-.-.-.-E-.-.-.-X---------------
----------------------,-X~.~.~.~X~X~,~,~,~X~X~.~.~.~X~----------------------,-X-.-E-,-.-.-.-.-,-,-,-,-,~,~.~.~.~,~,-.-.-.-.-A-.-.-.-,-,-.~.~.~.~.~.~.~.~.~.~.~.~.~.~.~.~,~X-X-X-X-X-X-X-X-X-.-.-.-.-.-.-.-.-.-.-.-.-X---------------
----------------------,-X~X~X~X~X~X-.-.-.-X-X~X~X~X~X~----------------------,-X-.-.-,-,-,-,-,-,-,-.-,-,-,-,~.~.~.~,~,-,-,-,-,-,-,-,-,-.~.~.~.~.~.~.~.~.~.~.~.~.~.~.~.~.~,~.-+-.-.-.-.-.-.-.-.-.-.-.-.-E-.-.-.-.-E-.-X---------------
--------------------------------,-X-.-.-.-X---------------------------------,-X-.-.-,-,-,-,-.-,-,-,-,-,-,-,-,~.~.~.~.~.~.~.~.~.~.~.~.~.~.~.~.~.~E~.~.~.~.~.~.~.~.~.~.~t~,~.-+-A-.-.-.-.-.-.-.-.-.-.-.-.-.-.-.-.-.-.-X---------------
--------------------------------,-X-E-A-E-X---------------------------------,-X-.-,-,-,-,-.-,-,-,-,-,-,-,-,-,-,~.~.~.~.~.~.~.~.~.~.~.~.~.~.~.~.~.~.~.~.~.~.~.~.~.~.~.~.~,~.-+-.-.-.-.-.-.-.-.-.-.-.-.-.-.-.-E-.-.-.-X---------------
--------------------------------,-X-.-:-.-X---------------------------------,-X-,-,-,-,-,-,-,-,-,-,-,-,-,-,-,-,-.~.~.~.~.~.~.~.~.~.~.~.~.~.~.~.~.~.~.~.~.~.~.~.~.~.~.~.~,~X-X-X-X-X-X-X-X-X-X-X-X-X-X-.-.-.-X-X-X-X-X---------------
--------------------------------,-X-X-X-X-X---------------------------------,-X-.-,-,-,-,-,-,-,-,-,-,-,-,-,-,-,-,~,~,~,~,~,~,~,~.~.~.~.~.~.~.~.~.~.~.~.~.~.~.~.~.~.~.~.~.~X~--------------,-,-,-,-,-X-+-+-+-X-,-,-,-,---------------
----------------------------------------------------------------------------,-X-X-,-,-,-,-,-,-,-,-,-,-,-,-,-,-,-,-.-,-,-,-.-:-,-.~.~.~.~.~.~.~.~.~.~.~.~.~.~,~,~,~.~.~.~,~X~------------,-,-X-X-X-X-X-.-.-.-X-X-X-X-X-,-,-----------
--------------------------------------------------------------------------------,-X-,-,-,-,-,-,-,-,-,-,-,-,-,-.-,-.-,-,-,-,-E-,-.~.~.~.~.~.~.~.~.~.~.~.~.~,~,~.-,-,~,~,~X~--------------,-X-.-.-.-.-.-.-<-.-.-.-.-.-.-X-X-----------
----------------------------------------------------------------------------------,-X-,-E-,-,-,-,-,-,-,-,-,-,-,-,-,-,-,-,-....,..~.~.~.~.~.~.~.~.~.~.~.~,~,~,-,-.-,-,-X~--,-,-,-,-,-,-,-,-X-,-,-,-,-.-.-.-.-,-,-,-,-,-,-X-----------
------------------------------------------------------------------------------------,-X-,-,-,-,-,-,-,-,-,-,-,-,-,-,-,-,-,-,-,-,-.~.~.~.~.~.~.~.~.~.~.~,~,~,-,-E-,-,-X---,-,-XZXGX-X-X-,-X~.~.~.~.~,~,-,-,-,-,-.~.~.~.~.~X~----------
--------------------------------------------------------------------------------------,-X-,-,-,-,-,-,-,-,-,-,-,-,-,-,-,-.-.-.-,-.~.~.~.~.~.~.~.~.~.~,~,~,-,-,-,-,-X---,-,-X-.-tG.-.-X-,-X~A~.~.~.~.~,~,-,-,-.~.~.~.~.~A~X~----------
----------------------------------------------------------------------------------------,-X-,-,-,-,-,-,-,-.-,-,-,-,-,-,-.-.-.-:-.~A~.~.~.~.~.~.~.~,~,~,-,-,-,-,-X-,-,-,-X-.-.-tG.-.-X-,-X~.~.~.~.~.~,~,-,-,-.~.~.~.~.~.~X~----------
------------------------------------------------------------------------------------------,-X-,-,-E-,-,-,-,-,-,-,-,-,-,-,-.-.-,-.~.~.~.~.~.~.~.~,~,~,-,-,-,-,-X-.-X-,-X-E-.-.-tG.-.-X-,-X~.~.~.~.~.~,~,-,-,-.~.~.~.~.~.~X~----------
--------------------------------------------------------------------------------------------,-X-,-,-,-,-,-.-,-,-,-.-.-.-,-.-.-,-,~,~,~,~,~,~,~,~,~,-,-,-E-,-X-,-X-,-X-E-E-.-.-t/.-.-X-,-X~.~.~.~.~.~,~,-,-,-,~.~.~.~.~,~X~----------
----------------------------------------------------------------------------------------------,-X-,-,-,-,-.-,-,-,-.-.-:-,-.-.-,-,-,-,-.-.-.-.-.-,-,-,-,-,-X-----,-X-.-.-.-.-.-t/.-.-X-X~X~X~X~.~.~.~,~.-.-.-,-.~.~.~X~X~------------
------------------------------------------------------------------------------------------------,-X-,-.-,-.-,-,-,-E-tG.-,-.-<-,-,-,-,-.-.-.-E-.-.-,-.-,-X-------,-X-E-E-E-.-.-t/.-.-X-X~.~.~X-.~.~.~,~.-.-.-,-.~.~.~X~--------------
--------------------------------------------------------------------------------------------------X-,-.-,-.-,-,-,-.-.-.-,-.-.-,-,-,-,-.-.-.-.-.-.-,-,-X---------,-X-E-E-E-.-.-t/.-.-X-H~.~H~.-.~.~.~,~.-.-.-,-.~.~.~X~--------------
----------------------------------------------------------------------------------,-,-,-,---,-,-,-,-X-X-X-X-X-X-X-X-+-X-X-X-X-X-X-X-X-X-X-X-+-+-+-X-X-----------,-X-E-E-E-.-.-t/.-.-X-.~.~.~X-.~.~.~,~.-E-.-,-.~.~.~X~--------------
--------------------------------------------------------------------------------,-,-X-X-X-,-,-X-X-X-X-X-X-X-,---,-X-.-X-------------,-,-,-XN.-.-.-XN,-,---------,-X-X-X-X-X-XZX/X-X-X-X~X~X~X~.~.~.~,~.-.-,-,-.~.~.~X~,-,-----------
--------------------------------------------------------------------------------,-X@.-.-.-X-X-.-,-,-H-.-.-.-X---,-X-<-X-------------,-X-X-X-.-W-.-X-X-X-------------------------------,-X~X~.~.~.~.~,~.-.-,-.~.~.~.~.~X~X~----------
--------------------------------------------------------------------------------,-X@.-A-.-L-.-,-,-.-,-,-,-.-X---,-X-.-X-,-,-,-,-,-,-,-X-.-.-.-.-.-.-.-X-,-,-,-,-,-,-----------,-,-,-,-,-X~.~.~.~.~.~,~.-.-,-.~.~.~.~.~,~X~,-,-,-,-,-
--------------------------------------------------------------------------------,-X@.-.-,-X-X-,-.-.-.-.-,-,-X-,-,-X-.-X-X-X-X-X-X-X-X-X-.-.-.-.-.-.-.-X-X-X-X-X-X-X-----------,-X-X-X-X-X-.~.~.~.~.~,~.-.-,-.~.~.~.~.~,~X-X-X-X-X-X-
----------------------------------------------------------------------------------,-X-X-X-,-X-.-.-E-.-.-.-,-X7X-X-.-.-X-X-.A.A.AX-X-.-.-.-.-.-.-.-.-.-.-,-X-.-.-,-X-----------,-X-H-.-,-,~.~.~.~.~.~,~.-.-,-.~.~.~.~.~,~.-,-.-H-.-X-
----------------------------------------------------------------------------------,-,-,-,-,-X-,-.-E-.-.-,-,-.7.-.-.-X-,-X-.AK-.AX-X-.-.-.-.-.-.-.-.-.-.-,-X-.-K-,-X-----------,-X-.-.-,-,-,~.~E~.~,~,~.-.-,-,~.~E~.~,~,~.-,-.-E-.-X-
--------------------------------------------------------------------------------,-,-X-X-X-,-X-,-.-E-.-,-,-.-X7X-X-X-X-,-X-.A.A.A,-,-.-.-.-.-.-.-.-.-.-.-,-,-,-,-,-X-----------,-X-E-.-,-,-,-,~.~,~,~.-.-.-.-,-,~.~,~,~.-,-,-.-.-.-X-
--------------------------------------------------------------------------------,-X-t>t>t>X-X-,-,-,-,-,-.-.-X---------,-X-.-.-.-,-,-.-.-.-.-.-.-.-.-.-.-,-,-.-.-.-X-----------,-X-.-.-.-,-,-,-,~,~.-.-.-E-.-.-,-,~,~.-,-,-.-.-.-.-X-
--------------------------------------------------------------------------------,-X-t>t?t>+-.-.-.-,-,-.-.-.-X---------,-X-.-.-.-,-,-.-.-.-.-.-E-.-.-.-.-,-,-.-.-.-X-----------,-X-.-.-E-.-,-,-,-,~.-.-.-.-.-.-,-,~,-,-,-.-E-.-.-,-X-
--------------------------------------------------------------------------------,-X-t>t>t>X-X-.-.-.-H-.-.-,-X---------,-X-.-.-.-X-X-.-.-.-.-.-.-.-.-.-.-,-X-.-.-.-X-------------,-X-.-.-H-.-,-,-X-X-X-X-A-X-X-X-X-,-.-.-.-H-.-,-X---
----------------------------------------------------------------------------------,-X-X-X---,-X-X-X-X-X-X-X-----------,-X-.-.-.-X-X-.-.-.-.-.-.-.-.-.-.-.-X-.-.-.-X---------------,-X-.-.-.-.-,-X---,-X-X-X---,-X-.-.-.-E-.-,-X-----
------------------------------------------------------------------------------------------------------,-,-,-,-,-,-,-,-,-X-.-.-.-X-X-.-.-.-.-.-.-.-.-.-.-.-X-.-.-.-X-----------------,-X-.-.-A-,-X-------------,-X-.-A-.-,-X-X-------
------------------------------------------------------------------------------------------------------,-X-X-X-X-X-X-X-X-X-.-.-.-X-X-.-.-.-.-.-tE.-.-.-.-.-X-.-.-.-X-------------------,-X-,-X-X-----------------,-X-X-,-X-----------
------------------------------------------------------------------------------------------------------,-X-.-.-.-.-.-.-.-.-.-.-.-X-X-.-.-.-.-.-A-.-.-.-.-.-X-.-.-.-X---------------------,-X-------------------------,-X-------------
------------------------------------------------------------------------------------------------------,-X-.-.-.-.-.-.-.-.-.-E-.-X-X-.-.-.-X-X-X-X-.-.-.-.-X-.-.-.-X-----------------------------------------------------------------
------------------------------------------------------------------------------------------------------,-X-,-,-,-,-,-,-,-,-,-,-,-X-XW+W+W+WXW----,-XX+X+X+XX-+-+-+-X-,-,-,-,-,-,-,---------------------------------------------------
------------------------------------------------------------------------------------------------------,-X~.~.~.~X~X~X~X~X~X~X~X~X~X~.-.-.-X-----,-XX+X+X+XX-+-+-+-X-X-X-X-X-X-X-X---------------------------------------------------
------------------------------------------------------------------------------------------------------,-X~.~.~.~.~.~.~.~.~.~.~.~.~,~tC.-.-X-----,-X-.-.-.-X-.-.-,-.-,-.-.-.-.-.-X---------------------------------------------------
------------------------------------------------------------------------------------------------------,-X~.~.~.~.~.~.~.~.~.~.~.~.~,~.-.-.-X-----,-X-.-.-.-X-.-.-,-.-,-.-.-.-.-.-X---------------------------------------------------
------------------------------------------------------------------------------------------------------,-X~.~.~.~.~.~.~.~.~.~.~.~.~,~.-.-.-X-----,-X-.-.-.-X-.-.-,-.-,-.-.-H-.-.-X---------------------------------------------------
------------------------------------------------------------------------------------------------------,-X~.~.~.~.~.~.~.~.~.~.~.~.~,~,-,-,-X-----,-X-.-.-.-X-.-.-,-.-,-.-.-.-.-.-X---------------------------------------------------
------------------------------------------------------------------------------------------------------,-X~.~.~.~.~.~.~.~.~.~.~.~.~.~.~.~.~X~----,-X-.-.-.-X-.-.-,-.-,-.-.-.-.-.-X---------------------------------------------------
----------------------------------------------------------------------------------------------,-,-,-,-,-X~.~.~.~.~.~.~.~.~.~.~.~.~.~.~.~.~X~----,-X-.-.-.-.-.-.-,-X-X-X-X-X-X-X-X---------------------------------------------------
----------------------------------------------------------------------------------------------,-X-X-XCX-X-.~.~.~.~.~.~.~.~.~.~.~.~.~.~.~.~X~------X-.-.-.-.-.-.-X-,-----------------------------------------------------------------
----------------------------------------------------------------------------------------------,-X-.-tC.-,-.~.~.~.~.~.~.~.~.~.~.~.~.~.~.~.~X~------,-X-.-.-.-.-.-X-------------------------------------------------------------------
----------------------------------------------------------------------------------------------,-X-X-XCX-X-,~,~.~,~,~,~,~.~,~,~,~,~.~,~,~,~X~--------X-.-.-.-.-X-,-------------------------------------------------------------------
------------------------------------------------------------------------------------------------------,-Xa+a+a.~,~+a+a+a.~,~+a+a+a.~,~+a+aXa--------,-X-X-,-,-X---------------------------------------------------------------------
------------------------------------------------------------------------------------------------------,-X-.-+aA~,~.-.-+aA~,~.-.-+aA~,~.-.-X-----------,-,-X-X-----------------------------------------------------------------------
------------------------------------------------------------------------------------------------------,-X-X-XaX~X~X-X-XaX~X~X-X-XaX~X~X-X-X-----------------------------------------------------------------------------------------
