----------------------------------,-,-,-,-,-,-------------------------------------------------------------------,-X-X@X@X@X-------------,-X-X-X-X-X-----------------------------------------------------------------------------------------
--------------------------------,-,-X-X-X-X-X-,-----------------------------------------------------------------,-X-.-H-.-X-------------,-X-.-H-.-X-----------------------------------------------------------------------------------------
--------------------------------,-X-.-.-.-.-.-X-----------------------------------------------------------------,-X-.-E-.-X-------------,-X-.-E-.-X-------------,-,-,-,-,-,-,---------------------------------------------------------------
------------------------------,-,-X-.-.-.-.-.-X-,-,-------------------------------------------------------------,-X-.-.-.-X-------------,-X-.-.-.-X-----------,-,-X-X-X~X~X~,-,-------------------------------------------------------------
------------------------------,-X-.-.-.-A-.-.-.-X-X-------------------------------------------------------------,-X-.-.-.-X-------------,-X-.-.-.-X---------,-,-X-.-.-,-.~.~X~X~,-----------------------------------------------------------
------------------------------,-X-.-.-.-E-.-.-.-.-X-------,-,---------------------------------------------------,-X-.-.-.-X-------------,-X-.-.-.-X---------,-X-.-.-A-,-,-.~.~.~X-----------------------------------------------------------
------------------------------,-X-.-.-A-W-.-A-.-.-X-----,-,-X-,-------------------------------------------------,-X-.-E-.-X-------------,-X-.-E-.-X-------,-,-X-.-.-.-.-,-.~.~.~X~,---------------------------------------------------------
------------------------------,-X-.-.-.-A-.-.-.-.-X-----,-X-.-X---------------------------------------------,-,-,-X-.-.-.-X-,-,-,-,-,-,-,-X-.-.-.-X-,-,---,-.-X-W-.-A-.-,-.~.~.~.~X~--------------------------------------------------------
------------------,-,-,-------,-X-.-.-.-.-.-.-,-X-X---,-,-X-.-X-,-,---------------------------------------,-,-X-X-X^.-.-.-X^X-X-X-X-X-X-X-X^.-.-.-X^X-X-,-,-X-.-.-.-.-.-,-,~.~.~.~X~--------------------------------------------------------
--------------,-,-,-X-X---------,-X-,-,-,-,-,-X---,-,-,-X-.-.-.-X-X-,-,---------------------------------,-,-X-.-.-.-.-.-.-.-.-.-.-H-.-.-.-.-.-.-.-.-.-.-X---X-X-,-,-,-.-.-A-.~.~.~X~--------------------------------------------------------
------------,-,-X-X-.-X-----------,-X-.-.-.-X-,-,-,-X-X-.-.-.-.-.-.-X-X-,-,---------------------------,-,-X-.-.-.-.-.-.-.-.-.-.-.-.-.-.-.-.-.-.-.-.-.-.-.-X-,-X=.=.=,=.-.-,-,~.~.~X~--------------------------------------------------------
------------,-X-.-.-.-X-,-----,-,-,-X-.-.-.-X-X~X~X-.-.-.-.-.-.-.-.-E-.-X-X---------------------------,-X-.-.-.-.-.-.-.-.-.-.-.-.-.-.-.-.-.-.-.-.-.-.-.-.-.-X-X=.=A=,=.-.-.-,-,-,~X~--------------------------------------------------------
------------,-X-.-.-.-.-X-,-,-,-X-X-X-+-+-+-X-X~,~,~.-.-.-.-.-E-.-E-.-.-.-X-,-------------------------,-X-.-.-.-.-.-.-.-.-.-.-.-.-.-.-.-.-.-.-.-.-.-.-.-.-.-X-X=.=.=,=.-.-A-X-X-X-X~--------------------------------------------------------
------------,-X-.-.-.-.-.-X-X-X-.-.-X-.-.-.-X-X~.~,~.-.-.-E-.-.-.-.-.-.-.-.-X-,-----------------------,-X-.-.-.-.-.-.-.-.-.-.-.-.-.-.-.-.-.-.-.-.-.-.-.-.-.-X-X-.-.-,-X=X=X=----------------------------------------------------------------
--------------,-X-.-.-E-.-.-.-.-.-.-X-.-.-.-X-X-.~,~.-.-.-.-.-.-.-.-.-.-.-.-.-X-,---------------------,-X-.-.-.-.-.-.-.-.-.-.-.-.-.-.-.-.-.-.-.-.-.-.-.-.-.-X-X-.-.-.-X---------------------------------------------------------------------
----------------,-X-.-.-.-E-.-.-.-.-.-.-.-.-,-,-.~,~.-.-.-.-.-.-.-.-.-.-.-.-.-.-X---------------------,-X-.-.-.-A-.-.-.-.-.-.-.-.-.-.-.-.-.-A-.-.-.-.-.-.-.-X-X-.-H-.-X---------------------------------------------------------------------
------------------,-X-.-.-.-.-E-.-.-X-.-.-.-X-X-.~,~,~,-,-,-,-.-.-.-.-A-.-.-.-.-X-,-,-,-,-,-,-,-,-,-,-,-X-.-.-.-.-.-.-.-.-.-.-.-.-.-.-.-.-.-.-.-.-.-.-.-.-.-X-X-.-.-.-X-,-,-----------------------------------------------------------------
,-,-,-,-,-,-,-------,-X-.-.-.-.-.-.-X-.-.-.-X-X~.~.~,~,-.~.~,~.-.-.-XAX-X-.-.-.-X-X-X-X-X-X-X-X-X-X-X-X-X-.-.-.-.-.-.-.-.-.-.-A-.-.-.-.-.-.-.-.-.-.-.-.-.-.-X-X-.-.-.-X-X-X-----------------------------------------------------------------
X-X-X-X-X-X-X-,---,-,-X-.-E-.-.-.-.-.-.-.-.-X-X~.~,~,~,~,~.~,~.-X-Xa.A.-.-.-X-.-X-X-H-.-.-.-.-.-.-.-,-.-,-.-.-.-.-.-.-.-.-.-.-.-.-.-.-.-.-.-.-.-.-.-.-.-.-.-X-X-.-.-.-.-.-X-----------------------------------------------------------------
X-X-.-.-.-.-.-X-,-,-X-X-X-X-X-X-.-.-.-.-.-.-X-X~X~X~X-,-X-X~X~X-.-X-.A.-.-.-.-X-X-X-.-.-.-.-.-.-.-.-,-.-,-.-.-.-.-.-.-.-.-.-.-.-.-.-.-.-.-.-.-.-.-.-.-,=,=,=X=X=.-.-.-.-.-X-----------------------------------------------------------------
X->-.-.-.-.-.-,-X-X-X-X-X-X-X-X-.-.-.-.-.-.-X-X-X-X-X-.-X-X-X-X-Xa.-.-.A.-.-.-X-X-X-.-.-.-.-.-.-.-.-,-.-,-.-.-.-.-.-.-.-,-,-,-,-,-,-.-.-.-.-.-.-.-.-.-,=.=.=.=.=.-.-.-.-.-X-,-,-------------------------------------------------------------
X->-.-.-.-.-.-,-.-+d+-.-.-.-.-.-.-.-.-.-.-.-.-.-.-.-.-.-.-.-.-.-+a.-.-.A.-.-.-.-.-+-.-.-.-.-.-.-.-.-,-.-,-.-.-.-.-.-.-.-,-.>.>.>.>,>.-.-.-.-.-.-.-.-.-,=.=A=.=.=.-.-.-.-.-X6X-X-------------------------------------------------------------
X->-.-.-E-.-.-,-.-+d+-.-.-.-.-.-.-.-.-.-.-.-.-.-.-.-.-.-.-.-.-.-+a.-.-.A.-E-.-A-.-+-.-.-.-.-H-.-.-.-,-.-,-.-.-.-.-.-A-.-,-.>.-t2.-,>.-.-A-.-.-.-.-.-.-,=.=A=.=.=.-.-<-.-.-t6t7X-------------------------------------------------------------
X->-.-.-.-.-.-,-.-+d+-.-.-.-.-.-.-.-.-.-.-.-.-.-.-.-.-.-.-.-.-.-+a.-.-.A.-.-.-.-.-+-.-.-.-.-.-.-.-.-,-.-,-.-.-.-.-.-.-.-,-,>,>,>,>,>.-.-.-.-.-.-.-.-.-,=.=.=.=.=.-.-.-.-.-X6X-X-------------------------------------------------------------
X->-.-.-.-.-.-,-X-XdX-X-X-X-X-X-.-.-.-.-.-.-X-X-X-X-X-,-X-X-X-X-Xa.-.-.A.-.-.-X-X-X-.-.-.-.-.-.-.-.-,-.-,-.-.-.-.-.-.-.-.-.-.-.-.-.-.-.-.-.-.-.-.-.-.-,=,=A=,=.=.-.-.-.-.-X-----------------------------------------------------------------
X-X-.-.-.-.-,-X---,-X~X~X~X-X-X-.-.-.-.-.-.-X-X-X-X-X-,-X-X-X-X-X-.-.A.-.-.-X-X-X-X-.-.-.-.-.-.-.-.-,-.-,-.-.-.-.-.-.-.-.-.-.-.-.-.-.-.-.-.-.-.-.-.-.-.=.=.=X=X=.-.-.-.-.-X-----------------,-,-,-,---------,-,-,-,-------------------------
X-X-.-.-.-X-X-----,-X-.~.~,~,-.-.-.-.-.-.-.-X-X-.-.-.-.-.-.-.-.-X-Xa.A.-.-.-X-.-X-X-H-.-.-.-.-.-.-.-,-.-,-.-.-.-.-.-.-.-.-.-.-.-.-.-.-.-.-.-.-.-.-.-.-.-.-.-X-X-.-.-.-.-.-X-----------------,-X-X-X-,-,-,-,-,-X-X-X-------------------------
,-X-X-X-X-X---------,-X~.~.~,~,-.-.-X-.-.-.-X-X-.-.-.-.-.-.-.-.-.-.-XAX-X-.-.-.-X-X-X-X-X-X-X-X-X-X-X-X-X-.-.-.-.-.-.-.-.-.-.-A-.-.-.-.-.-.-.-.-.-.-.-.-.-.-X-X-.-.-.-X-X-X-----------------,-X-.-X-,-X-X-X-,-X-.-X-------------------------
------------------,-,-X~.~E~.~,~,-,-X-.-.-.-X-X-.-.-.-.-.-.-.-.-.-.-.-A-.-.-.-.-X---------------------,-X-.-.-.-.-.-.-.-.-.-.-.-.-.-.-.@.@.@.-.-.-.-.-.-.-.-X-X-.-.-.-X---------------------,-X-E-X-,-X-H-X-,-X-E-X-------------------------
----------------,-,-X~.~.~.~E~.~.~,~.-.-.-.-,-,-.-.-.-.-.-.-.-.-.-.-.-.-.-.-.-,-X---------------------,-X-.-.-.-A-.-.-.-.-.-.-.-.-.-.-.-.-.-A-.-.-.-.-.-.-.-X-X-.-H-.-X---------------------,-X[,-X[X-X-.-X-X-X[,-X[------------------------
--------------,-,-X~.~.~E~.~.~.~.~,~X-.-.-.-X-X-.-.-.-.-.-E-.-.-.-.-.-.-.-.-,-X-----------------------,-X-.-.-.-.-.-.-.-.-.-.-.-.-.-.-.-.-.-.-.-.-.-.-.-.-.-X-X-.-.-.-X-----------------,-,-,-X-.-.-.-.-.-.-.-.-.-X-------------------------
------------,-,-X~.~.~E~.~.~.~.~.~,~X-.-.-.-X-X-.-.-.-.-.-.-.-.-.-.-,-,-,-,-X-------------------------,-X-.-.-.-.-.-.-.-.-.-.-.-.-.-.-.-.-.-.-.-.-.-.-.-.-.-X-X-.-.-.-X-----------------,-X-X-X-,-.-.-.-.-.-.-.-.-X-------------------------
------------,-X~X~.~.~.~.~.~,~X~X~X~X-+-+-+-X-X-X-X-X-.-.-.-E-.-E-.-E-.~.~.~X~------------------------,-X-.-.-.-.-.-.-.-.-.-.-.-.-.-.-.-.-.-.-.-.-.-.-.-.-.-X-X-.-.-.-X---------------,-,-X-.-.-,-.-.-.-.-.-,-,-,-,-X-,-,-,-,-,-,-----------
------,-,-,-,-,---X-X~X~.~.~X~,-,-,-X-,-,-,-X-,-,-,-,-X-X-.-.-.-.-,-,~.~.~.~X~,-----------------------,-X-.-.-.-.-.-.-.-.-.-.-.-.-.-.-.-.-.-.-.-.-.-.-.-.-,-X-X-.-A-.-X-------------,-,-X-E-.-.-,-.-.-.-.-.-,-.-.-.-X-X-X-X-X-X-X-----------
----,-,-X-X-X-X-X-,---,-X-X-X-X-X-X-X-.-.-.-X-X-X-X-X-,-,-X-.-,-X-X-.~.~.~.~.~X-------------------------,-X-.-.-.-.-.-.-.-.-.-.-.-.-.-.-.-.-.-.-.-.-.-.-,-X-,-X-.-.-.-X-------------,-X;.-.-.-.-,-.-.-.-.-.-,-.-.-.-+-.-.-.-.-.-X-----------
--,-,-X-.-.-H-.-.-X-,-,-X-.-.-.-.-.-.-.-.-.-.-.-.-.-X-,---,-X-X---,-X~.~.~.~,~X~--------------------------,-X-.-.-.-.-.-.-.-.-.-.-H-.-.-.-.-.-.-.-.-.-,-X---,-X-X-X-X-X-------------,-X;.-H-H-.-,-.-E-.-.-.-,-.-.-.-+-.-.-.-.-.-X-----------
,-,-X-.-.-.-.-.-.-,-X-X-X-.-.-.-.-.-.-.-.-.-.-.-.-.-.-X-------------,-X~,~X~X-------------------------------,-X-X-X^+^+^+^X^X-X-X-X-X-X-X-X^+^+^+^X^X-X-----------------------------,-X;.-E-.-.-,-.-.-.-.-.-,-,-.-.-+-.-.-.-.-.-X-----------
,-X-X-.-.-.-.-.-.-,-.-,-+-.-.-.-.-.-.-.-.-.-.-.-.-,-,-X-,-,-----------,-X~--------------------------------------,-X^+^+^+^X^------------,-X^+^+^+^X^----------------------------------,-X-.-.-,-,-.-.-.-.-.-.-,-,-,-X-X-X-.-.-.-X-----------
,-X-H-.-.-E-.-.-.-,-.-,-+-.-.-.-.-.-.-.-.-.-.-,-,~,~.~.~X~X~,---------------------------------------------------,-X-.-.-.-X-------------,-X-.-.-.-X-------------------------------,-,-,-,-X-X-X-.-.-.-.-.-.-.-.-.-X---,-X-.-E-.-X-----------
,-X-X-.-.-.-.-.-.-,-.-,-+-.-.-.-.-.-.-.-.-.-.-,~.~.~.~.~.~.~X---------------------------------------------------,-X-.-E-.-X-------------,-X-.-E-.-X-----------------------------,-,-X-X9X9X9X-X-.-.-,-,-,-,-.-.-.-X---,-X-.-.-.-X-----------
--,-X-.-.-.-.-.-.-,-X-X-X-.-.-.-.-.-.-.-.-.-,-,~.~.~.~.~.~.~X~,-------------------------------------------------,-X-.-.-.-X-------------,-X-.-.-.-X-----------------------------,-.-X-H-.-H-X-X-X-X-X-X[+[X[X-X-X-X---,-X-.-.-.-X-----------
----,-X-.-.-.-.-.-X---,-X-.-.-.-.-E-.-E-E-.-,-.~.~.~.~.~.~.~,~X~------------------------------------------------,-X-.-.-.-X-------------,-X-.-.-.-X-------------,-,-----------,-,-X-,-,-,-,-X-,-,---,-X[+[X[--------,-,-X-.-.-.-X-,---------
----,-X-.-.-H-.-,-X---,-X-X-.-.-.-.-.-.-.-.-,-.~.~.~.~.~.~,~X~--------------------------------------------------,-X-.-.-.-X-------------,-X-.-.-.-X-----------,-,-X-,-------,-,-X9.9.9.9.9.9.9X9X-,-,-X-.-X-------,-,-X-.-.-A-.-.-X-,-------
------,-X-X-X-X-X---------,-X-.-.-.-.-.-.-,-,-.~.~.~,~X~X~X~----------------------------------------------------,-X-.-E-.-X-------------,-X-.-E-.-X---------,-,-X-.-X-,-,-,-,-X9.9.9.9.9.9.9.9.9.9X9,-X-E-X-,-,-,-,-X-.-.-.-.-.-.-.-X-,-----
--------------------------,-X-.-.-.-.-.-,-,-.~.~.~.~X~----------------------------------------------------------,-X-.-H-.-X-------------,-X-.-H-.-X-------,-,-X-.-<-XZX:X-X-X-X-.9.9,9,9,9,9.9.9.9X9X-X-X-X-X-X-X-X-.-.-,-,-,-,-.-.-.-X-----
----------------------------,-X-.-.-<-,-,-.~.~.~.~.~X~----------------------------------------------------------,-X-X?X?X?X-------------,-X-X-X-X-X-------,-X-.-.-.-+Z.:.-.-.-,-.9.9,9.-.-,-.9.9.9.9.-.-.-.-E-.-.-.-.-.-,-.8.8,8.-.-.-X-----
----------------------------,-X-,-X-X-X-.~.~.~.~.~.~X~----------------------------------------------------------------------------------------------,-,-,-,-X-.-A-.-+Z.:E-.-.-,-.9.9A9.-.-A-.9.9.9.9.-.-.-.-.-.-.-.-W-.-,-.8t6,8.-.-A-X-----
--------------------------,-,-X-.-X-,-,-X-X~.~.~.~.~X~----------------------------------------------------------------------------------------,-,-,-,-X-X-X-.-.-.-.-+Z.:.-.-.-,-.9.9,9,-,-,-.9.9.9.9.-.-.-.-E-.-.-.-.-.-,-,8,8,8.-.-.-X-----
------------------------,-,-X-.-.-.-X-,---,-X~X~X~.~X~--------------------------------------------------------------,-,-,-,-------------------,-X~X~X~.~,~,~.-.-.-.-XZX:X-X-X-X-.9.9.9.9.9.9.9.9.9X9X-X-X-X-X-X-X-X-.-.-.-.-.-.-.-.-,-X-----
------------------------,-X-.-.-A-.-,-X---------,-X-X~--------------------------------------------------------------,-X-X-X-----------------,-,-X~.~.~.~.~,~.-.-.-.-.-X-----,-X9.9.9.9.9.9.9.9.9,9X9--------------,-X-.-.-.-.-.-.-,-X-------
--------------------------,-X-,-,-,-X-----------------------------------------------------------------------------,-,-X-.-X-,---------------,-X-.~.~.~.~.~,~,-,-.-.-.-X-,-----,-X9.9.9.9.9.9.9,9X9------------------,-X-.-.-.-.-,-X---------
----------------------------,-XCtCXC--------------------------------------------------------------------------,-,-,-X-X6t6X6X-,-,-----------,-X~.~.~.~.~.~E~.~,~,-,-,-,-X-----,-X-.9.9.9.9.9,9X9----------------------,-XX+X+X+XXX----------
----------------------------,-X-.-X---------------------------------------------------,-,-,-,-,-,-,-,-,-,-----,-X-X-.-.-.-.-.-X-X---------,-,-X~.~.~.~.~.~.~.~.~.~.~.~,~X-------,-X9X9X9X9X9X9------------------------,-XX+X+X+XXX----------
----------------------------,-X-X-X-------------------------------------------------,-,-X-XSXSX-X-X-X-X-X-----,-X-.-.-.-.-.-E-.-X-------,-,-X-.~.~.~.~.~.~.~.~.~.~.~.~X~--------,-,-X-.-X-X-,-,-,-,-,-,-,-,-----------,-X-.-.-.-X-----------
------------------------------------------------------------------------------------,-X4.-+S+S.-.-.-,-,-X-,---,-X-.-.-.-.-.-.-.-X-,-,-,-,-X-X~.~.~.~.~.~.~.~.~.~.~,~,~X~,-----,-,-X-.-.-.-X-X0X0X0X0X0X-X-,-,-,-------,-X-.-E-.-X-----------
------------------------------------------------------------------------------------,-X4E-+S+SA-.-.-,-,-,-X---,-X-.-.-.-E-.-.-.-X-X-X-X-X-.-,-,~.~.~.~.~.~.~.~,~,~,-.-.-X-----,-X-.-.-.-.-.-,0.0.0.0.0,-.-X-X-,-,-----,-X-.-.-.-X-----------
------------------------------------------------------------------------------------,-X4X-XSXSX-X-X-X-,-,-X-,-,-X-.-.-.-.-.-.-.-X-X-.-,-.-.-.-,-.~.~.~.~.~,~,~,-.-.-.-A-X-,-,-,-X-.-.-.-.-.-,0.0.0.0.0,-.-.-.-X-X-----,-X-.-.-.-X-----------
------------------------------------------------------------------------------------------,-X-X-X-X-X-.-.-X-X-X-X-.-E-.-.-.-.-.-L-L-.-,-.-.-.-,-,-.~.~.~.~,~.-.-.-.-.-.-.-X-X-X-.-.-.-.-.-.-,0.0.0.0.0E-.-.-.-.-X-----,-X-.-.-.-X-----------
------------------------------------------------------------------------,-,-,-,-,-,-,-,-,-,-X-.-.-.-.-.-.-.-.-.-X-.-.-.-.-.-.-.-L-L-.-,-,-.-.-.-,-E~.~.~,~,-.-.-.-.-.-.-.-.-.-.-.-.-.-.-,-X-X0X0X0X0X0X-X-.-.-.-,-X---,-X-.-.-.-X-----------
------------------------------------------------------------------------,-X-X-X-X-X-X-X-X2X-X-.-.-.-.-.-.-.-.-.-X-,-.-.-.-.-.-.-L-L-.-,-,-.-.-.-,-.~.~.~,~.-.-.-.-.-.-.-.-.-.-.-.-.-.-,-X---------------X-.-.-.-.-X---,-X-.-.-.-X-----------
------------------------------------------------------------------------,-X-A-.-H-.-.-A-t2.-.-.-.-.-.-.-.-.-.-,-X-X-X-X-X-X-X-X-X-X-.-,-,-H-.-.-,-.~.~.~,~.-.-.-.-.-.-.-.-.-.-.-.-.-.-X-,-,-,-,-,-,-,-,-,-X-.-.-.-X-,-,-X-.-.-.-X-----------
------------------------------------------------------------------------,-X-.-.-.-.-.-.-t2.-.-.-.-.-.-.-.-.-.-,-,-X-X-X-X-X-X-X-X-X-.-,-,-.-.-.-,-.~.~.~,~,-.-.-.-.-.-.-.-.-.-.-.-.-,-X-,-X-X-X-X-X-X-X-X-X-.-.-.-XXX-X-X-.-.-.-X-----------
------------------------------------------------------------------------,-X-A-.-A-.-.-.-t2.-.-.-.-.-.-.-.-.-.-.-X-X-X-,-.-.-,-.-L-L-.-,-.-.-.-,-,-.~.~.~.~,-.-.-.-.-.-.-.-.-.-.-.-.-X-,-X-.-.-.-.-H-.-.-.-.-.-.-.-+X.-.-.-.-.-.-X-----------
------------------------------------------------------------------------,-X-.-.-.-.-.-.-t2.-.-.-.-.3.3.3.-.-.-.-X-XTX-,-.-.-,-.-L-L-.-,-.-.-.-,-.-.~.~.~.~E~.-.-.-.-.-.-.-.-.-.-.-,-X-X-.-.-.-.-.-.-.-.-.-.-.-.-.-+X.-.-.-.-.-.-X-----------
------------------------------------------------------------------------,-X-W-.-H-E-.-.-t2.-.-.-.-.3.-.3.-.-.-.-,-+-.-,-.-t1,-.-L-L-.-,-.-.-.-,-.-.~.~.~,~,-.-.-.-.-.-.-.-.-.-.-,-X-,-X-.-.-.-.-.-.-.-.-.-.-.-.-.-+X.-.-.-.-.-.-X-----------
------------------------------------------------------------------------,-X-.-.-.-.-.-.-t2.-.-.-.-.3.3.3.-.-.-.-X-XTX-,-.-.-,-.-X-X-.-,-,-,-,-,-.-.~.~.~,~.-.-.-.-.-.-.-.-.-.-,-X-,-X-.-.-.-.-.-.-.-.-.-.-.-.-.-.-XXX-X-X-X-X-X-X-----------
------------------------------------------------------------------------,-X-A-.-A-.-.-.-t2.-.-.-.-.-.-.-.-.-.-,-X-X-X-,-.-.-,-.-X-X-X-X-.-.-.-,-,~,~,~,~,~,-,-,-,-,-,-,-,-,-,-X-,-X-.-.-.-.-.-.-.-.-.-.-.-.-.-.-,-X-,-,-,-,-,-,-,-,-,-,-,-,-
------------------------------------------------------------------------,-X-.-.-.-.-.-.-t2.-.-.-.-.-.-.-.-.-.-,-K-X-X-X-X-X-X-X-X-,-,-X-X-X-X-X-X-X-X-X-X-.-.-.-X-X-X-X-X-X-X---,-X-.-.-.-.-.-.-.-.-.-.-.-.-.-,-,-X-X-X-X-X-X-X-X-X-X-X-X-X-
------------------------------------------------------------------------,-X-A-.-H-.-.-A-t2.-.-.-.-.-.-.-.-.-.-.-X-X-,-,-,-,-X-X-X-X-X-X-X-X-X-X-X-X-X-X-X-,-,-,-X-X-X-X-X-X-X-,-,-X-H-,-,-,-,-,-,-,-,-,-,-,-,-,-.-.-.-.-.-.-.-.-.-.-.-.-.-X-
------------------------------------------------------------------------,-X-X-X-X-X-X-X-X2X-X-.-.-.-.-.-.-.-.-,-X---,-X-X-X7.-.-.-.-.-.-,-,-,-,-,-.-.-.-.-.-.-.-.-.-.-.-.-,-X-X-X-X-.-.-.-.-.-.-.-.-.-.-.-.-.-.-.-.-.-.-.-.-.-.-.-.-.-.-.-X-
------------------------------------------------------------------------------------------,-X-.-.-.-.-.-.-.-.-X-----,-X-.-t7.-.-.-.-.-.-,-,-,-,-,-.-.-.-.-.-.-.-.-.-.-.-.-,-.-.-.-L-.-.-.-.-.-.-.-.-.-.-.-.-.-.-.-.-.-.-.-.-.-.-<-.-<-.-.-X-
--------------------------------------------------------------------------------------,-,-,-X-X-X-X-X-,-,-X-X-X-----,-X-.-t7A-.-.-E-.-.-,-,-,-,-,-.-tC.-.-.-A-.-.-.-.-.-.-,-.-A-.-L-W-.-A-<-.-.-.-.-.-.-.-.-.-.-.-.-.-.-.-.-W-.-.-.-.-.-.-X-
------------------------------------------------------------------------------------,-,-X-XSXSX-X-X-X-,-,-X---------,-X-.-t7.-.-.-.-.-.-,-,-,-,-,-.-.-.-.-.-.-.-.-.-.-.-.-,-.-.-.-L-.-.-.-.-.-.-.-.-.-.-.-.-.-.-.-.-.-.-.-.-.-.-<-.-<-.-.-X-
------------------------------------------------------------------------------------,-X-.-+S+S.-.-.-,-,-,-X---------,-X-X-X7.-.-.-.-.-.-,-,-,-,-,-.-.-,-,-,-,-,-,-,-,-,-,-,-X-X-X-X-,-,-,-,-,-,-,-,-,-,-,-,-,-,-.-.-.-.-.-.-.-.-.-.-.-.-.-X-
------------------------------------------------------------------------------------,-X-E-+S+SA-.-.-,-,-X-----------------,-X-X-X-X-X-X-X-X-X-X-X-X-X-X-X-.-.-.-X-X-X-+-X-X-X---,-X-H-.-.-.-.-.-.-.-.-.-.-.-.-,-,-.-.-.-.-.-.-.-.-.-.-.-.-X-
------------------------------------------------------------------------------------,-X-X-XSXSX-X-X-X-X-X---------------------------,-X-X-X-X-X-X-X-X-X-X-,-,-,-X-X-X-+-X-X-X-,-,-X-.-.-.-.-.-.-.-.-.-.-.-.-.-.-,-X-X-X-X-X-X-X-X-X-X-X-X-X-
------------------------------------------------------------------------------------------------------------------------------------,-X-.-.-.-.-.-.-.-.-.-.-.-.-.-.-.-.-.-.-H-X-,-X-.-.-.-.-.-.-.-.-.-.-.-.-.-.-.-X-,-,-,-,-,-,-,-,-,-------
------------------------------------------------------------------------------------------------------------------------------------,-X-,-,-,-,-,-,-,-,-,-,-,-,-,-,-,-,-,-,-,-X-,-,-X-.-.-.-.-.-.-.-.-.-.-.-.-.-.-X-X-X-X-X-X-X-X-X-X-------
------------------------------------------------------------------------------------------------------------------------------------,-X-.-.-.-.-.-.-.-.-.-.-.-.-.-.-.-.-.-.-.-.-X-,-,-X-.-.-.-.-.-.-.-.-.-.-.-.-.-.-.-E-E-.-E-E-.-A-X-------
----------------------------------------------------------------------------------------------------,-,-,-,-,-,-,-,-,-,-,-,-,-,-,-,-,-X-.-.-.-.-.-.-.-.-.-.-.-.-.-.-.-.-.-.-.-.-.-X-,-X-.-.-.-.-.-.-.-.-.-.-.-.-.-.-.-.-.-.-.-.-.-K-X-------
----------------------------------------------------------------------------------------------------,-X-X-X-X-X-X-X-X-X-X-X-X-X-X-X-X-X-.-.-.-.-.-.-.-.-.-.-.-.-.-.-.-.-.-.-.-.-.-.-X-,-X-.-.-.-.-H-.-.-.-.-.-.-.-.-.-E-E-.-E-E-.-A-X-------
----------------------------------------------------------------------------------------------------,-X1t1t1.-.-.-.-.-.-.-.-.-.-.-.-,-,-.-.-.-.-.-.-.-.-.-.-.-.-.-.-.-.-.-.-.-.-.-.-X-,-,-X-X-X-X-X-X-X-X-X-.-.-.-X-X-X-X-X-X-X-X-X-X-------
----------------------------------------------------------------------------------------------------,-X-.-t1H-.-E-.-E-.-W-.-A-.-A-.-,-,-.-.-.-E-.-.-.-.-.-.-.-.-.-.-.-.-.-.-.-.-.-.-.-X-,---------------,-X-.-.-.-X-------------------------
----------------------------------------------------------------------------------------------------,-X1t1t1.-.-.-.-.-.-.-.-.-.-.-.-,-,-.-.-.-.-.-.-.-.-.-.-.-.-.-.-.-.-.-.-.-.-.-.-.-.-X-,-,-,-,-,-,-,-,-X-.-.-,-X-------------------------
----------------------------------------------------------------------------------------------------,-X-X-X-X-X-X-X-X-X-X-X-X-X-X-X-X-X-.-.-.-.-.-.-.-.-.-.-.-.-.-.-.-.-.-.-.-.-.-.-.-.-.-X-X.X.X.X.X.X-X-.-.-.-X---------------------------
--------------------------------------------------------------------------------------------------------------------------------,-,-,-X-.-.-.-.-.-.-.-.-.-.-.-.-.-.-.-.-.-.-.-.-.-.-.-.-.-.-,.........E-.-.-.-.-X---------------------------
--------------------------------------------------------------------------------------------------------------------------------,-X-X-X-.-.-.-.-.-.-.-.-.-.-.-.-.-.-E-.-.-.-.-.-.-.-.-.-.-.-,.........,-.-.-.-,-X---------------------------
------------------------------------------------------------------------------------------------------------------------------,-,-X-.-.-.-.-.-,-,-,-,-,-,-.-.-.-.-.-.-.-.-.-.-.-.-.-.-.-.-.-,.........,-.-,-X-X-----------------------------
------------------------------------------------------------------------------------------------------------------------------,-X-<-.-.-.-.-,-,-.~.~.~.~,-,-,-,-.-.-.-.-.-.-.-.-.-.-.-.-.-X-X.X.X.X.X.X-X-X---------------------------------
------------------------------------------------------------------------------------------------------------------------------,-X-.-.-.-.-,-,-.-.~.~.~.~.~.~.~,-,-,-.-.-.-.-.-.-.-.-.-,-,-X-------------------------------------------------
----------------------------------------------------------------------------------------------------------------------------,-,-X-.-.-.-.-,-.-.~.~.~.~.~.~.~.~.~,~X~X-.-.-.-.-.-.-.-.-X-X---------------------------------------------------
----------------------------------------------------------------------------------------------------------------------------,-X-A-.-.-.-,-,-.~.~.~.~.~.~.~.~.~,~X~--,-X-X-.-.-.-.-.-,-X-----------------------------------------------------
----------------------------------------------------------------------------------------------------------------------------,-X-X-.-.-,-,-.~.~.~.~.~.~.~.~.~,~X~--------,-X-.-.-.-.-X-------------------------------------------------------
------------------------------------------------------------------------------------------------------------------------------,-,-X-X-,-.~.~.~.~.~.~.~.~.~.~X~------------,-X-.-A-X-X-------------------------------------------------------
----------------------------------------------------------------------------------------------------------------------------------,-,-X~.~.~.~.~.~.~.~.~.~.~X~,-------------,-X-X-----------------------------------------------------------
------------------------------------------------------------------------------------------------------------------------------------,-X-.~.~.~.~.~E~.~.~.~.~.~X-----------------------------------------------------------------------------
--------------------------------------------------------------------------------------------------------------------------------------,-X~.~.~.~.~.~.~.~.~.~,~X~----------------------------------------------------------------------------
--------------------------------------------------------------------------------------------------------------------------------------,-X-.~.~.~.~.~.~.~.~A~X~------------------------------------------------------------------------------
----------------------------------------------------------------------------------------------------------------------------------------,-X~.~.~.~.~.~.~.~,~X-------------------------------------------------------------------------------
----------------------------------------------------------------------------------------------------------------------------------------,-X~X~X~X~X~X~X~X~X~--------------------------------------------------------------------------------
