----------------------------------------------------------------------------------------------------------------------------------------------------------,-,-X-X-X-X-X-,---------------------------------
--------------------------------------------------------------------------------------------------------------------------------------------------------,-,-X-.-.-.-.-.-X-,-------------------------------
--------------------------------------------------------------------------------,-,-,-,---------------------------------------------------------------,-,-X-.-.-<-<-<-.-.-X-,-----------------------------
--------------------------------------------------------------,-,-,-,-,-,-,-,-,-,-X-X-X-,-,-,-,-,-----------------------------------------------------,-X-X-.-.-.-<-.-.-.-X-X-----------------------------
--------------------------------------------------------------,-X-X-X~X~X~X~X-X-X-X:.:X:X-X-X-X8X-----------------------------------------------------,-X-.-.-.-.-.-.-.-.-,-X-----------------------------
--------------------------------------------------------------,-X-.-.~.~.~,~.-.-,-.-.-.-X-X-E-t8X-----------------------------------------------------,-X-.-.-.-.-<-.-.-.-,-X-----------------------------
--------------------------------------------------------------,-X~.~.~.~.~,~.-H-,-E-.-E-X-X-E-t8X-----------------------------------------------------,-X-X-.-.-.-.-.-.-.-X-X-----------------------------
--------------------------------------------------------------,-X~.~.~E~.~,~.-.-,-.-.-.-X-X-X-X8X-,-,-,-------------------------------------------------,-X-.-.-.-W-.-.-,-X-------------------------------
--------------------------------------------------------------,-X~.~.~.~.~,~.-.-,-.-.-.-X-X-X-X-X-X-X-X---------------------------------------------------,-X-,-,-,-,-,-X---------------------------------
------------------------------------------------------,-,-,-,-,-X~.~.~.~.~,~.-.-,9.9.9.-,-+-.-.-.-E-.-X-----------------------------------------------------,-X-X.t.X.X-----------------------------------
------------------------------------------------------,-X-X-X^X^,-.~.~.~.~,~.-.-,9.9.9.-,-+-.-.-.-.-A-X-------------------------------,-,-,-,-,-,-,-,-,-,-----,-X-.-X-------------------------------------
------------------------------------------------------,-X-H-+^+^E-.~.~.~.~,~,-,-,9A9.9.-,-+-.-.-.-.-.-X-----------------------------,-,-X-X-X-X-X-X-X-X-X-,---,-X-X-X-------------------------------------
------------------------------------------------------,-X-X-X^X^,-.~.~.~.~,~,~,~,~.9.9.-X-X-X-X-.-.-.-X---------------------------,-,-X-.-E-.-H-A-E-H-E-.-X-,---------------------------------------------
--------------------------------------------------------------,-X~.~.~.~.~,~.-.-,9.9.9.-X---,-X-.-E-.-X---,-,-,-,-----------------,-X-.-A-.-.-.-.-.-.-.-A-.-X---------------------------------------------
--------------------------------------------------------------,-X~.~.~.~.~,~.-.-,-.-.-.-X---,-X-.-.-.-X-,-,-X-X-X---------------,-,-X-.-E-.-.-.-E-.-.-.-E-.-X-,-------------------------------------------
--------------------------------------------------------------,-X~.~.~E~.~,~.-.-,-t8.-t8X---,-X-.-.-.-X-,-X-.-.-,-X-----------,-,-X-X5X-.-X-X-X-.-X-X-X-.-X-X-X-------------------------------------------
--------------------------------------------------------------,-X~.~.~.~.~,~.-.-,-.-.-.-X-,-,-X-.-.-.-X---X-.-.-.-X-----------,-X-X-.5.-.-.-.-.-.-.-.-.-.-.-X-X-,-----------------------------------------
--------------------------------------------------------------,-X~.~.~.~.~,~.-H-,-.-.-.-X-X-X-X-,-,-,-X-,-,-X-.-.-X-,---------,-X-X-,5,-E-,-.-E-.-.-E-.-E-.-.-.-X-----------------------------------------
--------------------------------------------------------------,-X-,-.~.~.~,~.-H-,-.-.-.-X-X-.-.-.-.-.-.-X-X-.-.-.-.-X-,-,-,-,-,-,-X-X5.-.-,-,-,-,-,-,-,-,-,-.-.-X-----------------------------------------
--------------------------------------------------------------,-X-X-X~X~X~X~X-X-X-,-,-,-X-X-E-.-.-.-.-.-.-.-.-.-.-.-.-X-X-X-X-X-X-X-X-.-.-,-.~.~.~.~.~,~.-,-.-.-X-----------------------------------------
------------------------------------------------------------------------------,-X-+-+-+-X-X-X-X-X-.-.-.-.-.-.-.-.-.-.-,-,-.-,-.-,-.-.-.-.-,6.~.~.~.~.~,~.-,-.-.-X-----------------------------------------
------------------------------------------------------------------------------,-X-.-.-.-X-------,-X-.-.-.-.-.-.-.-.-.-,-,-.-,-,-,-.-A-H-.-,-A~.~A~.~A~,~.-,-.-.-X-----------------------------------------
------------------------------------------------------------------------------,-X-.-.-.-X---------X-.-.-.-.-.-.-.-.-.-X-X-X-X-X-X-X-.-.-.-,6.~.~.~.~.~,~.-,-.-.-X-----------------------------------------
------------------------------------------------------------------------------,-X-.-E-.-X---------,-X-.-.-.-.-X-X-H-,-X---------,-X-,-.-.-,-.~.~.~.~.~,~,-,-+W+WX-----------------------------------------
------------------------------------------------------------------------------,-X-.-.-.-X-,-,-,-,-X-X-.-.-.-X-,-,-X-X-----------,-X-,-,-,-,-,~,~,~,~,~,~.-.-.-.-X-----------------------------------------
----------------------------------------------------------------------,-,-,-,-,-X-.-.-.-X-X-X-X-X-.-.-.-.-.-X-------------------,-X-E-.-.-.-.-.-.-.-.-E-.-.-.-,-X-----------------------------------------
,-,-,-,-,-,---,-,-,-,-,-,---------------------------------------------,-X-X-X-X-X-.-.-.-.-.-.-,-.-.-.-.-E-.-,-X-----------------,-X-.-.-.-.-.-.-.-.-.-.-.-.-,-X-------------------------------------------
X->->->-X-X-,-,-X-X-X-X-X-,---------,-,-,-,-,-------------------------,-X-A-A-A-,-.-.-.-E-.-.-,-.-.-E-.-.-.-.-X-----------------,-X-X-X-L-L-L-X-X-X-X-X-X-X-X---------------------------------------------
X-.-.-.-.-XdX-XdXd.-H-.-.-X-----,-,-,-X-X-X-X-,-,---------------------,-X-X-X-X-X-.-.-.-.-.-.-,-.-.-.-.-.-.-.-X-----------------,-X-X-X-L-L-L-X-X-X-,-,-,-,-,-,-,-,-,-------------------------------------
X-.-.-.-.-.D.-+d+d.-E-.-E-X-----,-X-X-.-,-H-,-X-X-----------------------------,-X-.-.-.-X-X-X-X-X-.-.-.-.-.-,-X-----------------,-X-.-E-.-E-E-.-.-X-X-X-X-X-X-X-X-X-X-,-----------------------------------
X-.-.-.-.-XdX-XdXd,-,-,-,-X---,-,-X-,-,-,-,-,-,-X-,---------------------------,-X-.-.-.-X-----,-X-X-.-<-.-,-X-----------,-,-,-,-,-X-.-.-.-.-.-.-.-X-X-.-.-.-.-.-.-,-,-X4,---------------------------------
X-.-<-.-.-X---,-X~.~.~.~.~X~--,-X-,-.-,-X-X-,-.-.-X---------------------------,-X-.-.-.-X-------,-,-X-X-X-X-------------,-X-X-X-X-X-.-.-.-.-.-.-.-.-L-.-.-.-.-.-.-,-,-X-X4,-------------------------------
X-.-E-.-.-X---,-X~.~.~.~.~X~--,-X-,-,-,-X-X-.-,-,-X---------------------------,-X-.-.-.-X-------------------------------,-X-.-H-X-X-.-.-.-.-.-.-.-.-L-.-.-.-E-.-.-,-.-,-,-X4,-,---------------------------
X-H-E-.-H-X---,-X~.~.~.~E~X~--,-X-,-,-,-X-,-X-,-,-X---------------------------,-X-.-.-.-X-------------------------------,-X-.-.-.-.-.-.-.-.-.-.-.-.-L-.-.-.-.-.-,-,-.-:-.-.-X-X-,-------------------------
X-.-.-.-.-X---,-X~.~.~.~.~X~,-,-X-,-,-,-X-,-X-,-,-X---------------------------,-X-.-.-.-X-------------------------------,-X-.-.-.-.-.-.-.-.-:-.-.-X-X-.-.-.-E-.-,-:-.-.-.-.-.-,-X-,-----------------------
X-.-.-.-.-X---,-X~.~.~.~.~X~X~X~X-.-.-.-X-X-X-.-.-X---------------------------,-X-.-.-.-X-------------------------------,-X-.-.-.-.-.-.-.-.-.-.-A-X-X-X-X-X-X-X-X-.-.-.-.-,-,-,-,-X-----------------------
X-.-.-.-.-X---,-X~,~,~.~.~.~.~,~E-.-E-.-,-,-.-E-.-X---------------------------,-X-.-E-.-X-------------------------------,-X-.-.-X-X-X-X-X-X-X-X-X-X-,-,-,-,-,-,-,-X-X-,-,-,-.-.-,-X-,---------------------
X-.-.-.-.-X-,-,-X-.-,-,~.~.~.~,~,-,-,-E-,-,-.-.-.-X---------------------,-,-,-,-X-.-.-,-X-,-,-,-------------,-,-,-,-----,-X-.-,-X-X~X~X~X~X~X~X~X~X~X~X~X~X-X-X-X---,-X-.-.-.-.-,-,-X---------------------
X-.-.-.-.-X-X-X-X-.-,-,-.~.~.~.~.~.~.~,~.-,-.-A-.-X-------------------,-,-X~X~X~X~L-L-L-X~X~X~X~,-----------,-X-X-X-----,-X-,-,-.~.~.~.~.~.~.~.~.~.~.~.~,~.-.-E-X-----,-X-.-.-.-.-,-X-,-------------------
X-.-.-.-.-.-.-.-,-E-,-,-.~.~.~.~.~.~.~,~.-,-.-A-.-X-----------------,-,-X~.~.~.~,~.-.-,-.~.~.~.~X~,-------,-,-X-E-X-,---,-X-,-.~.~.~.~.~.~.~.~.~.~.~.~.~,~.-.-.-X-,-,-,-X-,-.-.-.-.-.-X-,-----------------
X-.-.-.-.-.-.-.-H-.-E-,-.~.~.~.~.~.~.~,~.-,-.-.-.-X-----------------,-X~.~.~.~.~,~.-t<,-.~.~.~.~.~X~----,-,-X-X-,-X-X-,-,-X-.~.~.~.~.~.~.~.~.~,~,~,~,~.~,~.-.-E-X-X-X-X-X-XT,-,-,-,-,-,-X-----------------
X-.-.-.-.-.-.-.-,-E-,-,-.~.~.~.~.~.~.~,~.-,-.-.-.-X-----------------,-X~.~.~.~.~,~.-.-,-.~.~.~.~.~X~--,-,-X-.-.-.-.-.-X-,-X~.~.~.~.~.~.~.~.~.~,~t.t.t..~,~.-.-E-X-X-H-.-.-.-.-.-.-.-.-.-X-----------------
X-X-X-X-X-X-X-X-X-.-,-,-.~.~.~.~.~.~.~,~X-X-,-,-,-X-----------------,-X~.~.~.~.~X~+]+]+]X~X~.~.~.~X~--,-X-.-.-.-.-.-.-.-X-X~.~.~.~.~.~.~.~.~.~,~t..-t..~X~X-X-X-X-X-X-X-X-XT,3,3,3,3,3,3X3,---------------
--------------,-X-,-,-.~.~.~.~.~.~.~.~.~X~X-XFtFXFX-----------,-,-,-,-X~.~.~.~.~X~.-.-.-X-X~.~.~,~X~,-,-X-.-.-.-.-.-.-.-X-X~,~,~,~,~,~,~,~,~,~,~t.t.t.,~X~X-X-X-X-----,-,-X-.-.-.-.-.-.-,-X-,-,---,-,-,---
--------------,-XE,E,E.~.~.~.~.~.~.~.~.~X~,-X-tAX-------------,-X-X-X-X-.~.~.~.~X~.-.-.-X-X~.~.~,~X-X-X-X-,-,-A-,-:-.-.-X-X-.-,-,-.-,-,-,-,-,-,-,-.-,-.-,-H-.-.-X-,-,-,-X-.-.-E-.-.-E-.-,-X-X-X-,-X-X-,-,-
--------------,-X-,-,-,~,~,~,~,~,~.~.~.~X~,-X-X-X-------------,-X-.-E-,-.~.~.~.~X~.-.-.-X-X~.~.~,~.-E-,-X-H-tAtAtA.-.-.-.-L-.-,-,-.-,-,-,-E-,-,-,-.-,-.-,-A-.-.-X-X-X-X-X-.-.-.-.-.-.-.-.-XS.-.-X-.-.-X-X-
--------------,-X-,-,-.-.-.-.-.-,-,~,~,~X~--------------------,-X-.-.-,-.~.~.~.~X~.=.=.=X=X~.~.~,~.-.-,-X-,-tAtFtAA-.-.-.-L-W-,-,-.-,-,-,-E-,-,-,-.-,-.-,-.-A-.-,-t.X-X-X-<-.-H-.-W-H-.-.-,-A-.-A-A-.-A-X-
--------------,-X-,-,-,-,-,-,-,-,-.-.-.-X---------------------,-X-.-E-,-.~.~.~.~,~.-W-.-,-.~.~.~,~.-E-,-X-H-tAtAtA.-.-.-.-L-.-,-,-.-,-,-,-E-,-,-,-.-,-.-,-A-.-.-X-X-X-,-X-.-.-.-.-.-.-.-.-XSX-X-X-X-X-X-X-
--------------,-X-A-.-.-.-.-.-.-.-.-E-.-X---------------------,-X-.-.-,-.~.~.~.~,~E-E-E-,-.~.~.~,~.-.-,-X-.-.-A-.-.-.-.-X-X-.-,-,-,-,-,-,-,-,-,-,-,-,-,-,-H-.-:-X-----,-X-,-,-E-,-,-E-,-,-X---------------
--------------,-X-X-X-X-X-.-.-.-X-X-X-X-X---------------------,-X-.-E-,-.~.~.~.~,~.-.-.-,-.~.~.~,~.-E-,-X-.-.-.-.-.-.-.-X-X-,-,-.~.~.~.~.~.~.~,~t.t.t..~X~X-XO./XO------,-X3.3.3.3.3.3.3X3----------------
--------------,-,-,-,-,-X-+-+-+-X-,-,-------------------------,-X-+-X-X-.~.~.~.~X~A-A-A-X-X~.~.~,~X-X-X-X-.-.-.-.-.-.-,-X-X~.~.~.~.~.~.~.~.~.~,~t..-t..~,~.-.-E-X-------,-X-.-.-.-.-.-.-X-----------------
--------------,-X-X-X-X-XC.C.C,CX~X~X~,-----------------------,-X-+-X-X~.~E~.~.~X~.-H-.-X-X~.~.~.~X~----,-X-.-,-,-.-,-X-,-X~.~.~.~.~.~.~.~.~.~,~t.t.t..~,~.-.-.-X-----,-,-X-,-,-,-,-,-,-X-----------------
--------------,-X-.-,-,-,C,C,C,C.~.~.~X~,---------------------,-X-,-X-X~.~.~.~.~X~.-.-.-X-X~.~.~.~X~------,-X-X-E-X-X---,-X-,~.~.~.~.~.~.~.~.~.~.~.~.~.~,~.-.-H-X-----,-.-X-.-.-.-.-.-X-------------------
--------------,-X-,-,-.~.~.~.~.~.~.~.~.~X~--------------------,-X-,-X-X~,~,~,~.~X~.-H>.-X-X~.~.~.~X~--------,-X`+`X`----,-X-,-,~.~.~.~.~.~.~.~.~.~.~.~.~,~.-.-W-X---,-,-X-.-.-.-.-,-,-X-------------------
--------------,-X-,-,~,~,~,~,~,~,~.~.~.~X~--------------------,-X-.-X-X~X-.-X-X~X~X>,-X>X-X~X~,~X~X~--------,-X`+`X`----,-X-.-,-,~,~.~.~.~.~.~.~.~.~.~.~X~X-X-X-X---,-.-X-.-.-.-,-,-X---------------------
--------------,-X-.-,-,~,-.-.-.-,-.~.~.~X~--------------------,-X-,-X-X-X-.-X---,-X-X-X---,-X-.-X-----------,-X-.-X-----,-X-.-.-X-X0X~X~X~X~X~X~X~X~X~X~X~------,-,-,-X-.-.-.-.-,-X-,---------------------
--------------,-X-A-,-,~,-E-.-E-,-.~.~.~X~--------------------,-X-,-,-,-+-A-X-,-,-,-,-,-,-,-X-A-X-----------,-X-.-X-----,-X-.-,-,-X0,-,-,-,-,-,-,-,-,-,-,-,-,-,-,-X-X-,-,-,-.-.-,-X-----------------------
--------------,-X-.-,-,~,-.-E-.-,-.~.~.~X~--------------------,-X-X-X-X-X-.-.-X-,-X=X=X=,-X-.-,-X-----------,-X-X-X-----,-X-,-,-X0X0X-X-X-X-X-X-X-X-X-X-X-X-X-X-X-.-.-.-.-,-,-,-X-------------------------
--------------,-X-,-,-,~,-.-.-.-,-.~.~.~X~------------------------------,-X-.-.-X-X^+^X^X-.-,-X-------------------------,-X0.0.0.0.-.-.-.-E-.-.-.-L-.-.-.-.-E-.-,-,-.-.-.-.-.-,-X-------------------------
--------------,-X-.-,-,~,-,-,-,-,-.~.~.~X~--------------------------------,-X-.-A-.-.-.-A-,-X---------------------------,-X0.0.0.0.-.-.-.-.-.-.-.-L-.-.-.-.-.-.-.-,-.-,-,-,-X-X---------------------------
--------------,-X-,-,-,~,~,~,~A~,~,~,~,~X~,---------------------------------,-X-.-.-<-.-,-X-----------------------------,-X0X0X0X0.-.-.-.-E-.-,-,-L-.-.-.-.-.-.-.-,-,-,-,-X-------------------------------
------------,-,-X-E-,-,~.-,-.-,-.-,-.-E-X-X-----------------------------------,-X<t<X<X-X-------------------------------------,-X-.-.-.-.-E-.-,-X-X-X-.-.-.-E-.-.-.-,-X-X---------------------------------
------------,-X-.-.-,-,-.-,-.-A-.-,-.-,-.-X-----------------------------------,-X-.-X-----------------------------------------,-X-X-X-.-.-.-X-X-X-X-X-X-X-X-X-X-X-X-X-------------------------------------
------------,-X-,-,-X-X-X-X-X-X-X-X-X-X-X-X-----------------------------------,-X-X-X-------------------------------------,-,-,-,-,-X-+-+-+-X-,-,-,-,-----------------------------------------------------
------------,-X-X-X-------------------------------------------------------------------------------------------------------,-X-X-X-X-X-.-.-.-X-X-X-X-X-----------------------------------------------------
--------------------------------------------------------------------------------------------------------------------,-,-,-,-X-H-.-.-.-.-H-.-.-.-.-H-X-,-,-,-----------------------------------------------
--------------------------------------------------------------------------------------------------------------------,-X-X-X-XQ.-.-.-.-.-:-.-.-.-.-,-X-X-X-X-----------------------------------------------
--------------------------------------------------------------------------------------------------------------------,-X-.-E-,-.-.-.-,-,~,~,~.-.-.-,-.-.-E-X-----------------------------------------------
--------------------------------------------------------------------------------------------------------------------,-X-.-.-,-.-.-.-,~,~,~,~.-.-.-,-.-.-.-X-----------------------------------------------
--------------------------------------------------------------------------------------------------------------------,-X-.-E-,-.-.-.-.~.2.2.2.-.-.-,-.-.-.-X-----------------------------------------------
--------------------------------------------------------------------------------------------------------------------,-X-.-.-,-.-.-.-.~.2K2.2.-.-.-,-.-.-E-X-----------------------------------------------
--------------------------------------------------------------------------------------------------------------------,-X-.-E-,-.-.-,-,-,2,2,2,-,-.-,-.-.-E-X-----------------------------------------------
--------------------------------------------------------------------------------------------------------------------,-X-.-.-,-.-E-,-,1,~,~,~,1,-E-,-.-.-.-X-----------------------------------------------
--------------------------------------------------------------------------------------------------------------------,-X-.-E-,-.-.-.-.-.-E-.-.-.-.-,-.-.-E-X-----------------------------------------------
--------------------------------------------------------------------------------------------------------------------,-X-X-X-XQ.-.-.-.-.-.-.-.-.-.-,-X-X-X-X-----------------------------------------------
--------------------------------------------------------------------------------------------------------------------------,-X-.-.-,-,-,-A-,-,-.-.-.-X-----------------------------------------------------
--------------------------------------------------------------------------------------------------------------------------,-X-X-X-X-X-.-.-.-X-X-X-X-X-----------------------------------------------------
----------------------------------------------------------------------------------------------------------------------------------,-X-.-.-.-X-------------------------------------------------------------
----------------------------------------------------------------------------------------------------------------------------------,-X-E-E-E-X-------------------------------------------------------------
----------------------------------------------------------------------------------------------------------------------------------,-X-.-.-.-X-------------------------------------------------------------
----------------------------------------------------------------------------------------------------------------------------------,-X-X-X-X-X-------------------------------------------------------------
