------------------------------------------------------------------------------,-X-X-X-X-X-X-X-X-X-X-X-X-X-X-X-X-X-X-X-X-X-X-X-X-X-X-X-X-X---------------
------------------------------------------------------------------------------,-X-.-.-.-.-.-.-.-.-.-.-.-.-.-.-.-.-.-.-.-.-.-.-.-.-.-.-.-X---------------
------------------------------------------------------------------------------,-X-.-.-.-.-.-.-.-.-.-.-.-.-.-.-.-.-.-.-.-.-.-.-.-.-.-.-.-X---------------
------------------------------------------------------------------------------,-X-.-.-,-,-,-,-,-,-,-,-,-,-,-,-,-,-,-,-,-,-,-,-,-,-.-.-.-X---------------
------------------------------------------------------------------------------,-X-.-.-,-,-,-,-,-,-,-,-,-,-,-,-,-,-,-,-,-,-,-,-,-,-.-.-.-X---------------
------------------------------------------------------------------------------,-X-.-.-,-,-.-.-.-.-.-.-.-,-.4.4,4.-.-.-.-.-.-.-<-,-.-.-.-X---------------
------------------------------------------------------------------------------,-X-.-.-,-,-.-.-.-.-.-.-.-,-.4K-,4.-.-.-.-.-.-.-,-,-.-.-.-X---------------
------------------------------------------------------------------------------,-X-.-.-,-,-.-.-.-.-E-.-.-,-,4,4,4.-.-.-.-.-.-.-,-,-.-.-.-X---------------
------------------------------------------------------------------------------,-X-.-.-,-,-.-.-.-.-.-.-.-.-.-.-.-.-.-.-.-.-.-.-,-,-.-.-.-X---------------
------------------------------------------------------------------------------,-X-.-.-,-,-.-.-.-.-.-.-.-.-.-.-.-.-.-.-.-.-.-.-,-,-.-.-.-X---------------
------------------------------------------------------------------------------,-X-.-.-,-,-.-.-.-.-.-.-.-.-.-A-.-.-.-.-.-.-.-.-,-,-.-.-.-X---------------
------------------------------------------------------------------------------,-X-.-.-,-,-.-.-.-.-.-.-.-.-.-.-.-.-.-.-.-.-.-.-,-,-.-.-.-X---------------
------------------------------------------------------------------------------,-X-.-.-,-,-.-.-.-.-.-.-.-,3,3,3,3.3.-.-.-.-.-.-,-,-.-.-.-X---------------
------------------------------------------------------------------------------,-X-.-.-,-,-.-.-.-.-.-.-.-,3.3.3,3.3.-.-.-.-.-.-,-,-.-.-.-X---------------
------------------------------------------------------------------------------,-X-.-.-,-,-.-.-.-,-,-,-A-,3.3.3,3,3,-A-,-.-.-.-,-,-.-.-.-X---------------
------------------------------------------------------------------------------,-X-.-.-,-,-.-.-,-,-.-.-,-,3.3.3,3,3.-.-,-,-.-.-,-,-.-.-.-X---------------
------------------------------------------------------------------------------,-X-.-.-,-X-XT.-,-X-.-.-.-X3.3.3,3X3X-.-.-X-XT.-.-XT.-.-.-X---------------
------------------------------------------------------------------------------,-X-.-,-X-,-X-.-,-X-.-.-.-,-E-E-E-,-.-.-.-X-X-.-.-X-X-.-.-X---------------
------------------------------------------------------------------------------,-X-,-X---,-X-E-,-X-.-.-.-,-.-.-.-,-.-.-.-X-X-E-.-X-,-X-.-X---------------
------------------------------------------------------------------------------,-X-X-----,-X-.-,-X-X-.-.-,-.-.-.-,-.-.-X-X-X-.-.-X---,-X-X---------------
------------------------------------------------------------------------------,-X-------,-X-X-X-X-X-.-.-,-.-.-.-,-.-.-X-,-X-X-X-X-----,-X---------------
--------------------------------------------------------------------------------------------,-X-X-X-.-.-,-.-.-.-,-.-.-X-X-X-----------------------------
----------------------------------------------------------------------------------------------,-X-.-.-.-,-.-.-.-,-.-.-.-X-------------------------------
------------------------------------------------------------------,-,-,-,-,-,-,-,-,-,-,-,-----,-X-.-.-.-,-.-.-.-,-.-.-,-X-------------------------------
------------------------------------------------------------------,-X-X-X-X-X0X-X-X-X-X-X-------,-X-X-X-X-.-.-.-X-X-X-X---------------------------------
------------------------------------------------------------------,-X-.-.-,-.0.-.-.-.-.-X---,-,-,-,-,-,-X-.-A-.-X-,-,-,-,-,-,---------------------------
------------------------------------------------------------------,-X-.-E-,-.0.-.-.-<-.-X---,-X-X-X-X-X-X-.-.-.-X-X-X-X-X-X-X---------------------------
------------------------------------------------------------------,-X-.-.-,-.0.-.-.-.-.-X-,-,-X-.-.-.-.-.-.-.-.-.-.-.-.-.-.-X-,-,-----------------------
----------------------------------------------------------------,-,-X-.-.-,-X0X-X-.-.-.-X-X-X-X-.-.-.-.-.-.-.-.-.-.-.-.-.-.-X-X-X-----------------------
----------------------------------------------------------------,-X-X-+-+-+-X-X-X-.-.-.-X-X-.-.-.-.-,-,-,-,-,-,-,-,-.-.-.-.-.-.-X-----------------------
--------------------------------------------------------------,-,-X-.-.-.-.-.-X-X-.-.-.-X-X-,-,-,-,-,-X2.2.2.2.2.2X2X-,-,-,-,-,-X-----------------------
--------------------------,-,-,-,-,-,-----------,-,-,-,-,-,-,-,-X-.-B-.-.-.-.-X-X-.-.-.-X-X-,-,-E-,-,-X2.2.2A2.2.2X2X-,-,-E-,-,-X-------------------,-,-
------------------------,-,-X-X-X-X-X-,-------,-,-X-X-X-X-X-X-XN.-.-.-.-.-.-.-X-X-.-E-.-X-X-.-.-.-.-,-X2.2.2.2.2.2X2X-,-,-,-,-,-X-----------------,-,-X-
----------------------,-,-X-.-.-.-.-.-X-,-,-,-,-X-.-.-.-.-.-.-.-.-.-.-.-.-.-.-X-X-.-.-.-X-X-,-,-,-,-,-X2.2.2H2.2.2X2X-.-.-.-.-.-X-,-,-,-,-,-,-,-,-,-X-X-
----------------------,-X-<-.-.-.-.-.-.-X-X-X-X-.-.-.-.-.-.-B-+N.-.-.-.-.-.-.-,-.-.-.-.-X-X-,-,-,-,-,-X-.-.-.-.-.-X-X-,-,-,-,-,-X-X-X-X-X-X-X-X-X-X-.-X-
----------------------,-X-.-.-.-.-.-W-.-.-.-+-+-.-.-.-.-.-X-X-XN.-.-.-.-.-.-.-X-X-.-.-.-X-X-.-.-.-.-,-X-.-E-E-.-E-X-.-.-.-.-.-.-X-X-.-.-.-.-.-.-,-.-.-X-
----------------------,-X-<-<-<-.-.-.-H-.-.-+-+-.-.-.-E-H-X-,-X-A-.-.-.-.-.-.-X-X-.-E-.-X-X-.-.-.-.-.-,-,-,-,-,-,-,-.-.-.-.-.-.-X-X-.-.-.-.-.-.-,-.-.-X-
----------------------,-X-<-.-.-.-.-.-.-.-.-+-+-.-.-.-.-.-X-X-XN.-.-.-.-.-.-.-X-X-.-.-.-X-X-.-.-.-.-.-.-.-.-.-.-.-.-.-.-.-.-.-.-X-X-.-.-.-.-.-.-,-.-.-X-
----------------------,-X-.-.-.-.-.-.-,-X-X-X-X-.-.-.-.-.-.-.-.-.-.-.-.-.-.-.-,-.-.-.-.-X-X-.-.-.-.-.-.-.-.-A-.-.-.-.-.-.-.-.-.-X-X-.-.-.-.-.-.-,-.-.-X-
------------------------,-X-.-.-.-.-,-X-------,-X-,-,-,-,-,-.-+N.-.-.-.-.-.-.-X-X-.-.-.-X-X-.-.-.-.-.-.-.-.-.-.-.-.-.-.-.-.-.-.-X-X-.-.-.-.-.-.-,-.-.-X-
--------------------------,-X-X-X-X-X-----------,-X-,-,-,-X-X-XN.-.-.-.-.-.-.-X-X-.-E-.-X-X-.-.-.-.-.-.-.-.-.-.-.-.-.-.-.-.-.-.-X-X-.-.-.-.-.-.-,-.-.-X-
------------------------------------------------,-X-,-,-,-X---,-X-,-,-,-.-.-.-X-X-.-.-.-X-X-.-.-.-.-.-.-.-.-.-.-.-.-.-.-.-.-.-,-X-X-.-.-.-.-.-.-,-.-.-X-
------------------------------------------------,-X-,-,-,-X-----,-X-.-,-,-,-.-,-.-.-.-.-X-X-.-.-.-.-.-.-.-.-.-.-.-.-.-.-.-.-.-X-,-X-.-.-.-.-.-.-,-.-.-X-
------------------------------------------------,-X-.-.-.-X-----,-X-,-,/./,/.-X-X-.-.-.-X-X-X-L-L-L-X-X-X-X-X-X-X-X-X-L-L-L-X-X-X-X-.-.-.-.-.-.-,-.-.-X-
------------------------------------------------,-X-.-.-.-X-----,-X-H-././,/.-X-X-.-.-.-.-.-.-.-.-.-.-.-.-.-.-.-.-.-.-.-.-.-.-.-X-X-.-.-.-.-.-.-,-.-.-X-
,-,-,-,-,-------,-,-,-,-,-,-,---------------,-,-,-X-.-.-X-X-,-,-,-X-X-X/X/X/X-X-X-.-E-.-.-.-.-E-.-.-E-.-.-.-.-E-.-.-E-.-.-.-H-,-X-X-.-.-.-.-.-.-,-.-.-X-
X-X-X-X-X---,-,-X-X-X-X-X-X-,-,-,-----------,-X-X-X-.-.-X-XUX-X-X-X-X-X-------,-X-.-.-.-.-.-.-.-.-.-.-.-.-.-.-.-.-.-.-.-.-.-,-,-X-X-.-.-.-.-.-.-,-.-.-X-
X-H-A-.-X-,-X-X9.-.-.-.-.-.-X-X-,-,---------,-X-.-.-.-.-.-.-.-.-H-E-H-X-------,-X-X-X-X-X-,-X-X-X-,-X-X-X-,-X-X-X-X-X-X-X-X-X-X-,-.-.-.-.-.-.-.-,-.-.-X-
X-A-.-.-XYXY.-.9.-.-.-.-.-E-.-.-X-X-,-------,-X-.-.-.-.-.-.-.-.-.-.-H-X-----------,-X-X-X-.-X-X-X-.-X-X-X-,-X-X-X-X-X-X-X-X-X-X-.-.-.-.-.-.-.-.-,-.-.-X-
X-E-.-+Y+Y.-.-.9.-.-.-.-.-.-.-.-.-.-X-------,-X-.-.-.-.-.-.-.-.-.-.-.-X-,-,-------,-X-B-.-.-.-.-.-.-.-.-.-,-.-.-.-H-X-X-.-.-.-.-.-.-.-.-.-.-.-.-,-.-.-X-
X-X-XY+Y.-.-.-E9.-.-.-.-.-.-.-.-.-.-X-,-,-,-,-X-X-X-X-X-.-.-.-.-.-+U.-XUX-X-------,-X-B-.-.-.-.-.-.-.-.-.-,-.-.-.-,-X-X-.-.-.-.-.-.-.-.-.-.-.-.-,-.-.-X-
,-,-XY.-.-.-.-.9.-.-.-.-.-.-.-.-.-.-.-X-X-X-X-X-X-X-X-X-X-.-.-.-.-.-.-.-.-X-------,-X-B-.-.-.-.-.-.-.-.-.-,-E-.-.-,-,-.-.-.-.-.-.-.-.-.-.-.-.-.-,-.-.-X-
,-.-X-.-E-.-.-.9.-.-.-.-.-.-.-.-.-.-.-.-.-.-,-,-A-.-.-.-X-X-.-.-.-.-.-.-.-X-------,-X-.-.-.-.-.-.-.-.-,-,-,-.-.-.-,-X-X-.-.-.-.-.-.-.-.-.-.-.-.-,-.-.-X-
,-X-.-.-.-.-.-.9.-.-.-.-.-.-.-.-.-.-.-.-.-.-,-,-.-.-.-.-.-.-X-.-.-.-.-.-X-X-------,-X-,-,-,-,-,-,-,-,-,-.-.-.-,-,-,-X-X-.-.-.-.-.-.-.-.-.-.-.-.-,-.-.-X-
,-X-.-.-.-.-.-.9.-.-.-.-.-.-.-.-.-.-.-.-.-.-,-,-A-.-.-.-.-.-X-.-.-.-.-H-X-,-,-,-,-,-X-A-.-.-.-.-.-.-.-.-.-.-,-,-.-.-X-X-.-.-.-.-.-.-.-.-.-.-.-.-,-.-.-X-
X-,-.-E-,-,-,-.9.-.->->->-.-E-.-.-.-.-.-.-.-,-,-.-.-.-E-.-.-X-E-.-.-.-.-X-X-X-X-X-X-X-.-.-.-.-.-.-.-.-.-.-,-,-.-.-,-,-.-.-.-.-.-.-.-.-.-.-.-.-.-,-.-.-X-
X-,-.-,-.8.-,-.9.->-.-E->-.-.-.-.-.-.-.-.-.-,-,-.-.-.-.-.-.-.-.-.-.-.-.-.-.-.-,-,-,-,-.-.-.-.-.-.-.-.-.-.-,-.-.-.-,-X.X-.-.-.-.-.-.-.-.-.-.-.-.-,-.-.-X-
X-,-.-E-H8.-,-.9.->-.-.->-.-.-.-.-H-.-.-.-.-A-,-.-.-A-E-.-.-.-.-E-.-.-.-.-.-.-A-,-,-,-.-.-.-.-.-.-.-.-.-E-,-.-<-.-A-X.X-.-.-.-.-.-.-.-.-.-.-.-.-,-.-.-X-
X-,-.-,-,8,-,-.9.-.->-E->-.-E-.-.-.-.-.-.-.-,-,-.-.-.-.-.-.-.-E-.-.-.-.-.-.-.-,-,-,-,-,-,-,-,-,-,-,-,-,-.-,-,-.-.-,-X.X-.-.-.-.-.-.-.-.-.-.-.-.-,-.-.-X-
X-,-.-.-.-.-.-.9.-.-.->-.-.-.-.-.-.-.-.-.-.-,-,-.-.-.-E-.-.-X-.-.-.-.-.-X-X-X-X-X-X-X-.-.-.-.-.-.-.-.-,-,-.-,-,-.-.-.-.-.-.-.-.-.-.-.-.-.-.-.-.-,-.-.-X-
X-.-.-.-.-.-.-.9.-.-.-.-.-.-.-.-.-.-.-.-.-.-,-,-A-.-.-.-.-.-X-.-.-.-.-H-X-,-------,-X-A-.-.-.-.-.-.-.-.-,-,-.-,-,-,-X-X-.-.-.-.-.-.-.-.-.-.-.-.-,-.-.-X-
,-X-.-.-E-.-.-.9.-.-.-.-.-.-.-.-.-.-.-.-.-.-,-,-.-.-.-.-.-.-X-.-.-.-.-.-X-X-------,-X-.-.-.-.-.-.-.-.-.-.-,-,-.-.-,-X-X-.-.-.-.-.-.-.-.-.-.-.-.-,-.-.-X-
--X-.-.-.-.-.-.9.-.-.-.-.-.-.-.-.-.-.-.-.-.-,-,-A-.-.-.-X-X-.-.-.-.-.-.-.-X-------,-X-,-,-.-.-.-.-.-.-.-.-E-,-.-.-B-X-X-.-.-.-.-.-.-.-.-.-.-.-.-,-.-.-X-
,-X-XY.-.-.-.-.9.-.-.-.-.-.-.-.-.-.-,-X-X-X-X-X-X-X-X-X-X-.-.-.-.-.-.-.-.-X-------,-X-.-,-.-.-.-.-.-.-.-.-.-,-.-.-,-,-.-.-.-.-.-.-.-.-.-.-.-.-.-,-.-.-X-
X-.-.-+Y.-.-E-.9.-.-.-.-.-.-.-.-.-.-X-------,-X-X-X-X-X-.-.-.-.-.-+U.-XUX-X-------,-X-.-,-.-.-.-.-.-.-.-.-.-,-.-.-,-X-X-.-.-.-.-.-.-.-.-.-.-.-.-,-.-.-X-
X-E-.-.-+Y.-.-.9.-.-.-.-.-E-.-.-.-,-X-,-,-,-,-X-.-.-<-.-.-.-.-.-.-.-H-X-,-,-,-,-,-,-X-,-,-,-,-,-,-,-,-,-,-,-,-,-,-H-X-X-,-,-,-,-.-.-.-.-.-.-.-.-,-.-.-X-
X-A-E-.-XYXYX-.9.-,-,-,-,-.-,-,-X-X---,-X-X-X-X-.-.-.-.-.-.-.-.-.-.-.-X-X-X-X-X-X-X-X-X-X-.-X-X-X-.-X-X-X-.-X-X-X-X-X-X-X-X-X-X-,-.-.-.-.-.-.-.-,-.-.-X-
X-H-A-.-X-,-,-X9X-X-X-X-X-X-X-X-------,-X-.-.-+-.-.-.-.-.-.-.-E-H-E-H-X-X-,-.-.-.-.-.-.-.-.-.-.-.-.-.-.-.-.-.-.-.-.-.-.-.-.-.-.-,-,-.-.-.-.-.-.-,-.-.-X-
X-X-X-X-X-----------------------------,-X-.-.-X-X-X-.-.-X-XUX-X-X-X-X-X-X-,-.-.-.-.-.-E-.-.-.-.-.-.-.-E-.-.-.-.-.-.-.-.-.-.-.-.-X-X-.-.-.-.-.-.-,-.-.-X-
--------------------------------------,-X-A-W-X-,-X-,-,-,-X-----------,-X-,-.-.-.-.-.-.-.-.-.-E-.-.-.-.-.-.-.-E-.-.-.-.-.-.-H-.-X-X-.-.-.-.-.-.-,-.-.-X-
--------------------------------------,-X-.-:-X-,-X-,-,-,-X-----------,-X-.-.-.-.-.-.-,-X-X-X-X-X-+-X-X-X-X-X-.-.-.-.-.-X-X-X-X-X-X-.-.-.-.-.-.-,-.-.-X-
--------------------------------------,-X-.-A-X-,-X-,-,-,-X-----------,-X-.-.-.-.-.-,-X-,-,-,-,-X-+-X-,-,-,---X-.-.-.-.-X-------,-X-.-.-.-.-.-.-,-.-.-X-
--------------------------------------,-X-X-X-X-,-X-,-,-,-X-----------,-X-.-.-.-.-.-X-X-X-X-XQX-XQ.-XQX-XQX-X-,-X-.-.-.-X-,-,---,-X-.-.-.-.-.-.-,-.-.-X-
------------------------------------------------,-X-,-,-,-X-,-,-,-,-,-,-X-.-.-.-.-.-X-.-.-.-.-.-.-.-.-.-.-.-.-X-X-.-.-.-X-X-X---,-X-.-.-.-.-.-.-,-.-.-X-
------------------------------------------------,-X-.-.-,-X-X-X-X-X-X-X-X-.-.-.-.-,-X-.-E-.-.-.-.-E-.-.-.-.-.-X-X-.-.-.-.-A-X---,-X-.-.-.-.-.-.-,-.-.-X-
------------------------------------------------,-X-.-.-,-E-,-,-,-,-E-,-.-.-.-.-.-,-X-.-.-.-.-.-.-.-.-.-.-E-.-X-X-.-.-.-.-.-X---,-X-.-.-.-.-.-.-,-.-.-X-
------------------------------------------------,-X-.-E-,-,-,-,-,-,-,-,-.-.-.-.-.-,-,-.-E-.-.-.-.-.-.-.-.-E-.-.-.-.-.-.-.-A-X---,-X-.-.-.-.-.-.-,-.-.-X-
------------------------------------------------,-X-.-.-,-,-,-,-,-,-E-,-.-.-.-.-.-,-X-.-.-.-.-.-.-E-.-.-.-.-.-X-X-.-.-.-.-.-X---,-X-.-.-.-.-.-.-,-.-.-X-
------------------------------------------------,-X-X-X-X-X-X-X-X-X-X-X-X-,-.-.-.-.-X-.-E-.-.-.-.-.-.-.-.-.-.-X-X-.-.-.-.-A-X---,-X-.-.-.-.-.-.-,-.-.-X-
----------------------------------------------------------------------,-X-,-.-.-.-.-X-.-.-.-.-.-.-.-.-.-.-E-,-X-X-.-.-.-X-X-X---,-X-.-.-.-.-.-.-,-.-.-X-
----------------------------------------------------------------------,-X-X-X-X-X-X-X-X-.-.-.-.-.-E-.-,-,-,-X-,-X-.-.-.-X-,-,-,-,-X-X-X-X-X-X-X-X-X-.-X-
--------------------------------------------------------------------------------------,-X-X-XQ.-A-W-A-,-X-X-X-X-X-+-+-+-X-X-X-X-X-,---------------,-X-X-
--------------------------------------------------------------------------------------------,-X-X-X-X-X-.-.-.-,-.-.-.-.-,-.-.-.-.-X-,---------------,-X-
--------------------------------------------------------------------,-,-,-,-,-,-------------------,-X-.-.-.-,-,-.-.-.-.-,-,-.-.-.-.-X-------------------
--------------------------------------------------------------------,-X-X-X-X-X-------------------,-X-.-.-.-,-.-.-.-.-.-.-,-.-.-.-.-X-------------------
--------------------------------------------------------------------,-X-,-.-A-X-,-,-,-,-,-,-,-,---,-X-,-,-,-,-.-.-.-H-.-.-,-,-,-,-,-X-------------------
--------------------------------------------------------------------,-X-H-.-.-X-X-X-X-X-X-X-X-X---,-X-.-,-X-X-X-,-X-X-X-,-X-X-X-.-.-X-------------------
--------------------------------------------------------------------,-X-.-.-.-.-,-.-,-.-,-.-.-X---,-X-.-,-X-X-X-,-X-X-X-,-X-X-X-.-.-X-------------------
--------------------------------------------------------------------,-X-X-X-.-.-,-.-,-,-,-.-.-X---,-X-.-,-XQ,-XQ,-XQ,-XQ,-XQ,-XQ.-.-X-------------------
------------------------------------------------------------------------,-X-.-.-,-,-,-,-.-.-.-X---,-X-,-,-,-,-.-.-,-,-.-.-,-,-,-,-,-X-------------------
------------------------------------------------------------------------,-X-.-.-E-.-,-,-,-.-.-X---,-X-.-.-.-.-.-.-.-.-.-.-.-.-.-.-.-X-------------------
------------------------------------------------------------------------,-X-.-E-.-.-,---,-.-.-X-,-,-X-.-.-.-.-.-.-.-.-.-.-.-.-.-.-.-X-------------------
------------------------------------------------------------------------,-X5E-.-.-.-,-,-,-,-,-X-X-X-X-E-.-.-.-.-.-.-.-.-.-.-.-.-.-E-X-------------------
------------------------------------------------------------------------,-X5.-.-.-.-A-.-.-,-,-,-.-L-L-.-.-.-E-.-E-.-E-.-.-E-.-.-.-.-X-------------------
------------------------------------------------------------------------,-X5E-.-.-.-.-.-.-.-.-X-X-X-X-.-.-.-.-.-.-.-.-.-.-.-.-.-:-.-X-------------------
------------------------------------------------------------------------,-X-.-.-.-.-.-.-.-.-.-X---,-X-.-.-.-.-,-,-,-,-,-,-.-.-.-.-.-X-------------------
------------------------------------------------------------------------,-X-.-E-.-.-.-.-.-.-.-X---,-X-.-.-X-X-X-,-,-,-,-,-X-X-X-.-.-X-------------------
--------------------------------------------------------------------,-,-,-X-.-.-E-.-.-.-.-.-.-X---,-X-.-.-X-,-X-.-.-.-.-.-X-,-X-.-.-X-------------------
--------------------------------------------------------------------,-X-X-X-.-.-.-.-.-.-.-.-.-X---,-XQ+Q+QXQ,-X-.-,1,1.1,-X-,-XQ+Q+QXQ------------------
--------------------------------------------------------------------,-X-A-.-.-.-.-.-.-.-.-.-.-X---,-XQ+Q+QXQ--,-X-,1K-,1X---,-XQ+Q+QXQ------------------
--------------------------------------------------------------------,-X-.-.-.-X-X-X-X-X-X-X-+-X---,-X-E-.-X-----,-X1X-X1----,-X-E-.-X-------------------
--------------------------------------------------------------------,-X-H-,-,-X---------,-X-+-X---,-X-.-.-X-----------------,-X-.-.-X-------------------
--------------------------------------------------------------------,-X-X-.-A-X---------,-X-.-X---,-X-H-.-X-----------------,-X-H-.-X-------------------
----------------------------------------------------------------------,-,-X-X-X---------,-X-A-X---,-X-.-.-X-----------------,-X-.-.-X-------------------
----------------------------------------------------------------------------------------,-X-X-X---,-X-H-.-X-----------------,-X-H-.-X-------------------
--------------------------------------------------------------------------------------------------,-X-X-X-X-----------------,-X-X-X-X-------------------
