--------------------------------------------------------------------------------------------,-X-X-X-X~X~X~X~X~X~X~X~X~X~X~X~X-X-X-X---------------------------------------------------------------------------------------------------------
--------------------------------------------------------------------------------------------,-X-.-.~.~.~.~,~,~,-t/,-.~.~.~.~.~.-.-X---------------------------------------------------------------------------------------------------------
--------------------------------------------------------------------------------------------,-X-.~,~,~,~,~,~,-,-,-,-,~,~,~,~.~.~.-X---------------------------------------------------------------------------------------------------------
--------------------------------------------------------------------------------------------,-X~.~,~B-.-,-,-,-.-.-,-,-.-.-B-.~.~.~X---------------------------------------------------------------------------------------------------------
--------------------------------------------------------------------------------------------,-X~.~,~.-.-.-.-,-,-,-,-.-.-.-,-.~.~.~X---------------------------------------------------------------------------------------------------------
--------------------------------------------------------------------------------------------,-X~.~,~,-.-.-.-.-.-.-.-.-.-,-,-.~.~.~X---------------------------------------------------------------------------------------------------------
------------------------------------------------------------------------------,-,-,-,-,-,-,-,-X~,~,~,-.-.-.-.-.-.-.-.-.-,-,-,~,~,~X-,-,-,-,-,-,---------------------------------------------------------------------------------------------
------------------------------------------------------------------------------,-X-X-X-X-XPXPX-X-,-,-,-,-.-.-.-.-.-.-.-,-,-.-,-,-,~X-X-XPX-X-X-X---------------------------------------------------------------------------------------------
------------------------------------------------------------------------------,-X-.-.-.-+P+P.-.-,-,-.-,-.-.-.-.-.-.-.-,-.-,-,-,-.-.-.-.0.-.-.-X---------------------------------------------------------------------------------------------
------------------------------------------------------------------------------,-X-A-E-.-+P+P.-.-,-,-,-,-.-.-.-.-<-.-.-,-,-,-,-,-.-.-.-.0.-E-A-X---------------------------------------------------------------------------------------------
------------------------------------------------------------------------------,-X-.-.-.-+P+P.-.-,-,-,-.-.-.-.-.-.-.-.-.-,-.-,-,-.-.-.-.0.-.-.-X---------------------------------------------------------------------------------------------
,-,-,-,-----------------------------------------------------------------------,-X-X-X-X-XPXPX-X-,-,~,-.-.-.-.-.-.-.-.-.-,-,-,-,-,-X-X-XPX-X-X-X-,-,-----------------------------------------------------------------------------------------
X5X-X-X-------------------------------------------------------------------------------------,-X~.~,~.-.-.-.-.-.-.-.-.-.-.-,-,-.~,~X-,-,-X-X~X~X~X~X-,-,-------------------------------------------------------------------------------------
X5<-W-X-------------------------------------------------------------------------------------,-X~.~,~.-.-.-.-.-.-.-.-.-.-.-.-,-.~,~X-,-X~.~.~.~.~.~.~X~X~------------------------------------------------------------------------------------
X5X-X-X-------------------------------------------------------------------------------------,-X~.~,~B-,-,-.-.-.-.-.-.-.-.-B-,-.~,~X-,-X~,~,~A~.~A~.~.~X~------------------------------------------------------------------------------------
----------------------------------------------------------------------------------------------X-,~.~.~.~,~,-.-.-.-.-,-,-,-,-.~,~,-X-,-X~.~.-,~,~,~.~.~X~------------------------------------------------------------------------------------
----------------------------------------------------------------------------------------------X-,-,~.~.~.~,~.-.-.-.-,-.~.~,~,~,~--X-,-X-.-.-.-.-,-A~,~X~------------------------------------------------------------------------------------
----------------------------------------------------------------------------------------,-,-,-X-,-,-,~,~,~X~X1.1.1X1X-,~,~,~------X-,-X-.-.-.-.-.-,-X~--------------------------------------------------------------------------------------
----------------------------------------------------------------------------------------,-X-X-X-X-X-X-X-X-X-X-.-.-X-X-X-X-X-X-X-X-X-X-.-.-.-.-.-.-.-X---------------------------------------------------------------------------------------
----------------------------------------------------------------------------------------,-X-E-.-.-H-.-E-.-X-X-.-.-.-X-,-X-X-X-X-X-X-X-.-.-.-.-.-.-.-X---------------------------------------------------------------------------------------
----------------------------------------------------------------------------------------,-X-.-.-.-.-.-.-.-X-X-.-.-.-X-,-X-.-.-.-.-,-.-.-.-.-.-H-.-.-X---------------------------------------------------------------------------------------
----------------------------------------------------------------------------------------,-X-.-.-.-.-.-.-.-X-X-.-.-.-X-,-X-.-E-.-.-,-.-.-.-.-.-.-.-.-X---------------------------------------------------------------------------------------
----------------------------------------------------------------------------------------,-X-.-.-.-.-.-.-.-X-X-,-,-,-X-,-X-.-.-.-.-,-.-.-.-.-.-.-.-.-X---------------------------------------------------------------------------------------
----------------------------------------------------------------------------------------,-X-.-E-.-.-.-E-,-X-X-.-.-.-X-X-X-.-.-.-.-,-.-.-.-.-.-.-.-.-X---------------------------------------------------------------------------------------
----------------------------------------------------------------------------------------,-X-.-.-.-.-.-.-,-X-X-,-,-,-X-X-,-,-,-,-,-,-.-E-.-.-.-.-.-.-X---------------------------------------------------------------------------------------
----------------------------------------------------------------------------------------,-X-.-.-.-.-.-.-,-X-,-,-E-,-X-X-.-.-.-.-.-.-.-.-.-.-.-.-.-,-X---------------------------------------------,-,-,-,-,-,-,-,-,-,-,-,-,-,-,-,-,-,-,-,-,-
----------------------------------------------------------------------------------------,-X-.-.-.-.-.-.-,-X-X-.-.-.-X-X-.-.-.-.-.-.-.-.-.-.-.-.-.-X-----------------------------------------------,-X-X-X-X-X-,-X-X-X-X-X-X-X-X-,-X-X-X-X-X-
------------------------------------------------------------------,-,-,-,-,-------------,-X-.-.-E-.-E-.-.-X-X-,-,-,-X-X-.-.-.-.-.-.-,-,-,-,-,-,-X-X-----------------------------------------------,-X-.-.-.-X-X-X-.-,-.-.-,-.-X-X-X-.-.-.-X-
------------------------------------------------------------------,-X-X-X-X-,-----------,-X-,-.-.-.-.-.-.-X-X-.-.-.-X-X-.-.-.-.-.-.-,-.-.-.-.-,-X-,-,-,-,-,-,-,-,-,-------------------------------,-X-.-.-.-.-.-.-.-,-.-K-,-.-.-.-.-.-.-.-X-
------------------------------------------------------------------,-X-.-H-.-X-------------X-,-.-.-.-.-.-.-X-X-.-.-.-X-X-.-.-.-.-.-.-,-.-.-.-.-.-X-X-X-X-X-X-X-X-X-X-------------------------------,-X-.-.-.-.-.-.-.-,-,-,-,-.-.-.-.-.-.-.-X-
--------------------------------------------------------,-,-,-,-,-,-X-.-.-.-X-,-,-,-,-,-,-X-,-.-.-.-.-.-.-X-X-,-,-,-X-X-.-.-.-.-E-.-,-.-.-.-.-.-X-X-.-.-.-.-.-.-H-X-------------------------------,-X-X-.-.-.-.-.-.-.-.-.-.-.-.-.-.-.-.-.-X-
--------------------------------------------------------,-X-X-X-X-X-X-.-.-.-X-X-X-X-X-X-,-X-.-.-.-.-.-.-,-X-X-.-.-.-X-X-.-.-.-.-.-.-,-.-.-.-.-.-X-X-.-.-.-.-.-E-.-X---------------,-,-,-,-,-,-----,-,-X-.-.-.-A-,-,-:-,-A-,-,-,-A-.-.-.-.-X-
--------------------------------------------------------,-X-.-.-,-,-.-.-.-.-,-,-.-.-.-X-,-X-.-.-.-X-X-X-X-X-X-,-,-,-X-X-,-,-,-,-,-,-,-.-.-.-.-.-X-X-.-E-.-E-.-.-.-X---------------,-X-X-X-X-X-----,-X-X-.-.-.-,-.-.-.-.-.-.-.-,-.-.-.-.-.-X-
--------------------------------------------------------,-X-.-E-,-,-.-.-.-.-,-,-.-E-.-X-,-X-.-.-.-X-,-,-,-X-,-,-E-,-X-X-.-.-.-X-X-X2X2X-X-X-X-X-X-X-.-.-.-:-.-.-,-X---------------,-X-.-.-E-X-----,-X-.-.-.-.-,-.-,-,-,-,-,-.-,-.-.-.-.-.-X-
--------------------------------------------------------,-X-.-.-X-X-X-.-.-.-X-X-X-.-.-X-,-X-.-.-.-X-X-X-X-X-X-.-.-.-X-X-.-.-.-+-,-.2.2.-.-.-X-,-X-E-.-.-.-.-,-,-X-,-,-,-----------,-X-.-.-.-X-----,-X-.-.-.-.-,-.-,-.-.-.-,-.-,-.-.-.-.-.-X-
--------------------------------------------------------,-X-E-A-X-,-X-.-E-.-X-,-X-A-.-X-,-X-.-.-.-.-.-.-.-X-X-.-.-.-X-X-.-.-.-X-X-X2X2X-X-X-X-X-,-.-.-E-.-E-,-X-X-X-X-X-----------,-X-.-.-.-X-----,-X-.-.-.-.-,-.-,-.-.-.-,-.-,-.-.-.-.-.-X-
--------------------------------------------------------,-X-.-.-X-X-X-.-.-.-X-X-X-.-.-X-,-X-.-.-.-.-.-.-.-X-X-,-,-,-X-X-.-E-.-X---,-,-,-,-,-,-X-,-,-.-.-.-,-X-X-.-H-.-X-----------,-X-.-.-.-X-----,-X-.-.-.-.-A-,-,-.-E-.-,-,-,-A-.-.-.-.-X-
--------------------------------------------------------,-X-.-E-,-,-.-.-.-.-,-,-.-E-.-X-,-X-.-.-.-.-E-.-E-X-X-.-.-.-X-X-.-.-.-X---,-X-X-X-X-X-X-A-,-,-.-E-X-,-X-E-E-.-X-----------,-X-.-E-.-X-----,-X-.-.-.-.-,-,-,-.-.-.-,-,-,-.-.-.-.-.-X-
--------------------------------------------------------,-X-X-X-X-X-X-.-.-.-X-X-X-X-X-X-,-X-X-X-X-X-.-.-.-X-X-.-A-.-X-X-.-.-.-X---,-X-.-.-.-,-.-A-A-,-,-X---,-X-.-.-.-X-----------,-X-.-.-.-X-----,-X-.-.-.-.-,-.-,-,-,-,-,-.-,-.-.-.-.-.-X-
----------------------,-,-,-,-,-,-,-,-,-,-,-,-,-,-,-,-,-,-,-----,-,-X-.-.-.-X-,-,-,-------------,-X-.-.-.-X-X-,-,-,-X-X-.-.-.-X---,-X-.-E-.-,-,-,-X-X-X-,-,-,-X-.-.-.-X-,-,-,-----,-X-X-X-X-X-----,-X-.-.-.-.-,-.-.-.-.-.-.-.-,-.-.-.-.-.-X-
----------------------,-X-X-X-X-X-X-X-X-X-X-X-X-X-X-X-X-X-X-----,-X-X-.-.-.-X-X-X-X-,-------,-,-,-X-+-+-+-X-X-+-+-+-X-X-+-+-+-X-,-,-X-.-.-.-E-.-.-X-----,-X-X-X-.-.-.-X-X-X-X-,-------------------,-X-X-.-.-.-,-,-,-,-,-,-,-,-,-.-.-.-.-.-X-
----------------------,-X-.-E-X-------,-,-,-,-X-X-,-,-,-X-X-----,-X-.-.-.-.-.-.-.-.-X-----,-,-X-X-X-,-,-,-X-X-,-,-,-X-X-,-,-,-X-X-X-X-.-.-.-.-.-.-X-----,-X-<-.-.-.-.-.-.-.-.-X-------------------,-,-X-.-.-.-A-.-.-.-.-A-.-.-.-A-.-.-.-.-X-
----------------------,-XQ+Q+QXQ------,-X-X-X-,-H-X-X-X-X-X-----,-X-.-.-E-.-.-.-.-E-X---,-,-X-.-.-.-.-.-.-.-.-.-.-.-.-.-.-.-.-.-.-X-+-.-.-.-.-E-.-X-,-,-,-X-.-.-.-.-.-.-.-.-.-X-------------------,-X-X-.-.-.-.-.-.-.-.-.-.-.-.-.-.-.-.-.-X-
----------------------,-X/t/t/X/------,-X-.-.-.-E-.-.-,-X-X-----,-X-.-.-.-.-.-.-.-.-X-,-,-X-.-.-.-.-.-.-.-.-.-.-.-.-.-.-.-.-.-.-.-.-+-+-.-.-.-.-.-X-X-X-X-X-.-.-.-.-.-.-.-,-,-X-,-----------------,-X-.-.-.-.-.-.-.-.-.-.-.-.-.-.-.-.-.-.-X-
----------------------,-X-.-.-X-------,-X-.-E-.-.-.-E-,-X-X-----,-X-.-.-.-.-.-.-.-.-X-,-X-.-.-.-.-.-.-.-.-.-.-.-.-.-.-.-.-.-.-.-.-.-.-+-X-X-X-X-X-X-X-B-.-,-.-.-.-.-.-E-,-,-,-X-X-,---------------,-X-.-:-.-.-.-.-.-.-.-.-.-.-.-.-.-.-.-.-X-
----------------------,-X-.-.-X-------,-X-.-.-.-.-.-.-,-X-X-----,-X-.-.-.-.-.-.-.-.-X-X-.-.-.-.-.-.-.-.-.-.-.-.-.-.-.-.-.-.-.-.-.-.-.-.-X-,---,-X-X-X-B-.-,-.-.-.-.-.-.-,-.-,-.-.-X---------------,-X-.-.-.-.-.-.-.-.-.-.-.-.-.-.-.-.-.-.-X-
----------------------,-X-X-X-X-------,-X-.-.-.-.-.-.-,-X-X-----,-X-.-.-.-.-.-.-.-+-+-.-.-.-.-.-.-.-.-.-.-.-.-.-.-.-.-.-.-.-.-.-.-.-.-.-.-X-,-,-X-.-.-.-E-,-.-.-.-.-.-.-E-.-,-E-.-X---------------,-X-X-X-X-X-X-X-.-.-.-.-.-.-X-X-X-X-X-X-X-
--------------------------------------,-X-.-.-,-,-,-.-,-X-X-,-,-,-,-X-X-X-X-X-X-X-+-.-.-.-.-.-.-.-.-.-.-.-.-.-.-.-.-.-.-.-.-.-.-.-.-.-.-.-.-X-,-X-.-.-.-.-,-.-.-.-.-.-.-,-,-,-X-X-X---------------------------,-X-.-.-.-.-:-.-X-,-----------
--------------------------------------,-X-.-,-,-.-,-,-.-X-X-X-X-X-X-X-X-X-,-,-,-X-.-.-.-.-.-.-.-.-.-.-.-.-.-.-.-.-.-.-.-.-.-.-.-.-.-.-.-.-.-.-X-X-.-A-.-.-E-.-.-.-.-.-.-.-.-,-X-------------------------------,-X-.-.-.-.-.-.-X-X-----------
--------------------------------------,-X-,-,-.-.-.-.-,-X-,-,-,-,-,-,---X-X-,-X-.-.-.-.-.-.-.-.-.-.-.-.-.-.-.-.-.-.-.-.-.-.-.-.-.-.-.-.-.-.-.-.-.-+-.-.-.-,-.-.-.-.-.-.-.-E-.-X-----------,-,-,-,-,-,---------,-X-.-.-.-.-.-.-.-X-----------
--------------------------------------,-X-,-.-.-.-.-.-.-X-X-X-X-X-X-X-X-,-X-X-.-.-.-.-.-.-.-.-.-.-.-.-.-.-.-.-.-.-.-.-.-.-.-.-.-.-.-.-.-.-.-.-.-.-+-+-.-B-,-.-.-.-.-.-.-.-.-.-X-------,-,-,-X-X-X-X-X-,-,-----,-X-.-.-.-.-.-.-.-X-----------
--------------------------------------,-X-,-,-.-.-.-.-.-.-.-.-.-.-.-.-X-,-X-X-.-.-.-.-.-.-.-.-.-.-.-.-.-.-.-.-.-.-.-.-.-.-.-.-.-.-.-.-.-.-.-.-.-.-.-X-X-X-X-.-.-.-.-.-E-.-,-X-X-------,-X-X-X-.-H-.-X-X-X-,-,-,-X-.-.-.-.-.-.-.-X-----------
--------------------------------------,-X-.-,-.-.-.-.-.-.-.-.-.-.-.-.-X-,-X-.-.-.-.-.-.-.-.-.-.-.-.-.-.-.-.-.-.-.-.-.-.-.-.-.-.-.-.-.-.-.-.-.-.-.-.-.-X-,-X-X-X-X-X-X-X-X-X-,-,-,-,-,-,-X-.-.-.-.-.-.-.-X-X-X-X-X-.-.-.-.-.-.-.-X-----------
--------------------------------------,-X-E-,-,-.-.-.-.-.-.-.-.-.-.-.-X-X-.-.-.-.-.-.-.-.-.-.-.-.-.-.-.-.-.-,-,-A-,-.-.-.-.-.-.-.-.-.-.-.-.-.-.-.-.-.-.-X-X-X-X-X-X-X-X-X-X-X-X-X-X-X-X-X-.-.-.-.-.-.-.-,-+-.-.-.-.-.-.-.-.-.-.-X-----------
--------------------------------------,-X-.-.-,-,-,-,-,-X-X-X-.-.-.-.-X-X-.-.-.-.-.-.-.-.-.-.-.-.-.-.-.-.-,-,-,-,-,-,-.-.-.-.-.-.-.-.-.-.-.-.-.-.-.-.-.-.-.-.-.-.-.-.-.-.-.-.-.-.-.-.-.-.-.-.-.-.-.-.-.-,-+-.-.-.-.-.-:-.-.-.-.-X-----------
--------------------------------------,-X-E-.-.-.-.-.-.-X-,-X-.-.-.-.-+-.-.-.-.-.-.-.-.-.-.-.-.-.-.-.-.-,-,-,-,-,-,-,-,-.-.-.-.-.-.-.-.-.-.-.-.-.-.-.-.-.-.-.-.-.-.-.-.-.-.-.-.-.-.-.-.-.-.-.-.-.-.-.-.-,-+-.-.-.-.-.-.-.-.-.-.-X-----------
--------------------------------------,-X-X-X-X-X-X-X-X-X-,-X-.-.-.-.-+-.-.-.-.-.-.-.-.-.-.-.-.-.-.-.-W-,-,-,-,-A-,-,-,-W-.-.-.-.-.-.-.-.-.-.-.-.-.-.-.-.-.-.-.-.-.-.-.-.-.-.-.-.-.-.-.-.-.-.-.-.-.-.-.-,-+-A-.-.-.-.-.-.-.-.-.-X-----------
------------------------------------------------------,-X-X-X-X-.-.-.-+-.-.-.-.-.-.-.-.-.-.-.-.-.-.-,-,-,-.-.-.-.-.-.-,-,-,-.-.-.-.-.-.-.-.-.-.-.-.-.-.-.-.-.-X-X-X-.-.-.-.-.-X-X-X-.-.-.-.-.-.-.-.-.-.-,-+-.-.-.-.-.-.-.-.-.-.-X-----------
------------------------------------------------------,-X-.-.-X-X-X-X-X-X-.-.-.-.-.-.-.-.-.-.-.-.-,-,-,-.-,-,-,-,-,-,-.-,-,-,-.-.-.-.-.-.-.-.-.-.-.-.-.-.-.-.-X-,-X-.-.-A-.-.-X-,-X-.-.-.-.-.-.-.-.-.-.-,-+-.-.-.-.-.-.-.-.-.-.-X-----------
--------------------------------------------------,-,-,-X-<-.-.-X-X-X-X-X-.-.-.-.-.-.-.-.-.-.-.-,-,-,-,-.-,-.-.-.5.-,-.-,-,-,-,-.-.-.-.-.-.-.-.-.-.-.-.-.-.-.-X-X-X-.-.-.-.-.-X-X-X-.-.-.-.-.-.-.-.-.-.-,-+-.-.-.-.-.-.-.-.-.-.-X-----------
--------------------------------,-,-,-,-,-,-,---,-,-X-X-X-.-.-.-.-.-.-.-,-.-.-.-.-.-.-.-.-.-.-.-,-,-,-,-.-,-.-.-.5.-,-.-,-,-,-,-.-.-.-.-.-.-.-.-.-.-.-.-.-.-.-.-.-.-.-.-.-.-.-.-.-.-.-.-.-.-.-.-.-.-.-.-X-X-X-X-X-X-X-X-X-X-X-X-X-----------
----------------------------,-,-X-X-,-X~X~X~X~,-,-X-X-L-L-<-<-.-.-.-<-.-,-.-.-.-.-.-.-.-.-.-.-.-A-,-,-A-.-,-.5.5W5.5,5.-A-,-,-A-.-.-.-.-.-.-.-.-.-.-.-.-.-.-.-.-.-.-.-.-W-.-.-.-.-.-.-.-.-.-.-.-W-.-.-<-X-,-,-,-,-,-,-,-,-,-,-,-,-----------
----------------------------,-X-.-X-X-X-.~E~X-X-X-X->-X-X-<-.-.-.-.-.-.-,-.-.-.-.-.-.-.-.-.-.-.-,-,-,-,-.-,-.-.-.5.-,-.-,-,-,-,-.-.-.-.-.-.-.-.-.-.-.-.-.-.-.-.-.-.-.-.-.-.-.-.-.-.-.-.-.-.-.-.-.-.-.-.-X-X-X-X-X-X-X-X-X-X-X-X-X-----------
----------------------------,-X-.-.-.-,-.~,~.-.-.-E-X-,-X-.-.-,-X-X-X-X-X-.-.-.-.-.-.-.-.-.-.-.-.-,-,-,-,-,-,-,-,5,-,-,-,-,-,-.-.-.-.-.-.-.-.-.-.-.-.-.-.-.-.-X-X-X-.-.-.-.-.-X-X-X-.-.-.-.-.-.-.-.-.-.-,-+-.-.-.-.-.-.-.-.-.-.-X-----------
----------------------------,-X-.-.-.-,-.~,~.-.-.-.-X-,-X-.-,-X-X-X-X-X-X-.-.-.-.-.-.-.-.-.-.-.-.-.-,-,-,-.-.-.-.-.-,-,-,-,-.-.-.-.-.-.-.-.-.-.-.-.-.-.-.-.-.-X-,-X-.-.-A-.-.-X-,-X-.-.-.-.-.-.-.-.-.-.-,-+-.-.-.-.-.-.-.-.-.-.-X-----------
----------------------------,-X-.-.-.-,-.~,~,-.-.-.-X-,-X-X-X-X-.-.-.-+-.-.-.-.-.-.-.-.-.-.-.-.-.-.-.-W-,-,-,-,-A-,-,-,-W-.-.-.-.-.-.-.-.-.-.-.-.-.-.-.-.-.-.-X-X-X-.-.-.-.-.-X-X-X-.-.-.-.-.-.-.-.-.-,-,-+-.-.-.-.-.-.-.-.-.-.-X-----------
----------------------------,-X-.-.-,-,~.~.~,~.-.-.-X-,---,-X-.-.-.-.-+-.-.-.-.-.-.-.-.-.-.-.-.-.-.-.-.-,-,-,-,-,-,-,-,-.-.-.-.-.-.-.-.-.-.-.-.-.-.-.-.-.-.-.-.-.-.-.-.-.-.-.-.-.-.-.-.-.-.-.-.-.-.-.-,-.-+-A-.-.-.-.-.-.-.-.-.-X-----------
----------------------------,-X-E-,-,-.~.~.~,~,-.-.-.-X-,-,-X-.-.-.-.-+-.-.-.-.-.-.-.-.-.-.-.-.-.-.-.-.-.-,-,-,-,-,-,-.-.-.-.-.-.-.-.-.-.-.-.-.-.-.-.-.-.-.-.-.-.-.-.-.-.-.-.-.-.-.-.-.-.-.-.-.-.-.-.-,-.-+-.-.-.-.-.-.-.-.-.-.-X-----------
----------------------------,-X-X-,-.~.~.~.~.~,~.-.-.-.-X-X-X-.-.-.-.-X-X-.-.-.-.-.-.-.-.-.-.-.-.-.-.-.-.-.-,-,-A-,-.-.-.-.-.-.-.-.-.-.-.-.-.-.-.-.-.-.-.-.-.-X-X-X-.-.-.-.-.-X-X-X-.-.-.-.-.-.-.-.-.-,-.-+-.-.-.-.-.-.-.-.-.-.-X-----------
--------------------------------,-X-.~.~.~.~.~,~.-.-.-.-.-.-.-.-.-.-.-X-X-.-.-.-.-.-.-.-.-.-.-.-.-.-.-.-.-.-.-.-.-.-.-.-.-.-.-.-.-.-.-.-.-.-.-.-.-,-,-.-X-X-X-X-,-X-X-X-X-X-X-X-,-X-X-X-X-.-.-.-.-.-.-,-.-+-.-.-.-.-.-.-.-.-.-.-X-----------
----------------------------,-,-,-X-.~E~.~.~.~,~.-.-.-.-.-A-.-.-.-.-.-X-,-X-.-.-.-.-.-.-.-.-.-.-.-.-.-.-.-.-.-.-.-.-.-.-.-.-.-.-.-.-.-.-.-.-.-.-,-.-X-X-X-X-X-X-X-X-X-X-X-X-X-X-------,-X-,-,-,-H-,-,-,-X-X-X-X-X-.-.-.-.-.-.-.-X-----------
----------------------------,-X-X-,-,~.~.~.~.~,~.-.-.-.-.-.-.-.-.-.-.-X-,-,-X-.-.-.-.-.-.-.-.-.-.-.-.-.-.-.-.-.-.-.-.-.-.-.-.-.-.-.-.-.-.-.-.-.-,-+-+-.-.-.-.-.-.-.-.-.-.-.-.-X-,-----,-X-X-X-X-X-X-X-X-X-----,-X-.-.-.-.-.-.-.-X-----------
----------------------------,-X-H-.-,-.~.~.~,~,~.-:-.-,-X-X-X-X-X-X-X-X-X-X-X-X-.-.-.-.-.-.-.-.-.-.-.-.-.-.-.-.-.-.-.-.-.-.-.-.-.-.-.-.-.-.-.-.-.-+-.-.-.-.-.-.-.-.-.-.-.-.-,-X-X-----------------------------,-X-.-.-.-.-.-.-.-X-----------
----------------------------,-X-.-.-,-,~.~,~,~.-.-.-X-X-----------,-X-.-.-.-,-X-X-.-.-.-.-.-.-.-.-.-.-.-.-.-.-.-.-.-.-.-.-.-.-.-.-.-.-.-.-.-,-X-X-.-A-.-E-.-.-.-.-.-.-.-.-.-,-,-X-------------------------,-,-,-X-.-.-.-.-.-.-.-X-,-,-------
----------------------------,-X-.-.-.-,-.~,~.-.-.-.-X-------------,-X-A-.-.-.-X-.-+-.-.-.-.-.-.-.-.-.-.-.-.-.-.-.-.-.-.-.-.-.-.-.-.-.-.-.-,-X-,-X-.-.-.-.-.-.-.-:-.-.-.-.-.-.-X-X-------------------------,-X-X-X;.;.;.;.;.;.;.;X;X-X-------
----------------------------,-X-.-.-.-,-.~,~.-.-.-.-X-------------,-X-.-.-.-.-.-+-.-+-.-.-.-.-.-.-.-.-.-.-.-.-.-.-.-.-.-.-.-.-.-.-.-.-.-,-X---,-X-X-X-X-X-X-X-X-.-.-.-.-.-.-.-X-------------,-,-,-,-,-,-,-,-X-.-.-.-.-.-.-.-.-.-.-.-X-,-,---
----------------------------,-X-.-.-.-,-.~,~.-.-.-E-X---,-,-,-,-,-,-X-X-X-X-.-.-.-+-,-X-.-.-.-.-.-.-.-.-.-.-.-.-.-.-.-.-.-.-.-.-.-.-.-,-X-,-,-,-X-X-X-,-,-,-,-X-.-.-.-.-.-.-.-X-------------,-X-X-X-X-X-X-X-X-.-.-.-.-.-.-.-.-.-.-.-X-X-X---
----------------------------,-X-.-X-X-,-.~,~,-X-X-.-X-,-,-X-X-X-X-X-X-X-X-X-.-.-E-.-X-,-X-.-.-.-.-.-.-.-.-.-.-.-.-.-.-.-.-.-.-.-.-,-,-.-X-X-X-X-X-.-X-X-X-X-X-X-.-.-.-.-.-.-.-X-------------,-X-.-.-,-.-,-.-.-.-.-.-.-.-.-.-.-.-.-.-.-,-X---
------------------------------,-X-X-,-X-,~E~X---,-X-.-,-X-.-,-.-.-.-.-.-.-.-.-.-.-.-.-X-X-X-.-.-.-.-.-.-.-.-.-.-.-.-.-.-.-.-.-.-,-,-+-+-.-.-.-.-.-.-.-.-B-B-X-X-.-.-.-.-.-.-.-X-------------,-X-.-.-,-.-,-.-.-.-.-A-.-.-.-.-.-A-.-.-.-,-X---
--------------------------------,-X-,-X-.-.-X---,-X-,-X-.-A-,-.-.-.-.-.-.-.-.-X-X-.-.-.-X-,-X-.-.-.-.-.-.-.-.-.-.-.-.-.-.-.-.-.-,-X-+-.-A-.-.-.-.-.-.-.-.-.-X-X-X-.-.-.-.-.-X-X-------------,-X-.-H-,-.-,-.-.-.-.-.-.-.-.-.-.-.-.-.-.-,-X---
------------------------------------,-X-.-H-X-,-,-,-,-X-,-,-,-.-.-.-.-.-.-.-.-X-X-.-.-.-X---,-X-.-.-.-.-.-.-.-.-.-.-.-.-.-.-.-.-X-X-.-.-.-E-.-.-.-.-.-.-.-.-X-X-X-,-,-,-,-.-X-X-,-,-,-------,-X-.-.-,-.-,-.-.-.-.-.-.-.-.-.-.-.-.-.-.-,-X---
------------------------------------,-X-.-.-X-X-X-X-X-X-.-.-.-.-.-.-.-.-.-.-.-X-X-.-A-.-X-----,-X-X-+-+-+-X-X-+-+-+-X-X-+-+-+-X-X-,-X-.-.-.-.-.-.-.-.-.-.-.-X-X-.-,-.~.~,~.-,-X-X-X-X-------,-X-X-X-X-X-X-X-X-.-.-.-.-.-.-.-.-.-.-.-X-X-X---
------------------------------------,-X-.-.-X-X-E-.-E-,-.-.-.-:-.-.-.-.-.-.-.-X-X-X-X-X-X-------,-X-.-.-.-X-X-.-A-.-X-X-.-.-.-X-,-,-X-.-.-.-.-.-.-.-.-E-.-.-X-X-.-,-.~.~,~.-,-.-.-E-X---------------,-,-,-,-X-.-.-.-.-.-.-.-.-.-.-.-X-,-,---
------------------------------------,-X-X-X-X-X-X-X-X-X-.-.-.-.-.-H-.-.-.-.-.-X-----------------,-X-.-.-.-X-X-.-.-.-X-X-.-.-.-X-,-X-X-.-.-.-.-.-E-.-.-.-.-.-X-X-.-,-.~.~,~.-,-.-.-.-X---------------,-X-X-X-X-.-.-.-.-.-.-:-.-.-.-.-X-X-X---
----------------------------------------------------,-X-.-.-.-.-.-.-.-.-.-.-.-X-,-,-,-,-,-,-----,-X-E-.-E-X-X-.-E-.-X-X-E-.-E-X-,-X-.-.-.-.-,-,-,-.-.-.-.-.-X-X-,-,-.~.~,~,-,-X-X-X-X---------------,-X-,-.-.-.-.-.-.-.-.-.-.-.-.-.-.-,-X---
----------------------------------------------------,-X-,-,-,-.-.-.-.-,-,-,-,-X-,-X-X-X-X-X-----,-X-.-.-.-X-X-.-.-E-X-X-.-,-,-X-,-X-X-.-.-.-,-,-,-.-.-.-.-.-X-X-X-.~.~.~.~,~X-X---------------------,-X-,-.-.-.-.-.-.-.-.-.-:-.-.-.-.-,-X---
----------------------------------------------------,-X-.-.-,-.-.-.-.-,-.-.-,-X-,-X-.-H-.-X-----,-X-.-.-.-X-X-.-.-.-X-X-,-,-.-.-X-X-X-B-.-.-.-.-.-.-.-.-.-.-X-X-X-E~.~.~,~E~X-X-,-,-,---------------,-X-,-.-.-.-.-A-.-.-.-.-.-A-.-.-.-,-X---
----------------------------------------------------,-X-.-A-,-.-.-.-.-,-.-A-,-X-,-X-E-.-E-X-----,-X-.-.-.-X-X-.-.-.-X-X-,-.-.-.-.-,-X-X-X-X-X-.-.-E-.-.-E-.-X-X-.-,-.~.~,~.-,-X-X-X-X---------------,-X-,-.-.-.-.-.-.-.-.-.-.-.-.-.-.-,-X---
------------------------------------------------------,-X-,-,-.-,-,-,-,-,-,-X---,-X-.-.-.-X-----,-X-.-.-.-X-X-.-.-.-X-,-X-X-X-X-.-.-X-,---,-X-.-.-.-.-.-.-.-X-X-.-,-.~.~,~.-,-.-.-E-X---------------,-X-X-X-X-.-.-.-.-.-.-.-.-.-.-.-X-X-X---
--------------------------------------------------------,-X-X-X-X-X-.-X-X-X-----,-X-.-E-.-X-,-,-,-X-.-.-.-X-X-.-.-.-X-X-X-X-X-,-X-.-.-X-,-,-X-.-.-.-.-.-.-.-X-X-.-,-.~.~,~.-,-.-.-.-X---------------------,-X-.-.-,-,-,-,-,-,-,-.-.-X-------
----------------------------------------------------------------,-X-E-X---------,-X-.-.-.-X-X-X-X-X-.-.-.-X-X-.-.-.-.-E-.-.-X-,-X-.-.-.-X-,-X-.-.-.-.-.-.-.-X-X-.-,-,~,~,~.-,-X-X-X-X---------------------,-X-X-X[+[,-+[.-,-+[,-X-X-X-------
----------------------------------------------------------------,-X-.-X---------,-X-.-.-.-.-.-B-.-.-.-.-.-X-X-.-.-.-.-.-,-,-X-,-X-.-.-E-,-X-X-X-X-X-X-.-.-.-X-X-X-.-.-.-.-.-X-X-------------------------------,-X[+[,-+[,-,-+[,-X-----------
----------------------------------------------------------------,-X-E-X---------,-X-.-.-.-.-.-.-.-.-.-.-.-X-X-.-.-.-.-.-,-E-X-,-X-E-,-,-A~E-.-X-X-,-X-.-.-.-X-X-X7.7.7.7.7.7X7X-------------------------------,-X-,-,-,-,-,-,-,-X-----------
----------------------------------------------------------------,-X-X-X---------,-X-.-.-.-.-.-.-.-.-.-.-.-X-X-.-.-.-.-.-,-.-X-,-X-,-A-.~.~A-,-.-X-,-X-.-E-.-X-X-.-.-.-.-.-.-.-X-------------------------------,-X-.-.-.-.-.-.-.-X-----------
--------------------------------------------------------------------------------,-X-.-.-.-E-.-.-.-E-.-.-.-X-X-.-.-.-.-.-,-E-X-,-X-,-.~.~.~.~,~.-,-X-X-.-H-.-X-X-.-.-.-<-.-.-.-X-------------------------------,-X-.-.-.-.-.-.-.-X-----------
----------------------------------------------------------------------------,-,-,-X-B-.-.-.-.-.-.-.-.-.-.-X-X-.-.-.-.-.-.-.-X-.-X-A~.~.~H~.~A~E-.-X-X-X-X-X-X-X-X-,-A-H-A-,-X-X-------------------------------,-X-.-.-.-K-.-.-.-X-----------
----------------------------------------------------------------------------,-X~X~X~,-,-,-,-,-,-,-,-,-,-,-X-X-,-,-.-.-.-.-E-X-X-.-,-,~.~.~,~,~.-.-X-------------,-XW.-.-.-XW----------------------------------,-X-.-.-.-E-.-.-.-X-----------
----------------------------------------------------------------------------,-X~.~.~.~.~.~.~.~.~.~.~.~.~.~X~X6.6,6.-.-.-.-.-X-X-.-.-A-,~,~A~.-.-,-X-------------,-X-.-.-.-X-----------------------------------,-X-.-.-.-.-.-.-.-X-----------
----------------------------------------------------------------------------,-X~X~X~X~X~X~X~X~X~X~X~X~X~X~X~X6E6,6.-.-.-.-.-X-X-.-.-E-.-A-.-E-.-X---------------,-X-E-.-E-X---------------------------------,-,-X-.-.-.-.-.-.-.-X-,---------
----------------------------------------------------------------------------------------------------------,-X6,6X6X-X-.-.-.-X-X-.-.-,-,-X-X-,-,-X---------------,-X-X-X-X-X---------------------------------,-X-X-.-.-.-.-.-.-.-X-X---------
----------------------------------------------------------------------------------------------------------,-X-H-X-,-X-<-.-.-X-.-.-.-X-X-,-,-X-X-------------------------------------------------------------,-X-.-X-X-X-X-X-X-X-.-X---------
----------------------------------------------------------------------------------------------------------,-X-X-X-,-X-X-X-X-X-.-.-.-X-----------------------------------------------------------------------,-X-X-X---------,-X-X-X---------
----------------------------------------------------------------------------------------------------------------------------,-X-,-,-X-------------------------------------------------------------------------------------------------------
------------------------------------------------------------------------------------------------------------------------------,-X-X---------------------------------------------------------------------------------------------------------
