------------------------------------------------------------------------------,-X~,-,---------,-,-,-,-,-,---------------,-,-,-X~----------------------------------------------------------------------------
------------------------------------------------------------------------------,-X-X~X-,-------,-X~X~X~X~X~------------,-,-X-X~X-----------------------------------------------------------------------------
--------------------------------------------------------------------------------,-X~.~X~,-----,-X~.~.~.~X~------------,-X~.~X~------------------------------------------------------------------------------
--------------------------------------------------------------------------------,-X~.~.~X-----,-X~E~.~E~X~----------,-,-X~.~X~------------------------------------------------------------------------------
--------------------------------------------------------------------------------,-X-.~.~X~,-,-,-X~,~,~,~X~,-,-,-,-,-,-X~.~,~X~------------------------------------------------------------------------------
----------------------------------------------------------------------------------,-X~.~.~X~X~X~X2.-.-,-X~X~X~X~X~X~X~.~,~X~--------------------------------------------------------------------------------
----------------------------------------------------------------------------------,-X~.~.~.~.~.~,~,2K-,-.~.~.~.~.~.~.~.~X~----------------------------------------------------------------------------------
------------------------------------------------------------------------------------,-X~.~.~.~.~.~.~.~.~.~.~.~.~.~.~.~,~X-----------------------------------------------------------------------------------
--------------------------------------------------------------------------------------,-X~X~.~.~,~,~,~,~,~,~,~.~.~,~,~X~------------------------------------------------------------------------------------
----------------------------------------------------------------------------------------,-,-X~,~,~.-.-.-.-.-X-X~X~X~X---------------------------------------------------------------------------------------
------------------------------------------------------------------------------------------,-X-.-.-.-H-.-.-.-X-----------------------------------------------------------------------------------------------
------------------------------------------------------------------------------------------,-X-.-.-.-.-.-.-.-X-----------------------------------------------------------------------------------------------
----------------------------------------------------------------------------------,-,-,-,-,-X-.-.-.-W-.-.-.-X-,-,-,-,-,-------------------------------------------------------------------------------------
----------------------------------------------------------------------------------,-X-X-X-X-XR.-.-.-.-.-.-.-X-XRX-X-X-X-------------------------------------------------------------------------------------
----------------------------------------------------------------------------------,-X-.-A-.-.-.-.-.-<-.-.-.-.-+RE-A-A-X-------------------------------------------------------------------------------------
----------------------------------------------------------------------------------,-X-A-.-A-.-.-,-,1,1,1.-.-.-+R.-A-E-X-------------------------------------------------------------------------------------
----------------------------------------------------------------------------------,-X-.-E-.-.-.-,-.1.1,1.-.-.-+RE-.-.-X-------------------------------------------------------------------------------------
----------------------------------------------------------------------------------,-X-X-X-X-XRX1X1.-.-,-X-X-X-XRX-X-X-X-------------------------------------------------------------------------------------
------------------------------------------------------------------------------------,-,-,-X-X-X-X-+-+-+-X-X-X-X-,-,-----------------------------------------------------------------------------------------
--------------------------------------------------------------------------------,-,-,-X-X-.-.-.-.-.-.-.-.-.-.-.-X-X-,-,-,-----------------------------------------------------------------------------------
------------------------------------------------------------------------,-,-,-,-,-X-X-.-.-.-.-.-.-.-.-.-.-.-.-.-.-.-X-X-X-,-,-------------------------------------------------------------------------------
--------------------------------------------------------------------,-,-,-X-X-X-X-.-.-.-.-.-.-.-.-.-.-.-.-.-.-.-.-.-.-.-.-X-X-,-,-,-------------------------------------------------------------------------
------------------------------------------------------------------,-,-X-X-.-,-,-.-.-.-.-.-.-.-.-.-.-H-.-.-.-.-.-.-.-.-.-.-.-.-X-X-X-------------------------------------------------------------------------
------------------------------------------------------------------,-X-,-.-.-.-,-.-.-.-.-.-.-.-.-.-.-.-.-.-.-.-.-.-.-.-.-.-.-.-,-X---------------------------------------------------------------------------
----------------------------------------------------------------,-,-X-,-,-.-.-,-.-.-.-.-.-.-.-.-.-.-.-.-.-.-.-.-.-.-.-.-.-.-.-,-X---------------------------------------------------------------------------
--------------------------------------------------------------,-,-X-.-.-,-.-.-,-.-.-.-.-.-.-.-.-.-.-.-.-.-.-.-.-.-.-.-.-.-W-,-,-X---------------------------------------------------------------------------
------------------------------------------------------------,-,-X-,-.-.-,-,-.-,-,-.-.-.-.-.-X-X-X-+-+-+-X-X-X-X-.-.-.-.-.-.-,-X-,---------------------------------------------------------------------------
----------------------------------------------------------,-,-X-.-,-,-.-.-,-.-.-,-.-,-,-X-X-X-X-X-+-+-+-X-X-X-.-X-.-.-.-.-.-,-X-----------------------------------------------------------------------------
--------------------------------------------------------,-,-X-.-.-.-,-,-.-,-,-.-,-X-.-,-X-.-.-.-.-.-.-.-.-.-.-X-X-.-.-X-.-.-,-X-----------------------------------------------------------------------------
--------------------------------------------------------,-X-,-,-.-.-.-,-.-.-,-X-X-X-,-.-.-.-.-.-.-.-t4.-.-.-.-.-.-.-.-X-X-X-X-------------------------------------------------------------------------------
------------------------------------------------------,-,-X-.-,-,-,-.-,-,-,-X-X-.-.-.-.-E-.-.-.-.-.-.-.-.-.-.-.-E-.-.-.-X-X-,-------------------------------------------------------------------------------
------------------------------------------------------,-X-.-.-.-.-,-,-.-,-X-X-.-.-.-.-.-.-.-.-.-.-.-.-.-.-.-.-.-.-.-.-.-.-.-X-,-----------------------------------------------------------------------------
----------------------------------------------------,-,-X-,-,-.-.-.-,-,-X-X-.-.-.-.-.-.-.-.-,-,-,-,-,-,-,-,-.-.-.-.-.-.-.-.-.-X-,---------------------------------------------------------------------------
--------------------------------------,-,-,---------,-X-.-.-,-,-.-.-.-,-X-.-.-.-.-.-,-,-,-,-,-.-.-.-.-.-.-,-,-,-.-.-.-.-.-.-.-.-X-,-------------------------------------------------------------------------
------------------------------------,-,-X-X-,-------,-X-.-.-.-,-,-,-,-X-X-.-E-.-.-,-,-,-,-.-.-.-.-.-.-.-.-.-.-,-,-,-,-.-.-.-E-.-.-X-,-----------------------------------------------------------------------
------------------------------------,-X-.-.-X-,---,-,-X-,-,-.-.-.-,-X-X-.-.-.-.-,-,-.-.-.-H-.-.-.-.-H-.-.-.-.-A-.-.-,-,-.-.-.-.-.-.-X-----------------------------------------------------------------------
------------------------------------,-X-.-.-.-X-,-,-X-.-.-,-,-,-.-X-,-X-.-.-.-,-,-.-.-.-.-.-.-.-.-.-.-.-.-.-.-.-.-.-.-,-,-.-.-.-.-.-X-----------------------------------------------------------------------
------------------------------------,-X-.-:-H-,-X-,-X-.-.-.-.-,-,-X-X-.-.-,-,-,-.-.-.-.-.-.-.-.-.-.-.-.-.-.-.-.-.-.-.-.-,-,-.-.-.-.-,-X---------------------------------------------------------------------
--------------------------------------,-X-W-.-X-,-X-,-,-,-.-.-.-X-.-X-.-.-,-,-.-.-H-.-.-.-.-.-.-.-.-.-.-.-.-.-.-.-.-.-H-.-,-.-.-.-.-.-X-,-,-,-,-,-,-,-,-,-,-,-,-,-,-,-,-,-----------------------------------
--------------------------------------,-X-,-,-X-,-X-.-.-,-,-,-,-X-X-.-E-.-,-,-.3.-.-.-.-.-.-.-.-.-.-.-.-.-.-.-.-.-.-.-.-.-,-.-.-E-.-.-X-X-X-X-X-X-X-X-X-X-X-X-X-X-X-X-X-X-----------------------------------
--,-,-,-,-,-,-,-,-,-,-,-,-,-,-,-,-,-,-,-,-X-.-,-X-X-.-.-.-.-.-.-X-X-.-.-.-,-.-.3.-.-.-.-.-.-.-.-.-.-.-.-.-.-.-.-.-.-.-.-.-,-,-.-.-.-.-X---------------------,-X-X4XS.-.-X-,-,-,-----------------------------
--,-X-X-X-X-X-X-X-X-X-X-X-X-X-X-X-X-X-X-X-X-+-X-,-X-.-.-A-.-.-.-X-X-.-.-,-,-.-.3.-.-.-.-.-.-.-.-.-.-.-.-.-.-.-.-.-.-.-.-.-.-,-.-.-<-.-,-X-------------------,-X-t4.-E-,-X-X-X-X-,-,-,-,---------------------
--,-X-<-.-.-.-.-X-X-A-.-<-.-<-.-X-X-.-.-.-.-<-X-,-X-,-,-,-,-,-,-X-X-.-.-,-.-.-.3:-.-.-.-.-.-:-.-.-.-.-.-.-.-.-.-.-.-.-.-.-H-,-,-.-.-.-,-X-,-,-,-,-,-,-,-----,-X-t4.-,-.-,-.-.-.-X-X-X-X---------------------
--,-X-.-.-.-.-.-X-X-.-.-.-.-.-.-X-X-.-E-:-.-.-X-,-X-.-.-.-.-.-,-X-X-X-X-X-X-.-.3.-.-.-.-.-.-.-.-.-.-.-.-.-.-.-.-.-.-.-.-.-.-.-X-X-X-X-X-,-,-X-X-X-X-X-,-,---,-X-t4.-E-.-,-E-.-E-E-.-E-X---------------------
,-,-X-:-.-.-.-.-X-X-.-,-,-,-,-,-X-X-.-.-.-.-.-X-,-X-X-+-+-+-X-X-,-,-,-,-,-X-.-.3.-.-.-.-.-.-.-.-.-.-.-.-.-.-.-.-.-.-.-.-.-.-.-X=X-X-X-X-,-X-.-.-.-.-.-X-X-,-,-X-t5.-,-.-,-.-.-.-.-.-.-X---------------------
X-X-X-.-X-.-.-.-X-X-.-X-X-,-,-,-X-X-.-X-.-.-.-X-X-X-X-+-+-+-X-X-X-X-X-X-X-X7.-.3.-.-.-.-.-.-.-.-.-.-.-.-.-.-.-.-.-.-.-.-.-.-.-,=,-.-.-X-X^X7.-.-.-.-.-.->-X-,-X-t5.-E-,-,-E-.-E-E-.-E-X-,-,-----------------
X-.-.-.-.-.-.-.-.-.-.-.-.-.-.-.-.-.-.-.-.-.-.-.-.-.-.-.-.-.-.-.-.-L-.-.-,-.7.-.3A-.-.-.-.-.-.-.-.-.-.-.-.-.-.-.-.-.-.-.-.-.-.-.-,=.-.-.-.-.7.-.-.-.-.-.->-X-,-X-t5.-.-.-.-.-.-.-.-.-.-X-X-X-,-,-,-,-,-------
X-.-.-.-.-.-.-.-.-.-.-.-.-.-.-.-.-.-.-.-.-.-.-.-.-.-.-.-H-.-.-.-A-L-.-.-,-.7.-.3A-.-.-.-.-.-.-.-.-.-.-.-.-.-.-.-.-.-.-.-.-.-.-H-H=.-.-A-.-.7E-.-.-.-.-.->-X-,-X-t5.-E-.-.-.-.-.-.-.-.-.-.-.-X-X-X-X-X-,-,-,-
X-.-.-.-.-.-.-.-.-.-.-.-.-.-.-.-.-.-.-.-.-.-.-.-.-.-.-.-.-.-.-.-.-L-.-.-,-.7.-.3.-.-.-.-.-.-.-t9.-.-.-.-.-.-.-.-.-.-.-.-.-.-.-,-,=.-.-.-.-.7.-.-.-.-.-.->-X-,-X-X5X-.-.-.-.-.-.-.-.-.-.-.-.-.-.-.-.-.-X-X-X-
X-X-X-.-X-,-,-,-X-X-.-X-X-,-,-,-X-X-.-X-,-,-,-X-X-X-X-.-.-.-X-X-X-X-X-X-X-X7.-.3A-.-.-.-.-.-.-.-.-.-.-.-.-.-:-.-.-.-.-.-.-.-.-,=.-.-.-X-X^X7.-.-.-.-.-.->-X-X-X-X-X9.-.-.-.-.-.-.-.-.-E-.-E-.-.-.-.-.-.-.-X-
--,-X-.-X-,-,-,-X-X-.-X-X-,-,-,-X-X-.-X-,-,-,-X-,-,-X-+-+-+-X-,-,-,-,-,-,-X>.-.3.-.-.-.-.-.-.-.-.-.-.-.-.-.-.-.-.-.-.-.-.-.-.-X=X-X-X-X-,-X-.-.-.-.-.-,->-X-.-.-,-t9.-.-.-.-.-.-.-.-.-.-.-.-.-.-.-E-.-.-.-X-
--,-X-.-.-.-.-.-X-X-.-.-.-.-.-.-X-X-.-.-.-.-.-X-,-X-X-.-.-.-X-X-X-X-X-X-X-X>.-.3.-.-.-.-.-.-.-.-.-.-.-.-.-.-.-.-.-.-.-.-.-.-.-X-X-X-X-X-,-X-.-,-,-.-,-X-,-X-.-.-,-t9.-.-E-.-.-E-E-.-.-E-.-E-.-E-.-.-.-.-.-X-
--,-X-.-.-.-W-.-X-X-.-:-.-E-.-.-X-X-.-.-.-.-<-X-,-X-,-,-,-,-,-,-X-X-.-.-,-,-.-.3.-.-.-.-.-.-.-.-.-.-.-.-.-.-.-.-.-.-.-.-.-.-,-,-.-.-.-,-X-,-X-X-X-X-X---,-X-.-.-,-t9.-.-.-.-.-.-.-.-.-.-.-.-.-.-.-.-.-.-.-X-
--,-X-.-<-.-.-:-X-X-.-.-.-.-.-A-X-X-A-:-.-.-.-X-,-X-.-.-.-.-.-.-X-X-.-.-.-,-.-.3.-.-.-.-.-.-.-.-.-.-.-.-.-.-.-.-.-.-.-.-.-H-,-.-.-<-.-X-----------------,-X-.-.-,-t9.-.-.-.-.-.-.-.-.-.-.-.-.-.-.-.-.-.-.-X-
--,-X-X-X-X-X-X-X-X-X-X-X-X-X-X-X-X-X-X-X-X-X-X-,-X-.-.-A-.-.-.-X-X-.-.-.-,-,-.3.-.-.-.-.-.-.-.-.-.-.-.-.-.-.-.-.-.-.-.-.-,-,-.-.-.-.-X-----------------,-X-.-.-,-t9.-.-.-E-E-.-E-.-.-E-.-.-.-E-.-E-.-.-.-X-
------------------------------------------------,-X-.-.-.-.-,-,-X-X-.-.-E-.-,-.3.-.-.-.-.-.-.-.-:-.-.-.-.-.-.-.-.-.-.-.-.-,-.-.-E-.-.-X-----------------,-X-.-.-,-t9.-.-.-.-.-.-.-.-.-.-.-.-.-.-.-.-.-.-.-X-
------------------------------------------------,-X-,-,-,-,-,-.-X-X-.-.-.-.-,-,3.-.-.-.-.-.-.-.-.-.-.-.-.-.-.-.-.-.-.-H-,-,-.-.-.-.-,-X-----------------,-X-.-.-,-t9.-.-.-.-.-.-.-.-.-.-.-.-.-.-.-.-.-.-.-X-
------------------------------------------------,-X-,-.-.-.-.-,-,-X-X-.-.-.-.-,-,-H-.-.-.-.-.-.-.-.-.-.-.-.-.-.-.-.-.-,-,-.-.-.-.-.-X-------------------,-X-.-.-,-t9.-.-.-E-E-.-E-.-.-.-.-.-.-.-.-.-.-.-.-X-
--------------------------------------------------X-.-.-.-,-,-,-.-X-X-.-.-.-.-.-,-,-.-.-.-.-.-.-.-.-.-.-.-.-.-.-.-.-,-,-.-.-.-.-.-.-X-------------------,-X-.-.-,-t9.-.-.-.-.-.-.-.-.-E-.-.-.-E-.-E-.-.-.-X-
--------------------------------------------------,-X-,-,-,-.-.-.-.-X-X-.-.-.-.-.-,-,-.-.-H-.-.-.-.-.-.-.-.-.-A-.-,-,-.-.-.-.-.-.-,-X-------------------,-X-.-.-.-t9.-.-.-.-.-.-.-.-.-.-.-.-.-.-.-.-.-.-.-X-
----------------------------------------------------X-,-.-.-.-.-.-,-X-X-.-.-E-.-.-.-,-,-,-.-.-.-.-.-H-.-.-.-.-,-,-,-.-.-.-E-.-.-,-X---------------------,-X-.-.-.-t9.-.-.-.-.-.-.-.-.-.-.-.-E-.-.-E-.-.-.-X-
----------------------------------------------------,-X-.-.-.-,-,-,-.-X-X-.-.-.-.-.-.-.-,-,-,-,-,-,-,-,-,-,-,-,-.-.-.-.-.-.-.-,-X-----------------------,-X-.-.-.-t9.-.-.-E-E-.-E-.-E-.-.-.-.-.-.-.-.-.-.-X-
----------------------------------------------------,-X-.-.-,-,-.-.-,-,-X-.-.-.-.-.-.-.-.-.-.-.-.-.-.-.-.-.-.-.-.-.-.-.-.-.-.-X-------------------------,-X-.-.-.-t9.-.-.-.-.-.-.-.-.-.-.-.-E-.-.-E-.-.-.-X-
------------------------------------------------------,-X-,-,-.-.-,-,-.-,-X-.-.-.-.-.-.-.-.-.-.-.-.-.-.-.-.-.-.-.-.-.-.-.-.-,-X---------------,-,-,-,-,-,-X-X-X-X-X9.-.-.-.-.-.-.-.-.-.-.-.-.-.-.-.-.-,-X-X-
------------------------------------------------------,-X-.-.-,-,-,-.-,-,-X-X-.-.-.-.-.-E-.-.-.-.-.-.-.-.-.-.-.-E-.-.-.-.-,-X-----------------,-X-X-X-X-X-X-X-X-X-X-.-.-.-.-.-.-.-.-.-.-.-.-.-,-X-X-X-X-----
--------------------------------------------------------,-X-,-,-.-.-.-,-.-.-X-X-X-.-.-.-.-.-.-.-.-.-t5.-.-.-.-.-.-,-,-.-.-X-,-----------------,-X-.-.-.-.-.-.-.-.-.-.-.-.-.-.-.-.-.-.-,-,-X-X-X-------------
--------------------------------------------------------,-X-,-.-.-.-,-,-.-.-,-.-X-X-.-.-.-.-.-.-.-.-.-.-.-.-.-,-,-,-,-X-X-.-X-,---------------,-X-.-.-.-.-.-.-.-.-.-.-.-.-.-.-.-,-X-X-X-X-------------------
----------------------------------------------------------,-X-.-.-,-,-.-.-,-,-.-,-.-.-.-X-X-.-.-.-.-.-.-.-.-.-,-X-.-.-.-.-.-X-X-,-------------,-X-.-.-.-.-.-.-.-.-.-.-.-,-X-X-X-X---------------------------
------------------------------------------------------------,-X-.-,-.-.-.-,-.-,-,-.-.-.-X-,-X-X-X-+-+-+-X-X-X-X-X-.-.-.-.-.-.-,-X-------------,-X-.-.-.-.-.-.-.-t9.-.-X-X-----------------------------------
--------------------------------------------------------------,-X-,-.-.-,-,-.-,-.-.-.-.-.-X-X-X-X-.-.-.-X-X-X-.-.-.-.-.-.-.-.-A-X-,-----------,-X-.-.-.-.-.-.-.-t9.-E-X-------------------------------------
----------------------------------------------------------------,-X-.-.-,-.-.-,-.-.-.-.-.-.-.-.-.-.-.-.-.-.-.-.-.-.-.-.-.-W-.-.-X-X-----------,-X-X-X-X-X-X-X-X-X9X]X-X-------------------------------------
------------------------------------------------------------------,-X-,-,-.-.-,-.-.-.-.-.-.-.-.-.-.-.-.-.-.-.-.-.-.-.-.-.-.-.-.-.-X-------------------------------------------------------------------------
--------------------------------------------------------------------,-X-X-.-,-,-.-.-.-.-.-.-.-.-.-.-.-.-.-.-.-.-.-.-.-.-.-.-.-.-,-X-------------------------------------------------------------------------
----------------------------------------------------------------------,-,-X-X-.-.-.-.-.-.-.-.-.-.-:-H-.-.-.-.-.-.-.-.-.-.-.-,-X-X---------------------------------------------------------------------------
--------------------------------------------------------------------------,-,-X-X-X-,-,-.-.-.-.-.-.-.-.-.-.-.-.-,-,-.-,-X-X-X-------------------------------------------------------------------------------
----------------------------------------------------------------------------------,-X-X-,-,-.-.-.-.-.-.-.-.-,-,-,-X-X-X-------------------------------------------------------------------------------------
------------------------------------------------------------------------------------,-X-.-,-,-,-,-,-,-,-,-,-,-.-.-X-----------------------------------------------------------------------------------------
------------------------------------------------------------------------------------,-X-.-A-X-X-X-+-+-+-X-X-X-.-A-X-----------------------------------------------------------------------------------------
------------------------------------------------------------------------------------,-X-.-.-X-,-X-,-,-,-X-,-X-.-.-X-----------------------------------------------------------------------------------------
--------------------------------------------------------------------------------,-,-,-X-.-.-X-,-X-.-.-.-X-,-X-.-.-X-,-,-------------------------------------------------------------------------------------
--------------------------------------------------------------------------------,-X-X-X-.-.-X-X-X-.-.-.-X-X-X-.-.-X-X-X-------------------------------------------------------------------------------------
--------------------------------------------------------------------------------,-X-.-.-.-.-.-.-.-.-.-.-.-.-.-.-.-.-.-X-------------------------------------------------------------------------------------
--------------------------------------------------------------------------------,-X0.-.-E-.-.-.-.-.-.-.-.-.-.-.-.-.-.-X-------------------------------------------------------------------------------------
--------------------------------------------------------------------------------,-X0.-.-.-.-.-.-.-.-E-.-.-.-.-E-.-.-.-X-------------------------------------------------------------------------------------
--------------------------------------------------------------------------------,-X0.-.-.-.-.-.-.-.-.-.-.-.-.-.-.-.-.-X-------------------------------------------------------------------------------------
--------------------------------------------------------------------------------,-X-.-.-.-.-.-,-,-,-,-,-,-.-.-,-,-,-,-X-------------------------------------------------------------------------------------
--------------------------------------------------------------------------------,-X-X-X-X-XP.-XPX-,-,-,-X-XP.-XP,-,-,-X-------------------------------------------------------------------------------------
----------------------------------------------------------------------------------------,-X-.-.-.-.-.-.-X-X-.-.-.-.-.-X-------------------------------------------------------------------------------------
----------------------------------------------------------------------------------------,-X-.-.-.-:-.-<-X-X-.-.-.-.-.-X-------------------------------------------------------------------------------------
----------------------------------------------------------------------------------------,-X-.-.-.-.-.-.-X-X-.-.-.-.-.-X-------------------------------------------------------------------------------------
----------------------------------------------------------------------------------------,-X-X-X-X-X-X-X-X-X-X-X-X-X-X-X-------------------------------------------------------------------------------------
