----------------------------------------------------------------------------------------------------------------------------------,-,-X-X-X---------------------------------------------
--------------------------------------------------------------------------------------------------------------------------,-,-,-,-,-X-.-.-X-,-,-,-,-------------------------------------
--------------------------------------------------------------------------------------------------------------------------,-X-X-X-X-X-.-.-X-X-X-X-X-------------------------------------
--------------------------------------------------------------------------------------------,-,-,-,-------,-,-,-,-,-,-,-,-,-X-,-,-.-.-.-.-.-,-,-.-X-------------------------------------
------------------------------------------------------------------------------------------,-,-X-X-X-----,-,-X-X-X-,-X-X-X-X-X2,2,-,-,-.-,-,-,-,-.-X-------------------------------------
----------------------------------------------------,-,-,-,-,-,-,-,-,-,-,-,-,-,-,-,-,-,-,-,-X-.-A-X-,-,-,-X-E-A-X-,-X-.-.-X-X-.2:-,---,-.-E-.-.-.-X-,-,---------------------------------
----------------------------------------------------,-X-X-X-X-X-X-X-X-X-X-X-X-X-X-X-X-X-X~X~X-,-,-X-X~X~X~X-,-,-X-X-X-.-.-XRX-.2.-.-,-,-,-.-.-.-.-X-X-X-,-------------------------------
----------------------------------------------------,-X-.-.-.-.-.-.-.-.-.-.-.-.-.-.-.-.-.~.~.~.~.~.~.~.~.~.~.~,~,-,-.-.-.-+R.-.2.-.-.-.3.3.3.-.-.-.-.-.-X2------------------------------
----------------------------------------------,-,-,-,-X-.-.-.-.-.-.-.-.-.-.-.-.-.-.-.-.-A~,~,~,~,~,~.~.~,~,~,~,~,-,-.-.-E-+R.-.2t5.-.-.3K-.3.-E-t4.-.-<-X2------------------------------
----------------------------------------------,-X-X-X-X4.-.-.-.-.-X-X-X-X-X-X-X-X-X-X-X-X~X~X0.0.0X0X~X~X~X-.-.-X-X-X-.-.-+R.-.2.-,-,-.3,3,3.-.-.-.-,-X-X2------------------------------
----------------------------------------------,-X-.-.-t4E-.-E-.-E-X---------,-X0X0X0X0X0--,-X-.-.-X-----,-X-E-A-X-,-X-.-.-XRX-.2,-.-,-.-,---,-.-.-X-X-----------------------------------
----------------------------------------------,-X-.-.-t4.-.-.-.-.-X---------,-X-.-A-.-X---,-X-.-.-X-------,-X-X-X-,-X-.-H-X-X-,2.-,-.-.-.-,---,-.-X-------------------------------------
----------------------------------------------,-X-.-.-t4.-.-.-.-.-X-,-,-,-,-,-X-.-<-.-X-,-,-X-.-.-X-----------------,-X-X-X-X2,2,-.-:-.-.-.-,-E-.-X-------------------------------------
----------------------------------------------,-X-.-.-t5E-.-E-.-E-X-,-X-X-X-X-X-,-,-,-X-X-X-X-.-.-X-----------------------,-X-.-.-.-.-.-.-.-.-.-.-X-------------------------------------
----------------------------------------------,-X-X-X-X5X-X-X-X-X-X-X-.-E-.-.-.-.-.-.-.-,-,-.-.-.-X-----------------------,-X-X-X-X-X-.-.-X-X-X-X-X-------------------------------------
----------------------------------------------------------------,-.-X-.-.-.-.-E-.-.-.-.-,-,-.-.-.-X---------------------------------,-X-A-X---------------------------------------------
----------------------------------------------------------------,-X-.-.-.-.-.-.-.-.-.-.-,-,-.-.-.-X-----------------------------------,-X-----------------------------------------------
----------------------------------------------------------------,-X-.-.-.-.-.-.-.-.-E-.-,-,-.-.-.-X-------------------------------------------------------------------------------------
----------------------------------------------------------------,-X-.-.-.-.-.-.-.-.-.-.-,-,-.-.-.-X-------------------------------------------------------------------------------------
----------------------------------------------------------------,-X-.-.-.-.-.-.-.-.-.-.-,-,-.-.-.-X---------------------------,-,-,-,-,-,-,-,-------------------------------------------
----------------------------------------------------------------,-X-.-.-.-.-.-.-.-.-.-.-E-,-.-.-.-X-----------------------,-,-,-X-X-X-,-X-X-X-,-,---------------------------------------
----------------------------------------------------------------,-X-,-,-,-,-,-,-,-,-,-,-,-,-.-.-.-X---------------------,-,-X-X-.-H-X-,-X-H-.-X-X-,-------------------------------------
----------------------------------------------------------------,-X-.-.-,-,-,-,-,-,-,-,-,-,-.-.-.-X---------------------,-X-.-.-.-.-X-X-X-.-.-.-.-X-------------------------------------
----------------------------------------------------------------,-X-.-.-,-./.-.-.-.-.-.-.-.-.-.-.-X---------------------,-X-.-.-.-.-.-A-.-.-.-.-.-X-------------------------------------
----------------------------------------------------------------,-X-.-.-,-./E-.-.-.-.-.-.-.-.-.-.-X---------------------,-X-.-.-.-E-.-.-E-.-.-.-.-X-------------------------------------
----------------------------------------------------------------,-X-.-.-,-./.-.-.-.-.-.-.-.-.-.-.-X---------------------,-X-.-.-.-.-.-.-.-.-.-.-.-X-------------------------------------
----------------------------------------------------------------,-X-.-.-,-X-X-X-X-X/./././X/X-.-.-X---------------------,-X-E-.-.-.-.-.-.-.-.-E-.-X-------------------------------------
----------------------------------------------------------,-,-,-,-X-.-.-.-X-,-,-,-X-.-.-.-X-X-.-.-X---------------------,-XX+X+X+X+XXXX-XX+X+X+X+XXX,-,-,-,-----------------------------
----------------------------------------------------------,-X-X-X-X-L-L-L-X-X-X-X-X-X-X-X-X-X-,-,-X---------------------,-XX+X+X+X+XXX,-XX+X+X+X+XXX,-X-X-,-,-,-------------------------
----------------------------------------------------------,-X-E-.-.-.-H-.-.-.-.-X-X-X-X-X-X-X-,-,-X---------------------,-X-.-.-.-.-X-X-X-.-.-.-.-X8X-X-.-X-X-X-------------------------
----------------------------------------------------,-,-,-,-X-.-.-.-.-.-.-.-.-.-.-,-,-,-,-,-.-.-.-X---------------------,-X-.-.-.-.-.-.-.-.-.-.-.-.8.-.-.-.-.-X-------------------------
----------------------------------------------------,-X-X-X-X-.-.-.-.-.-.-.-.-.-.-,-,-,-,-,-.-.-.-X---------------------,-X-.-.-.-.-.-.-.-.-.-.-.-.8.-.-.-.-.-,-X-----------------------
----------------------------------------------------,-X-A-.-.-.-.-.-.-.-.-.-.-.-X-X-X-X-X-X-X-X-X-X---------------------,-X-.-.-.-.-.-.-.-.-.-.-.-.8.-.-.-.-.-.-X-----------------------
----------------------------------------------------,-X-.-.-.-.-,-,-E-,-,-,-,-,-X-X-X-,-,-------------------------------,-X-,-,-,-,-.-.-.-.-.-.-.-.8.-.-.-.-.-.-X-----------------------
----------------------------------------------------,-X-<-.-.-.-,-,-,-,-,-,-,-,-,-,-,-X-X-,-----------------------------,-X:t:t:t:t:X:X-X-,-,-,-,-X8X-X-,-,-,-,-X-----------------------
----------------------------------------------------,-X-.-.-.-.-,-,-.-.-.-.-.-.-.-.-,-,-,-X-,---------------------------,-X-,-,-,-,-X-,-X-,-,-,-,-X-,-X-,-,-,-,-X-----------,-,-,-,-,-,-
----------------------------------------------------,-X-.-.-.-.-,-,-.-.-.-.-.-.-.-.-.-.-,-.-X---------------------------,-X-,-,-,-,-X-X-X-.-.-.-.-X8X-X-.-.-.-.-X-----------,-X-X-X-X-X-
----------------------------------------------------,-X-.-.-.-.-,-,-E-.-.-.-.-.-.-.-.-.-,-,-,-X-,-,-,-,-,-,-,-,-,-,-,-,-,-X-.-.-.-.-.-A-.-.-.-.-.-.8A-.-.-.-.-,-X-,-,-,-,-,-,-X-.-.-B-X-
------------------------------------,-,-,-,-,-,-,-,-,-X-.-.-.-.-,-,-.-.-.-.-.-.-.-.-.-.-.-,-,-X-X-X-X-X-X-X-X-X-X-X-X-X-X-X;.-.-.-.-.-.-.-.-.-E-.-.8.-.-.-.-.-,-X-X-X-X-X-X-X-X;.-.-.-X-
------------------------------------,-X-X-X-X-X-X-X-X-X-.-.-.-.-,-,-.-.-.-.-.-.-.-.-.-.-.-,-W-+-+[+[.-.-.-.-+W.-.-.-.-A-+-.;.-.-.-.-.-.-.-.-.-.-.-.8.-.-.-.-.-,-,-,-,-.-.-,-,-.;.-.-.->-
------------------------------------,-X-<-.-,-,-,-,-.-.-<-.-.-.-,-,-.-.-.-.-.-.-.-.-.-.-.-E-,-+-+[.-.-.-A-.-+WA-.-E-.-A-+-.;.-.-.-.-.-.-.-.-.-E-.-.8.-.-.-t:.-,-,-,-,-.-<-,-,-.;E-.-H->-
------------------------------------,-X-X-X-X-X-X-X-X-X-.-.-.-.-,-,-.-.-.-.-.-.-.-.-.-.-.-,-A-+-+[+[.-.-.-.-+W.-.-.-.-A-+-.;.-.-.-.-.-.-.-.-.-.-.-.8.-.-.-.-.-,-,-,-,-.-.-,-,-.;.-.-.->-
--------------------------------------------------,-,-X-.-.-.-.-,-,-.-.-.-.-.-.-.-.-.-.-,-,-,-X-X[X[.-X-X-X-X-X-X-.-X-X-X-X;.-.-.-.-.-.-.-.-.-.-.-.8.-.-.-.-.-,-X-X-X-X-X-X-X-X;.-.-.-X-
--------------------------------------------------,-X-X1.-.-.-.-,-,-E-.-.-.-.-.-.-.-.-.-,-.-X-,-,-X-X-X-------,-X-X-X---,-X-.-.-.-,-,-,-,-.-.-E-.-.8.-.-.-.-.-.-X-----------,-X-.-.-.-X-
--------------------------------------------------,-X-.1.-.-.-.-,-,-.-.-.-.-.-.-.-.-.-.-,-.-X---------------------------,-X-,-,-,-,-,9A9,9,-,-,-,-X8X-X-,-,-,-,-X-----------,-X-X-X-X-X-
--------------------------------------------------,-X-.1.-.-.-.-,-,-,-,-,-,-,-,-,-,-,-,-,-X-,---------------------------,-X-.-.-.-,-.9,9,9,-,-,-,-X-,-X-,-,-,-,-X-----------------------
--------------------------------------------------,-X-.1.-.-.-.-,-,-,-,-,-,-,-,-,-.-.-.-,-X-----------------------------,-X-,-,-,-,-,9,9,9.-.-.-.-X8X-X-.-.-.-.-X-----------------------
--------------------------------------------------,-X-X1<-.-.-.-.-.-E-.-.-.-.-.-X-X-X-X-X-,-,-,-,-,---------------------,-X-.-.-.-.-.-.-.-.-.-.-.-.8.-.-.-.-.-.-X-----------------------
----------------------------------------------------,-X-.-.-.-.-.-.-.-.-.-.-.-.-X-X-X-X-X-X-X-X-X-X---------------------,-X-.-.-.-.-.-.-.-.-.-.-.-.8.-.-.-.-.-,-X-----------------------
----------------------------------------------------,-X-X-X-X-.-.-.-.-.-.-.-.-.-.-,-,-,-,-,-.-E-.-X---------------------,-X-.-.-.-.-.-.-.-.-.-.-.-.8.-.-.-.-.-X-------------------------
----------------------------------------------------------,-X-.-.-.-.-.-.-.-.-.-.-,-,-,-,-,-,-,-,-X---------------------,-X-.-.-.-.-.-.-.-.-.-.-.-.8.-.-.-.-.-X-------------------------
----------------------------------------------------------,-X-E-.-.-.-.-.-.-.-.-X-X-X-X-X-X-X-,-,-X---------------------,-X-.-.-.-.-X-X-X-.-.-.-.-X8X-X-.-.-,-X-------------------------
------------,-,-,-,-,-,-,-,-,-,---------------------------,-X-X-X-X-.-H-.-X-X-X-X---------,-X-,-,-X---------------------,-XX+X+X+X+XXX,-XX+X+X+X+XXX,-X-X-X-X---------------------------
--------,-,-,-X-X-X-X-X-X-X-X-X---------------------,-,-,-,-,-,-,-X-L-L-L-X-,-,-----------,-X-.-.-X---------------------,-XX+X+X+X+XXXX-XX+X+X+X+XXX------------------------------------
--------,-X-X-.-.-.-.-.-.-.-H-X-,-,-,---------------,-X-X-X-X-X-X-X-.-.-.-X-X-X-------,-,-,-X-.-A-X-,-,-----------------,-X-.-.-.-.-.-.-.-.-.-.-.-X-------------------------------------
--------,-X-.-.-.-.-.-.-.-.-.-X-X-X-X-,-,-,---------,-X-E-.-.-.-E-.-.-.-.-E-.-X-------,-X~X~X~.-.-X-X~X~----------------,-X-E-.-.-.-.-.-.-.-.-E-.-X-------------------------------------
--------,-X-.-.-.-.-.-.-.-.-.-,-,-,-,-X-X-X-,-------,-X-.-.-.-.-.-.-.-.-.-.-.-X-,-,-,-,-X~.~,~.-.-,-.~X~,-,-,-,---------,-X-.-.-.-.-.-.-.-.-.-.-.-X-------------------------------------
--------,-X-.-.-.-.-.-.-.-.-.-,-,-,-,-.-E-.-X-,-----,-X-.-.-.-.-.-.-.-.-.-.-.-X-X-X-X~X~X~.~,~.-.-,-.~X~X~XNX-X---------,-X-.-.-.-E-.-A-E-.-.-.-.-X-------------------------------------
--------,-X-.-.-.-.-.-.-.-.-.-,-,-,-,-.-.-.-.-X-----,-X-.-.-.-,-A-,-,-,-,-,-A-X-X-,-.~.~.~.~,~.-.-,-.~.~,~.-.-X---------,-X-.-.-.-.-X-X-X-.-.-.-,-X-------------------------------------
--------,-X-.-.-.-.-,-,-,-,-,-X-X-X-X-.-.-.-.-X-----,-X-.-.-.-,-.-.-.-.-.-.-.-X-X-H-.~A~.~.~,~.-.-,-.~.~A~.-H-X-----------,-X-X-.-H-X-,-X-H-,-X-X---------------------------------------
--------,-X-.-.-.-.-,-.~.~.~,~X~----,-X-.-.-.-X-----,-X-.-.-.-,-.-.-.-.-.-.-.-X-X-,-.~.~.~.~,~.-.-,-.~.~,~.-.-X---------------,-X-X-X-,-X-X-X-------------------------------------------
,-,-,-,-,-X-E-.-.-.-,-.~.~.~A~X-----,-X-,-,-,-X-----,-X-E-.-.-,-.-.-.-.-.-.-.-X-X-X-X~X~X~.~,~.-.-,-.~X~X~XNX-X-------------------------------------------------------------------------
X-X-X-X-X-X-.-.-.-.-,-,~,~,~,~X~----,-X-,-,-,-X-,-,-,-X-.-.-.-,-.-.-.-.-.-.-.-X-,-,-,-,-X~.~,~.-.-,-.~X~,-,-,-,-------------------------------------------------------------------------
X-A-.-E-.-.-.-.-.-.-,-,-,-.-.-X-----,-X-.-,-,-X-X-X-X-X-.-.-.-,-.-.-.-.-.-.-.-X6X-X-XNX~X~.~,~.-.-,-.~X~X~XNX-X-------------------------------------------------------------------------
X-.-.-.-.-.-.-.-.-.-,-,-,-.-.-X7----,-X-.-.-.-,-,-.-+-.-.-.-.-,-.-.-.-.-.-.-.-X6X-E-,~.~.~.~,~.-.-,-.~.~,~.-E-X-------------------------------------------------------------------------
X-H-.-E-.-.-E-.-.-A-,-,-,-.-A-X7----,-X-.-.-.-,-,-<-+-.-.-.-.-,-.-E-.-W-.-E-.-X6X-H-,~A~.~.~,~.-.-,-.~.~A~.-H-X-------------------------------------------------------------------------
X-.-.-.-.-.-.-.-.-.-,-,-,-,-,-X7----,-X-.-.-.-,-,-.-+-.-.-.-.-,-.-.-.-.-.-.-.-X6X-E-,~.~.~,~,~.-.-,-.~.~,~.-E-X-------------------------------------------------------------------------
X-A-.-E-.-.-.-.-.-.-,-.~.~.~,~X~----,-X-,-,-,-X-X-X-X-X-E-.-.-,-.-.-.-.-.-.-.-X6X-X-XNX~X~,~......,..~X~X~XNX-X-------------------------------------------------------------------------
X-X-X-X-X-X-.-.-.-.-,-,~.~.~A~X-----,-X-,-,-,-X-----,-X-.-.-.-,-.-.-.-E-.-.-.-X-------,-X~,~.-.-<-,-.~X~--------------------------------------------------------------------------------
--------,-X-E-.-.-.-.-,-,~,~,~X~,-,-,-X-.-.-.-X-----,-X-.-.-.-,-.-.-.-.-.-.-.-X-------,-X~X~X-.-K-X-X~X~--------------------------------------------------------------------------------
--------,-X-.-.-.-.-.-.-.-.-.-X-X-X-X-X-.-.-.-X-----,-X-.-.-.-,-.-.-.-.-.-.-,-X-,-,-,-,-,-,-X-+-+-X-------------------------------------------------------------------------------------
--------,-X-.-.-.-.-.-.-.-.-.-,-,-,-,-.-.-.-,-X-----,-X-.-.-.-,-.-.-.-.-.-.-,-X-X-X-X-X-X-X-X-.-.-X-------------------------------------------------------------------------------------
--------,-X-.-.-.-.-.-.-.-.-.-,-,-,-,-.-.-,-X-------,-X-E-.-.-,-.-.-.-.-.-.-,-.-,-,-.-.-.-.-.-E-.-X-------------------------------------------------------------------------------------
--------,-X-.-.-.-.-.-:-.-.-.-,-,-,-,-.-,-X---------,-X-A-A-,-,-,-,-,-,-,-,-,-.-,-,-.-.-.-.-.-E-.-X-------------------------------------------------------------------------------------
--------,-X-.-.-.-.-.-.-.-.-.-X-X-X-X-X-X-----------,-X-X-X-X-X-,-XV.-.-XVX-.-X-X-X-X-X-X-X-X-X-X-X-------------------------------------------------------------------------------------
--------,-X-.-.-.-.-.-.-.-.-.-X-----------------------------,-X-,-X-E-E-X-X-.-X---------------------------------------------------------------------------------------------------------
--------,-X-X-X-X-X-X-X-X-X-X-X-----------------------------,-X-,-X-X-X-X-X-.-X---------------------------------------------------------------------------------------------------------
------------------------------------------------------------,-X-.-.-.-.-.-.-.-X---------------------------------------------------------------------------------------------------------
------------------------------------------------------------,-X-X-X-.-.-.-X-X-X---------------------------------------------------------------------------------------------------------
----------------------------------------------------------------,-X-A-.-A-X-------------------------------------------------------------------------------------------------------------
----------------------------------------------------------------,-X-.-H-,-X-------------------------------------------------------------------------------------------------------------
------------------------------------------------------------------,-X-X-X---------------------------------------------------------------------------------------------------------------
