------------------------------------------------------,-X-X-X-X-X-X-X-X-X-X-X-X-X-X-X-X-X-X-X-X-X-X-X-----------------------------------------------------------------------------------------
------------------------------------------------------,-X-.-,-.-.-,-.-E-,-.-.-.-,-.-E-,-.-.-,-.-.-.-X-----------------------------------------------------------------------------------------
------------------------------------------------------,-X-,-,-.-.-,-,-,-,-.-.-.-,-,-,-,-.-.-,-,-,-.-X-----------------------------------------------------------------------------------------
------------------------------------------------------,-X-.-.-.-.-.-.-.-.-.-.-E-.-.-.-.-.-.-.-.-,-.-X-----------------------------------------------------------------------------------------
------------------------------------------------------,-X-.-.-.-.-.-.-.-.-.-.-.-.-.-.-.-.-.-.-.-,-.-X-----------------------------------------------------------------------------------------
------------------------------------------------------,-X-.-.-.-.-.-.-.-.-.-.-.-.-.-.-.-.-.-.-.-,-.-X-----------------------,-,-,-,-----------------------------------------------------------
------------------------------------------------------,-X-.-.-.-.-.-.-.-,-,-,-,-,-,-.-.-.-.-.-.-,-.-X-------------,-,-,-,-,-,-X-X-X-,-,-,-,-,-------------------------------------------------
------------------------------------------------------,-X-.-.-.-.-.-.-,-,-X-,-,-,-X-X-.-.-.-.-.-,-.-X-------------,-X-X-X-XNX-X-<-X-X-XNX-X-X-------------------------------------------------
------------------------------------------------------,-X-.-.-.-.-.-.-X-X-X-,-,-,-X-,-X-.-.-.-.-,-.-X-------------,-X-.-.-.-<-.-.-.-<-.-.-E-X-------------------------------------------------
------------------------------------------------------,-X-.-.-.-.-,-X-X-.-.-.-H-.-.-X-X-,-.-.-.-,-.-X-------------,-X-.-E-+N.-.-<-.-.-+NE-H-X-------------------------------------------------
------------------------------------------------------,-X-.-.-.-.-,-X-.-.-.-E-.-E-.-.-,-X-.-.-.-,-.-X-------------,-X-.-.-.-.-.-.-.-.-.-.-E-X-------------------------------------------------
------------------------------------------------------,-X-.-.-.-,-,-,-.-.-E-.-.-.-E-.-,-,-.-.-.-,-.-X-------------,-X-X-X-XNX.......X.XNX-X-X-------------------------------------------------
------------------------------------------------------,-X-.-.-.-,-.-,-.-.-.-.-.-.-.-.-,-,-.-.-.-,-.-X-------------,-,-,-,-,-X-.-.-.-X-,-,-,-,-------------------------------------------------
------------------------------------------------------,-X-,-,-.-,-,-,-E-.-.-.-.-.-.-.-E-,-.-,-,-,-.-X-------------,-X-X-X-XOX-.-.-.-X-XOX-X-X-------------------------------------------------
------------------------------------------------------,-X-.-,-.-.-,-X-.-.-.-.-.-.-.-,-,-X-.-,-.-.-.-X-------------,-X-.-.-.-.-.-.-.-.-.-.-E-X-------------------------------------------------
------------------------------------------------------,-X-E-,-,-,-,-X-.-.-.-.-.-.-.-,-X-X-,-,-.-E-.-X-------------,-X-.-.-+O.-.-<-.-.-+O.-H-X-------------------------------------------------
------------------------------------------------------,-X-.-,-,-X-X-X-X-X-.-.-<-.-.-,-X-X-X-X-.-.-.-X-------------,-X-.-.-.-.-.-.-.-.-.-.-E-X-------------------------------------------------
------------------------------------------------------,-X-X-X-X---------,-X-.-.-.-X-X-------,-X-X-X-X-------------,-X-X-X-XOX/./././X/XOX-X-X-------------------------------------------------
------------------------------------------------------------------------,-X-,-,-,-X-------------------------------------,-,-X-.-.-.-X-,-------------------------------------------------------
------------------------------------------------------------------------,-X-,-,-,-X-------------------------------------,-X-X-.-.-.-X-X-------------------------------------------------------
------------------------------------------------------------------------,-X-,-,-,-X-------------------------------------,-X-.-.-.-.-.-X-------------------------------------------------------
------------------------------------------------------------------------,-X-,-,-,-X-------------------------------------,-X-H-.-.-.-H-X-------------------------------------------------------
------------------------------------------------------------------------,-X-,-,-,-X-------------------------------------,-X-.-.-.-.-.-X-------------------------------------------------------
------------------------------------------------------------------------,-X-,-,-,-X-------------------------------,-,-,-,-X-X-+-+-+-X-X-,-,-,-------------------------------------------------
----------------------------------------------------------------,-,-,-,-,-X-,-,-,-X-,-,-,-,-----------------------,-X-X-X-X-X-+-+-+-X-X-X-X-X-------------------------------------------------
----------------------------------------------------------------,-X-X-X-X-X-.-.-.-X-X-X-X-X-------------------,-,-,-X-.-.-.-.-.-.-.-.-.-.-.-X-,-,---------------------------------------------
------------------------------------------------------------,-,-,-X-.-,-,-.-.-.-.-,-,-.-.-X-,-,-,-,-,-,-,-,-,-,-X-X-X-.-.-.-.-.-E-.-.-.-.-.-X-X-X---------------------------------------------
------------------------------------------------------------,-X-X-X-.-.-,-.-.-.-.-,-.-.-.-X-X-X-X-X-X-X-X-X-X-X-X-.-.-.-.-.-.-.-.-.-.-.-.-.-.-.-X-,-,-,-,-,-,---------------------,-,-,-,-,-,-
------------------------------------------------------------,-X-.-.-.-.-,-.-.-A-.-,-.-.-.-.-.-.-,-,-,-,-,-,-,-,-.-.-.-.-.-.-.-.-.-.-.-.-.-.-B-.-X-X-X-X-X-X-X---------------------,-X-X-X-X-X-
------------------------------------------------------------,-X-H-.-.-.-,-,-.-.-,-,-.-.-.-.-.-.-,-,-,-,-,-,-,-,-.-.-.-.-.-.-.-.-.-.-.-.-.-.-.-.-X-X-.-A-B-.-X-,-,-----------------,-X-.-.-.-X-
------------------------------------------------------------,-X-.-.-.-.-.-,-,-,-,-.-.-.-.-.-.-.-,-,-,-,-,-,-,-,-.-E-.-.-.-.-.-.-.-.-.-.-.-.-.-E-X-X-.-.-.-.-X-X-X-----------------,-X1t1t1t1X1
--------------------------------------------------------,-,-,-X-X-X-.-.-.-.-.-.-.-.-.-.-.-X-X-X-X-X-X-X-X-X-X-X-X-.-.-.-.-.-.-.-.-.-.-.-.-.-.-.-L-L-.-.-.-B-+-.-X-----------------,-X-.-.-.-X-
--------------------------------------------------------,-X-X-X-X-XV.-.-.-.-.-.-.-.-.-.-.-X---,-,-,-,-,-,-,-,-,-X-E-.-.-.-.-.-A-W-A-.-.-.-.-.-E-L-L-.-.-.-.-X-X-X---------------,-,-X-E-.-E-X-
--------------------------------------------------------,-X-.-.-.-.6.-.-.-.-.-.-.-.-.-.-.-X---,-X-X-X-X-X-X-X-X-X-.-.-.-.-.-.-.-.-.-.-.-.-.-.-.-L-L-.-.-.-.-X-------------------,-X-X-X-X-X-X-
--------------------------------------------------------,-X-A-.-.-,6E-,-,-,-,-,-,-,-,-,-E-X---,-X-.-.-.-,-,-,-,-.-.-.-.-.-.-.-.-.-.-.-.-.-.-.-.-X-X-.-.-.-.-X-----------------,-,-X-----------
--------------------------------------------------------,-X-.-X-X-XV.-X-X-X-.-.-.-X-X-X-.-X---,-X-.-.-.-,-,-,-,-.-E-.-.-.-.-.-.-.-.-.-.-.-.-.-E-X-X-,-,-,-,-X-,-,-,-,---------,-X-X-----------
--------------------------------------------------------,-X-H-X-,-X-,-X-,-X-,-,-,-X-,-X-,-X---,-X-,-,-,-,-,-,-,-.-.-.-.-.-.-.-.-.-.-.-.-.-.-.-.-X-X-,-,-,-,-X-X-X-X-X-,-,-,-,-,-X-------------
--------------------------------------------------------,-X-.-X-X-XV.-X-X-X-.-.-.-X-X-X-.-X---,-X-,-,-,-X-X-X-X-X-.-.-.-.-.-.-.-.-.-.-.-.-.-.-.-X-X2,2,2,2,2X2X-X-X-X-X-X-X-X-X-X-------------
--------------------------------------------------------,-X-A-.-.-.-.-.-.-.-.-.-.-.-.-.-.-X---,-X-.-.-.-X-----,-X-X-X-.-.-.-.-.-.-.-.-.-.-.-X-X-X-X-,-,-,-,-X-------,-X-X-X-X-X---------------
--------------------------------------------------------,-X-X-X-X-XV.-.-.-.-.-.-.-.-.-.-.-X---,-X-,-,-,-X---------,-X-.-.-.-E-E-.-E-E-.-.-.-X---,-X-.-.-.-.-X---------------------------------
----------------------------------------------------------------,-X-X-X-.-.-.-.-.-.-.-X-X-X---,-X-,-,-,-X---------,-X-X-X-X-X-.-.-.-X-X-X-X-X-,-,-X-.-.-.-.-X-,-,-----------------------------
--------------------------------------------------------------------,-X-.-.-.-.-.-.-.-X---,-,-,-X0.0.0.0X0,-,-------------,-X-,-H-,-X-X-X-X-X-X-X;X-.-.-.-.-X-X-X-----------------------------
--------------------------------------------------------------------,-X-E-.-.-.-.-.-E-X---,-X-X-XP.-.-.-X-X-X-------------,-X-X-X-X-X-X-.-.-.-.-.;.-E-E-.-E-.-,-X-----------------------------
--------------------------------------------------------------------,-X-B-E-.-.-.-E-.-X---,-X-H-.-.-.-.-.-H-X-----------------------,-X-.-E-.-.-.;.-.-.-.-.-.-H-X-----------------------------
--------------------------------------------------------------------,-X-X-X-.-E-.-X-X-X---,-X-X-XP.-.-.-X-X-X-----------------------,-X-.-.-.-.-.;.-.-.-.-.-.-,-X-----------------------------
------------------------------------------------------------------------,-X-L-L-L-X-----------,-X-E-.-E-X---------------------------,-X-.-.-.-X-X;X-.-.-.-.-X-X-X-----------------------------
------------------------------------------------------------------,-,-,-,-X-.-A-.-X-,-,-,-,-,-,-X-+-+-+-X-,-,-,-,-,-,-,-,-,-,-,-,-,-,-X-+-+-+-X-,-X-,-t1,-,-X---------------------------------
------------------------------------------------------------------,-X-X-X-X-.-.-.-X-X-X-X-,-X-X-X-+-+-+-X-X-X-,-X-X-X-X-X-,-X-X-X-X-X-X-+-+-+-X-X-X-X-,-,-X-X---------------------------------
--------------------------------------------------------------,-,-,-X-.-.-.-.-.-.-.-.-.-X-,-X-.-.-.-.-.-.-.-X-,-X-.-.-.-X-,-X-.-.-.-.-.-.-.-.-.-X-X-X-.-.-X-X---------------------------------
--------------------------------------------------------------,-X-X-X-.-.-.-.-.-.-.-.-.-X-X-X-.-.-.-.-.-.-.-X-X-X-.-.-.-X-X-X-.-.-.-.-.-.-.-.-.-X-X-.-H-.-.-X---------------------------------
--------------------------------------------------------------,-X-.-.-.-.-.-.-.-.-.-.-.-.-,-.-.-.-.-.-.-.-.-,-.-E-.-.-.-.-.-.-.-.-.-.-.-.-.-.-E-X-X-X-.-.-X-X---------------------------------
--------------------------------,-,-,-,-,-,-,-,-,-,-----------,-X-.-.-.-.-.-.-.-.-.-.-.-E-,-.-.-.-.-W-.-.-.-,-.-.-.-.-.-.-.-.-.-.-.-.-.-.-.-E-.-X-,-X-E-.-X-,---------------------------------
--------------------------------,-X-X-X-X9X9X9X-X-X-----------,-X-.-.-.-.-,-,-,-,-.-.-.-.-,-.-.-.-.-.-.-.-.-,-.-E-.-.-.-.-.-.-.-.-.-.-.-.-E-.-.-X-X-X-.-.-X-X---------------------------------
----------------------------,-,-,-X-.-.-.-A-.-.-.-X-,-,-------,-X-X-X-.-.-,-,-,-,-.-.-.-X-X-X-.-.-.-.-.-.-.-X-X-X-.-.-.-.7.7.7.-.-.-X-X-X-X-X-X-X-X-.-.-.-.-X---------------------------------
----------------------------,-X-X-X-.-.-.-.-.-.-.-X-X-X-------,-,-,-X-.-.-,-.-,-,-.-.-.-X-,-X-.-.-.-.-.-.-.-X-,-X-.-.-.-.7K-.7.-.-.-X-,-,-------,-X-.-E-.-.-X---------------------------------
------------,-,-,-,-,-,-,-,-,-X-.-.-.-.-.-.-.-.-.-.-.-X-,-,---,-X-X-X-.-.-,-,-,-,-.-.-.-X-X-X-.-.-.-.-.-.-.-X-X-X-.-.-.-.7.7.7.-.-.-X-X-X-------,-X-X-.-.-X-X---------------------------------
------------,-X-X-X-X-X-X-X-X-X-.-.-.-.-.-.-.-.-.-.-.-X-X-X---,-X-.-.-.-.-.-.-.-.-.-.-.-E-,-.-.-.-.-.-.-.-.-.-,-E-.-.-.-.-.-.-.-.-.-.-.-X-----,-,-,-X-.-.-X-,-,-------------------------------
------------,-X-.-.-.-,-,-,-.-.-.-.-.-.-E-E-.-.-.-.-.-.-.-X---,-X-.-.-.-.-.-.-.-.-.-.-.-.-,-.-.-.-.-.-.-.-.-.-,-.-.-.-.-.-.-.-.-.-.-.-.-X-----,-X-X-X-.-.-X-X-X-------------------------------
------------,-X-.-.-.-,-,-,-E-.-E-.-.-.-.-.-.-.-.-.-E-E-.-X---,-X-.-.-.-.-.-.-A-.-.-.-.-E-,-.-.-.-.-.-.-.-.-.-,-.-.-.-.-.-A-.-.-.-.-.-.-X-----,-X-.-.-.-.-.-.-X-------------------------------
------------,-X-.-.-.-,-,-,-.-.-.-.-.-.-.-.-.-.-.-.-.-.-.-X---,-X-X-X-E-.-E-X-X-X-.-E-.-X-X-X-.-.-.-.-.-.-.-X-X-X-E-.-E-X-X-X-.-E-.-X-X-X-----,-X-.-.-.-.-.-.-X-------------------------------
,-,-,-,-,-,-,-X-,-,-,-X-X-X-+X+X+X+X+X+X+X+X+X+X+X+X+X+X+XXX--,-,-,-X-,-,-,-X-,-X-,-,-,-X-,-X-.-.-.-.-.-.-.-X-,-X-,-,-,-X-,-X-,-,-,-X-,-,-----,-X-.-.-.-.-.-.-X-------------------------------
,-X-X-X-X-X-X-X-.-.-.-X-X-XX+X+X+XXXXXXX+X+X+XXXXXXX+X+X+XXX--,-X-X-X-.-.-.-X-X-X-.-.-.-X-X-X-.-.-.-.-.-.-.-X-X-X-.-.-.-X-X-X-.-.-.-X-X-X-----,-X-.-.-.-.-.-.-X-------------------------------
X-.-.-.-X-X-H-.-.-.-.-.-.-.-.-.-E-X-,-X-.-.-E-X-,-X-.-.-.-X-,-,-X-.-.-.-.-.-.-.-.-.-.-.-.-.-.-.-.-.-.-.-.-.-.-.-.-.-.-.-.-.-.-.-.-.-.-.-X-,-,-,-X-.-.-.-.-.-.-X-------------------------------
X-E-.-.-XZX-.-.-.-.-.-.-.-.-.-.-.-X-X-X-.-.-.-X-X-X8.-.-.-X-X-X-X-.-.-.-.-.-.-.-.-.-.-.-.-.-.-.-.-.-.-.-.-.-.-.-.-.-.-.-.-.-.-.-.-.-.-.-X-X-X-X-X-.-.-.-.-.-B-X-------------------------------
>-.-.-.-+Z.-.-.-.-.-.-.-.-.-.-.-.-.-.-.-.-.-.-.-.-.8.-.-.-.-.-.-.-.-.-.-.-.-.-.-.-.-.-.-.-.-.-.-.-.-.-.-.-.-.-.-.-.-.-.-.-.-.-.-.-.-.-.-+-+-.-.-.-.-.-.-.-B-B-X-------------------------------
>-E-.-.-.-.-<-.-.-.-.-.-.-.-.-.-.-.-A-.-.-.-.-.-A-.8.-E-.-.-.-.-E-.-.-.-.-.-.-.-.-.-.-.-.-.-.-.-.-.-E-.-.-.-.-.-.-.-.-.-.-.-.-.-.-.-.-E-+-+-.-.-.-.-.-.-.-.-.-X-------------------------------
>-.-.-.-+Z.-.-.-.-.-.-.-.-.-.-.-,-,-,-,-.-.-.-.-.-.8.-.-.-.-.-.-.-.-.-.-.-.-.-.-.-.-.-.-.-.-.-.-.-.-.-.-.-.-.-.-.-.-.-.-.-.-.-.-.-.-.-.-+-+-.-.-.-.-.-.-.-.-.-X-------------------------------
X-E-.-.-XZX-.-.-.-.-.-.-.-.-.-.-,-X-X-X-.-.-.-X-X-X8.-.-.-X-X-X-X-.-.-.-.-.-.-.-.-.-.-.-.-.-.-.-.-.-.-.-.-.-.-.-.-.-.-.-.-.-.-.-.-.-.-.-X-X-X-X-X-.-.-.-.-B-.-X-------------------------------
X-.-.-.-X-X-H-.-.-.-.-.-,-,-,-,-E-X-,-X-,-,-E-X-,-X-,-,-,-X---,-X-.-.-.-.-.-.-.-.-.-.-.-.-.-.-.-.-.-.-.-.-.-.-.-.-.-.-.-.-.-.-.-.-.-.-.-X-----,-X-.-.-<-.-.-,-X-------------------------------
,-X-X-X-X-X-X-X-,-,-,-X-X-XX+X+X+XXXXXXX+X+X+XXXXXXX+X+X+XXX--,-X-X-X-.-.-.-X-X-X-.-.-.-X-X-X-.-.-.-.-.-.-.-X-X-X-.-.-.-X-X-X-.-.-.-X-X-X-------,-X-X-.-.-X-X---------------------------------
------------,-X-.-.-.-X-X-X-+X+X+X+X+X+X+X+X+X+X+X+X+X+X+XXX------,-X-,-A-,-X-,-X-.-.-.-X-,-X-.-.-.-<-.-.-.-X-,-X-.-.-.-X-,-X-.-A-.-X---,-,-,-,-,-,-X-A-.-X-,-,-,-,-,-------------------------
------------,-X-.-.-.-,-,-,-E-.-E-.-.-.-.-.-.-.-.-.-.-.-.-X-------,-X-,-,-,-X-,-X-X-X-X-X-,-X-X-X-.-.-.-X-X-X-,-XW.-.-.-XW,-X-X-X-X-X---,-X-X-X-X-X5X5,5,5X5X-X-X-X-X-------------------------
------------,-X-.-.-.-,-,-,-.-.-.-.-.-.-.-.-.-.-.-.-E-E-.-X-------,-X-E-.-E-X-----------------,-X-.-H-.-X-----,-X-E-.-E-X-----------,-,-,-X-.-.-.-X5.5.5.5X5X-.-.-.-X-,-,---------------------
------------,-X-.-.-.-,-,-,-.-.-.-.-.-.-E-.-E-.-.-.-.-.-.-X-------,-X-.-.-.-X-----------------,-X-X-X-X-X-----,-X-E-E-E-X-----------,-X-X-X-.-.-.-.5.5.5.5.5.-.-.-.-X-X-X---------------------
------------,-X-X-X-X-X-X-X-X-X-.-.-.-.-.-.-.-.-.-.-.-X-X-X-------,-X-E-.-E-X---------------------------------,-X-.-.-.-X-----------,-X-.-.-.-.-.-X5.5.5.5X5X-.-.-.-.-,-X---------------------
----------------------------,-X-.-.-.-.-.-.-.-.-.-B-.-X-----------,-X-X-X-X-X---------------------------------,-X-X-X-X-X-----------,-X-H-.-.-.-.-X5X5.5X5X5X-.-.-.-.-H-X---------------------
----------------------------,-X-X-X-.-.-.-.-.-.-.-X-X-X-----------------------------------------------------------------------------,-X-.-.-.-.-.-.-.-.-.-.-.-.-.-.-.-,-X---------------------
--------------------------------,-X-.-.-.-A-.-.-.-X---------------------------------------------------------------------------------,-X-X-X-.-.-.-.-.-.-.-.-.-.-.-.-X-X-X---------------------
--------------------------------,-X-X-X-X:X:X:X-X-X-------------------------------------------------------------------------------------,-X-.-.-.-.-.-.-.-.-.-.-.-.-X-------------------------
----------------------------------------------------------------------------------------------------------------------------------------,-X-X-X-.-.-.-.-.-.-.-.-X-X-X-------------------------
--------------------------------------------------------------------------------------------------------------------------------------------,-X-.-.-.-.-.-.-.-.-X-----------------------------
--------------------------------------------------------------------------------------------------------------------------------------------,-X-.-.-.-.-.-.-.-X-X-----------------------------
--------------------------------------------------------------------------------------------------------------------------------------------,-X-.-.-.-.-.-.-.-X-------------------------------
--------------------------------------------------------------------------------------------------------------------------------------------,-X-.-.-.-.-.-.-.-X-------------------------------
--------------------------------------------------------------------------------------------------------------------------------------------,-X-E-.-.-E-.-.-.-X-------------------------------
--------------------------------------------------------------------------------------------------------------------------------------------,-X-.-,-,-,-,-.-.-X-------------------------------
----------------------------------------------------------------------------------------------------------------------------------------------X-.-,-.-.-,-.-.-X-------------------------------
----------------------------------------------------------------------------------------------------------------------------------------------,-X-,-.-K-,-.-.-X-------------------------------
------------------------------------------------------------------------------------------------------------------------------------------------X-,-H-A-,-H-X-,-------------------------------
------------------------------------------------------------------------------------------------------------------------------------------------,-X-.-.-,-,-X---------------------------------
--------------------------------------------------------------------------------------------------------------------------------------------------,-X-X-X-X-----------------------------------
