------------------------------------------------------------,-X-X-X-X-X-X-X-X-X-X-X-X-X-,-,-,-,-X-X-X-X-X-X-X-X-X-X-X-X---------------------------------------------------------------
------------------------------------------------------------,-X-.-.-.-.-.-.-.-.-.-.-.-X-X.X.X.,-X-.-.-.-.-.-.-.-.-.-.-X---------------------------------------------------------------
------------------------------------------------------------,-X-.-.-.-.-.-.-.-.-.-.-,-X-X-H-X-,-X-X-,-.-.-.-.-.-.-.-.-X---------------------------------------------------------------
------------------------------------------------------------,-X-.-.-.-.-.-.-.-.-,-X-X-X-X3.3X3X-,-,-X-,-.-.-.-.-.-.-.-X---------------------------------------------------------------
------------------------------------------------------------,-X-.-.-.-.-.-.-.-.-,-,-X-,-.-.-,-,-X-X-.-,-.-.-.-.-.-.-.-X---------------------------------------------------------------
------------------------------------------------------------,-X-.-.-.-.-.-.-.-.-X-,-.-,-,-A-,-.-,-,-,-X-.-.-.-.-.-.-.-X---------------------------------------------------------------
------------------------------------------------------------,-X-X-X-X-X-X-X-X-X-X-X-.-:-.-.-.-.-.-,-X-X-X-X-X-X-X-X-X-X-,-,-,-,-,-,-,-,-,-,-,-,-,-,-,-,-,-,-,-------------------------
--------------------------------------------------------------------------------,-X-.-.-.-.-.-.-.-.-X-X-X-X-X-X-X-X-X-X-X-X-X-X-X-X-X-X-X-X-X-X-X-X-X-X-X-X-X-------------------------
--------------------------------------------------------------------------,-,-,-,-X-E-.-.-.-.-.-E-.-X-X-X-X-X-X-X-X-X-X-X-X-X-X-X-X-X-.-.-.-.-.-.-.-.-.-.-.-X-------------------------
--------------------------------------------------------------------------,-X-X-X-X-.-.-.-.-.-.-.-.-X-XSX-X-----------------------,-X-.-E-.-.-E-.-.-E-.-.-E-X-------------------------
--------------------------------------------------------------------------,-X-E-,-.-.-.-.-.-.-.-.-.-,-.-E-X-----------------------,-X-.-.-.-.-.-.-.-.-.-.-.-X-------------------------
--------------------------------------------------------------------------,-X-.-,-.-.-.-.-.-.-.-.-.-,-.-.-X-----------------------,-X-.-.-.-.-.-.-.-.-.-.-.-X-------------------------
--------------------------------------------------------------------------,-X-.-,-.-.-.-.-.-.-.-.-.-,-.-E-X-----------------------,-X7t7t7t7t6t6t6t5t5t5t4t4X4------------------------
----------------------------------------------------------------,-,-,-,---,-X-E-,-.-.-.-.-.-.-.-.-.-,-,-,-X-----------------------,-X-.-.-.-.-.-.-.-.-.-.-.-X-------------------------
----------------------------------------------------------------,-X-X-X---,-X-X-X-X-.-.-.-.-.-.-.-.-X-X-X-X-----------------------,-X-.-.-.-.-.-.-.-.-.-.-.-X-------------------------
----------------------------------------------------------------,-X-,-X---,-X-H-.-A-.-.-.-<-.-.-.-A-+-A-A-X-----------------------,-X-.-.-.-.-.-.-.-.-.-.-.-X-------------------------
----------------------------------------------------------------,-X-.-X---,-X-X-X-X-.-.-.-.-.-.-.-.-X-X-X-X-----------------------,-X-X-X-X-X-X-X-X-X-X-X-X-X-------------------------
--------------------------------------------------------,-,-,-,-,-X-A-X-,-,-,-,-,-X-.-.-.-W-.-.-.-.-X-,-,-,-,-,-,-,-,-,-,-,-----------------------------------------------------------
--------------------------------------------------------,-X-X-X-X-X-,-X-X-X-X-X-X-X-X-X1.1.1.1X1X-X-X-X-X-X-X-X-X-X-X-X-X-X-----------------------------------------------------------
--------------------------------------------------------,-X-B-.-.-.-A-.-.-.-.-.-.-.-,-.1.1.1.1,1.-.-.-.-.-.-.-.-A-.-.-.-.-X-----------------------------------------------------------
--------------------------------------------------------,-X-.-.-.-.-.-.-.-.-.-.-.-E-,-.1.1H1.1,1.-.-E-.-.-.-.-.-.-.-.-.-.-X-----------------------------------------------------------
--------------------------------------------------------,-X-.-.-.-.-.-.-.-.-.-.-.-.-,-.1.1.1.1,1.-:-.-.-.-.-,-,-,-,-,-,-,-X-----------------------------------------------------------
--------------------------------------------------------,-X-,-,-,-,-,-.-.-.-.-X-X-X-X-X1X1X1X1X1X-X-X-X-.-.-,-.-.-.-.-.-.-X-----------------------------------------------------------
--------------------------------------------------------,-X-.-.-.-.-,-.-.-.-.-X-------,-X-X-X-------,-X-.-.-,-.-.-.-.-.-.-X-----------------------------------------------------------
--------------------------------------------------------,-X-.-E-.-.-E-.-.-.-B-X-------,-X-<-X-------,-X-.-.-,-.-.-E-.-.-E-X-----------------------------------------------------------
--------------------------------------------------------,-X-.-.-.-.-,-.-.-,-X---,-,-,-,-X-.-X-,-,-,---,-X-.-,-.-.-.-.-.-.-X-----------------------------------------------------------
--------------------------------------------------------,-X-.-.-.-X-X-X-X-X---,-,-X-X-X-.-A-.-X-X-X-,---,-X-X-X-X-X-.-.-.-X-----------------------------------------------------------
--------------------------------------------------------,-X-.-.-.-X-----------,-X-,-,-,-,-E-,-,-,-,-X-,---------,-X-.-.-.-X-----------------------------------------------------------
--------------------------------------------------------,-X-.-E-.-X---------,-,-X-,-.-,-.-.-.-,-,-.-X-,---------,-X-.-E-.-X-----------------------------------------------------------
--------------------------------------------------------,-X-.-.-.-X---------,-X-.-A-E-,-.-A-.-,-E-.-A-X---------,-X-.-.-.-X-----------------------------------------------------------
--------------------------------------------------------,-X-.-.-.-X-,-------,-X-.-.-.-,-.-.-.-,-.-.-.-X---------,-X-.-.-.-X-----------,-,-,-,-,-,-------------------------------------
--------------------------------------------------------,-X-.-.-.-.-X-,-,-,-,-X-.-.-.-,-.-.-.-,-.-.-.-X-,-,-,-,-,-X-.-.-.-X-----------,-X-X-X-X-X-------------------------------------
--------------------------------------------------------,-X-.-.-.-.-X-X-X-X-X-X-.-.-.-,-.-.-.-,-.-.-.-X-X-X-X-X-X-X-.-.-.-X-----------,-X-.-.-.-X-------------------------------------
----------------------------------------------------------,-X-.-.-.-.-.-.-.-.-.-.-.-.-,-.-.-.-,-.-.-.-.-.-.-.-.-.-.-.-.-.-X-----------,-X-.-.-.-X-------------------------------------
------------------------------------------------------------,-X-.-.-.-.-.-.-.-.-.-.-.-,-......,..-.-.-.-.-.-.-.-.-.-.-.-.-X-----------,-X-.-.-.-X-------------------------------------
--------------------------------------------------------------,-X-.-.-.-.-.-.-.-.-.-.-,-,...,.,..-.-.-.-.-.-.-.-.-.-.-.-.-X-----------,-X-.-.-.-X-------------------------------------
----------------------------------------------------------------,-X-X-X-X-X-X-X-.-.-.-.-,-.-,-.-.-.-.-X-X-X-X-X-X-X-.-.-.-X-----------,-X-.-.-.-X-------------------------------------
----------------------------------------------------------------------------,-X-.-.-.-.-,-.-,-.-.-.-.-X---------,-X-.-.-.-X-----------,-X-.-.-.-X-------------------------------------
----------------------------------------------------------------------------,-X-.-.-.-.-,-.-,-.-.-.-.-X---------,-X-.-E-.-X-----------,-X-.-.-.-X-------------------------------------
----------------------------------------------------------------------------,-X-.-.-,-,-,-.-,-,-,-.-.-X-----,-,-,-X-,-,-,-X-,-,-------,-X-.-.-.-X-------------------------------------
----------------------------------------------------------------------------,-X-,-,-,-.-.-.-.-.-,-,-,-X-----,-X-X-X-.-.-.-X-X-X-,-----,-X-.-.-.-X-------------------------------------
------------------------------------------------------------------------------,-X-.-.-,-,-,-,-.-.-,-X-------,-X-t=.-.-.-.-.-t=X-X-----,-X-.-.-.-X-------------------------------------
--------------------------------------------------------------------------------,-X-X-X-,-,-,-X-X-X---------,-X-.-.-.-E-E-.-,-.-X-----,-X-.-.-.-X-------------------------------------
------------------------------------------------------------------------------------,-X-.-.-.-X---------,-,-,-X-.-.-.-t=.-.-,-.-X-----,-X-.-.-.-X-------------------------------------
--------------------------------------------------------,-,-,-,-,-,-,-,-,-,-,-,-,-,-,-X-+-+-+-X---------,-X-,-X-.-.-.-.-.-.-,-.-X-----,-X-.-.-.-X-------------------------------------
--------------------------------------------------------,-X-X-X-X-X-X-X-X-X-X-X-X-X-X-X-+-+-+-X-------,-,-X-X-X-t=.-.-.-.-.-t=X-X-----,-X-.-.-.-X-------------------------------------
--------------------------------------------------------,-X-.-.-.-.-.-,-,-,-,-,-,-.-,-.-.-.-.-X-------,-X-.-X-X-X-X-.-.-.-X-X-X-------,-X-.-.-.-X---------,-,-,-,-,-,-----------------
--------------------------------------------------------,-X-.-.-.-.-.-,-,-,-,-,-,-.-,-.-.-.-.-X-------,-X-.-X-X-X-X-+-+-+-X-X-X-------,-X-.-A-.-X-----,-,-,->->->->->-,-,-------------
--------------------------------------------------------,-X-.-H-.-.-.-,-,-,-,-,-,-.-,-.-.-:-E-X-------,-X-.-X-X-.-.-.-A-.-.-.-X-------,-X-.-E-.-X-,-,-,-X-X-.-,-A-.-,-X-X-------------
--------------------------------------------------------,-X-.-.-.-.-.-,-,-,-,-,-,-.-,-.-.-.-,-X---,-,-,-X-.-X-X-.-.-.-.-.-.-.-X-------,-X-.-.-.-X-,-X-X-X-.-.-,-.-.-,-.-X-------------
------------------------------------------------,-,-,-,-,-X-X-X-.-.-.-X-X-X-X-X-X-X-X-X-X-X-X---,-,-X-,-X-.-X-X-.-.-.-E-.-.-.-X-------,-X-.-<-,-X-X-.-,-.-.-.-,-.-.-,-B-X-------------
------------------------------------------------,-X-X-X-X-X-X-X-+-+-+-X-X-X-X-X-X-X-------------,-X-,-X-X-,-X-X-B-B-.-.-.-.-,-X-------,-X-.-.-,-X-,-,-X-X-.-.-,-.-.-,-B-,-X-----------
------------------------------------------------,-X-.-.-.-.-.-,-.-.-,-.-.-.-.-.-.-X-,-,-,-,-,-,-,-X-,-.-.-.-,-X-X-,-,-,-,-,-X-,-,-----,-X-.-.-.-X-X-X-,-X-.-.-,-E-.-,-,-.-X-----------
------------------------------------------------,-X-.-t4.-.-,-,-.-.-,-,-.-.-.-.-t7X-,-X-X-X-X-X-X-.-,-.-.-E-,-X-X-X-X-,-,-X-X-X-X-----,-X-.-.-.-X-----,-X-X-,-,-,-,-,-B-,-X-----------
------------------------------------------------,-X-.-.-.-.-,-.-.-.-.-,-.-.-.-.-.-X-,-X-A-.-,-X-.-.-,-.-.-.-X-,-X-.-.-.-.-.-.-.-X---,-,-X-.-.-.-X-,-------,-X-.-.-.-.-X-X-------------
------------------------------------------------,-X-.-.-.-.-,-.-.-.-.-,-.-.-.-.-.-X-,-X-.-.-,-.-.-.-,-,-,-.-,-X-X-.-.-.-.-.-E-.-X-,-,-X-X-.-.-.-X-X-,-----,-X-.-.-.-.-X---------------
------------------------------------------------,-X-.-,-,-,-,-.-.-.-.-,-,-,-,-.-.-X-,-X-.-.-,-.-.-.-.-.-,-,-X-,-X-,-,-,-,-.-.-,-X-,-X-.-.-.-.-.-.-.-X-,-,-,-X-.-.-.-.-X---------------
------------------------------------------------,-X-,-,-.-.-.-.-.-.-.-.-.-.-,-,-,-X-X-X-.-.-,-,-,-,-,-,-,-.-X-X-X2,2,2,2,2.-.-,-X8X8.8.-.-.-.-.-.-.-,8X-X-X-X-.-.-.-.-X-,-,-----------
------------------------------------------------,-X-<-.-.-.-.-.-.-A-.-.-.-.-.-.-.-.-L-.-.-.-,-,-,-.-.-.-.-.-.-.-.2.2.2.2,2.-.-,-.8.8.8.8.8.8.8.8.8.8,8+-.-.-.-.-.-,-,-X-X-X-----------
------------------------------------------------,-X-<-<-.-.-.-.-.-t9.-A-.-.-.-.-.-.-L-.-.-.-A-,-,-.-.-.-E-.-.-.-.2.2A2.2,2.-.-E-.8.8.8.8.8.8.8.8.8.8,8+-.-H-.-.-.-,-.-.-.-X-,---------
------------------------------------------------,-X-,-,-.-.-.-.-.-.-.-.-.-.-,-,-,-,-L-.-.-.-,-,-,-,-,-,-,-,-,-,-,2,2,2,2,2.-.-,-.8.8.8.8.8.8.8.8.8.8,8+-.-.-.-.-.-,-.-.-.-,-X-,-------
------------------------------------------------,-X-<-,-,-,-,-.-.-A-.-,-,-,-,-.-.-X-X-X-.-.-,-,-,-,-.-.-.-.-,-X-X2.2.2.2,2.-.-,-X8X8.8.8.8.8.8.8.8.8,8X-X-X-X-.-,-,-.-.-,-,-X-,-,-----
------------------------------------------------,-X-.-.-.-.-,-.-.-.-.-,-.-.-.-.-.-X-,-X-.-.-.-,-,-,-.-.-.-.-X-,-X-,-,-,-,-.-.-.-X-,-X-.-.-.-.-.-.-,-X-----,-X-,-,-.-A-W-X-X-.-X-X-----
------------------------------------------------,-X-.-.-.-.-,-.-.-.-.-,-.-.-.-.-.-X-,-X-.-.-.-,-,-.-.-.-.-.-X-,-X-.-.-.-.-.-E-.-X---,-X-X-.-.-.-X-X-------,-X-,-.-.-,-,-X-,-X-.-,-X---
------------------------------------------------,-X-.-.-.-.-,-,-.-.-,-,-.-.-.-.-.-X-,-X-A-.-.-,-,-.-.-.-.-.-,-X-X-.-.-.-.-.-.-.-X-----,-X-.-.-.-X---------,-X-,-.-,-,-.-.-X-.-.-.-X---
------------------------------------------------,-X-.-.-.-.-.-,-.-.-,-.-.-.-.-.-.-X-,-X-X-X-X-X-X-X-.-.-E-.-X-,-X-X-X-X-X-X-X-X-X-----,-X-.-.-.-X---------,-X-X-,-,-.-.-.-.-.-.-.-X---
------------------------------------------------,-X-.-t5.-.-,-,-.-.-,-,-.-.-.-.-t6X-------------,-X-.-.-.-.-X---,-,-,-,-,-,-----------,-X-.-.-.-X-------------,-X-X-X-X-X-X-.-.-.-,-X-
------------------------------------------------,-X-X-X-X-X-X-X-.-.-.-X-X-X-X-X-X-X---------------,-X-.-.-.-X-,-,-X-X-,-X-X-,-,-,-----,-X-.-E-.-X-----------------------,-,-X-X-.-.-X-
--------------------------------------------,-,-,-,-,-,-,-,-,-X-+-+-+-X-,-,-,-,-,-,-,-,-,---------,-X-.-.-,-X-,-.-X-,-X^,-.-X-X-X-----,-X-.-.-.-X---------------------------,-,-X-.-X-
--------------,-,-,-,-,-,-,-,-,-,-,-,-,-,-,-,-X-X-X-X-X-X-X-X-X-.-.-.-X-X-X-X-X-X-X-X-X-X---------,-X-.-,-,-X-,-X-.-K-,-+^E-.-.-X-,-,-,-X-.-.-.-X-------------------------------X-X-,-
--------------,-X-X-X-X-X-X-X-X-X-X-X-X-X-X-X-X-.-.-.-.-.-.-.-.-.-.-.-.-.-.-.-.-.-.-.-.-X---,-,-,-,-X-X-,-.-,-X-X-X-,-+^.>.-.-.-X-X-X-X-.-.-.-.-X-------------------------------,-X---
--------------,-X-X-X-X-X-X-X-X-X-X-X-X-X-X-X-X-.-.-.-.-.-E-.-.-.-.-.-.-.-.-.-.-E-.-.-A-X---,-X-X-X-X-X-X-,-,-.-,-X-X^+^.-:-.-.-.-.-.-.-.-.-.-,-X-------------------------------------
--------------,-X-X-----------,-,-,-,-,-,-,-,-X-.-.-.-.-.-.-.-.-.-.-.-.-.-.-.-.-.-.-.-.-X---,-X-H-.-H-X-,-X-.-.-,-.-.-.-.-.-.-.-.-.-.-.-.-.-.-X---------------------------------------
--------------,-X-X-----------,-X-X-X-X-X-X-X-X-.-.-.-,-,-,-,-,-,-,-,-,-,-,-,-,-,-,-,-,-X-,-,-X-.-.-.-X-,-,-X-X-,-.-.-.-.-.-.-.-.-.-.-.-.-.-,-X---------------------------------------
--------------,-X-X-----------,-X-A-A-.-A-.-X-X-.-.-.-,-,-,-,-.-.-.-.-.-.-.-.-.-.-H-.-H-X-,-X-.-.-.-.-,-X-,---,-X-,-,-,-.-.-,-,-X-X-X-X-X-X-X-----------------------------------------
,-,-,-,-,-,-,-,-X-X-,-,-------,-X-.-.-.-.-.-X-X-.-.-.-,-,-.-,-.-.-.-.-.-.-.-.-.-.-.-.-.-X-XS,-.-.-.-.-,-.-X-----,-X-.-,-,-,-,-.-X-,---------------------------------------------------
X-X-X-X-X-X-X-X-X-X-X-X-------,-X-.-.-.-.-.-+-.-.-.-.-,-,-.-,-.-.-.-.-.-.-.-.-.-.-.-.-.-.-.-,-.-.-.-.-,-.-X-,-,-,-X-.-.-.-.-.-.-,-X---------------------------------------------------
X-E-E-.-E-E-.-E-.-.-E-X-------,-X-E-.-.-H-.-+-.-A-.-.-,-,-.-,-.-.-.-.-.-.-.-.-.-.-E-.-W-.-.-,-.-.-.-.-,-.-X-X-X-X-X-X-X9t9X9X-X-X-----------------------------------------------------
X-.-.-.-.-.-.-.-.-.-.-X-------,-X-.-.-.-.-.-+-.-.-.-.-,-,-.-,-.-.-.-.-.-.-.-.-.-.-.-.-.-.-.-,-.-.-.-.-,-.-+P+PE-X---,-X-.-X-----------------------------------------------------------
X=t=t=t=t=t=t=t=t=t6t6X6------,-X-.-.-.-.-.-X-X-.-.-.-,-,-,-,-.-.-.-.-.-.-.-.-.-.-.-.-.-X-XS,-.-.-.-.-,-.-+P+PA-X---,-X-X-X-----------------------------------------------------------
X-.-.-.-.-.-.-.-.-.-.-X-------,-X-A-A-.-A-.-X-X-.-.-.-,-,-,-,-,-,-,-,-,-,-,-,-,-,-,-,-,-X-X-,-.-.-.-.-,-.-+P+PE-X---------------------------------------------------------------------
X-X-X-X-X-X-X-X-X-X-X-X-------,-X-+-X-X-X-X-X-X-.-.-.-.-.-.-.-.-.-.-.-.-.-.-.-.-.-H-.-H-X-X-,-,-.-.-,-,-.-+P+PA-X---------------------------------------------------------------------
------------------------------,-X-+-X-------,-X-.-.-.-.-.-.-.-.-.-.-.-.-.-.-.-.-.-.-.-.-X-X-B-,-,-,-,-.-.-+P+PE-X---------------------------------------------------------------------
------------------------------,-X:X:X:------,-X-.-.-.-.-.-.-.-.-.-.-.-.-.-.-.-.-.-.-.-.-X-X-B-.-.-.-.-.-.-+P+P.-X---------------------------------------------------------------------
--------------------------------------------,-X-.-.-.-.-.-.-E-.-.-E-.-.-.-E-.-.-E-.-E-A-X-X-.-.-.-.-.-.-.-+P+PA-X---------------------------------------------------------------------
--------------------------------------------,-X-.-.-.:.:.:.-.-.-.-.-.-.-.-.-.-.-.-.-.-,-X-X-.-.-.-.-.-.-.-XPXPX-X---------------------------------------------------------------------
--------------------------------------------,-X-X-X:,:,:,:X:X-X-.-.-.-X-X-X-X-X-X-X-X-X-,-X-.-.-.-.-.-.-.-X---------------------------------------------------------------------------
------------------------------------------------,-X-.-.-.-X-,-X-+-+-+-X-X-X-X-X-X-X-X---,-X-.-.-E-.-E-.-,-X---------------------------------------------------------------------------
------------------------------------------------,-X-.-.-.-X-,-X-.-.-,-,-,-.-.-.-<-.-X-----,-X-.-.-.-.-,-X-----------------------------------------------------------------------------
------------------------------------------------,-X-.-.-.-X-,-X-.-H-,-,-,-.-.-.-.-.-X-,-,-,-,-X-X<.<X<X-------------------------------------------------------------------------------
------------------------------------------------,-X-.-E-.-X-,-X-,-,-,-,-,-.-.-.-.-.-.-X-X-X---,-X0X0X0--------------------------------------------------------------------------------
----------------------------------------------,-,-X-+[+[+[X[,-X-X-.-X-X-X-X-.-.-.-.-.-.-.-,-X-----------------------------------------------------------------------------------------
----------------------------------------------,-X-X-+[+[+[X[X-X-X-,-X-X-X-X-.-.-.-.-.-.-.-.-X-,-,-,-----------------------------------------------------------------------------------
----------------------------------------------,-X-,-.-.-.-,-X-X-.-.-.-.-.-.-.-.-.-.-.-.-.-,-,-X-X-X-,---------------------------------------------------------------------------------
----------------------------------------------,-X-,-.-.-.-,-X-X-.-.-.-.-.-.-.-.-.-.-.-.-,-,-.-.-.-.-X-,-------------------------------------------------------------------------------
----------------------------------------------,-X-,-.-.-.-,-X-X-.-.-.-.-.-.-.-.-.-.-.-.-,-.-.-.-.-.-B-X-------------------------------------------------------------------------------
----------------------------------------------,-X-X-X->-X-X-X-X-.-.-.-.-.-.-.-.-.-.-.-.-,-.-.-.-.-.-.-X-------------------------------------------------------------------------------
--------------------------------------------------,->-.->---,-X-.-.-.-.-.-.-.-.-.-.-.-.-,-.-.-.-.-.-.-X-,-,---------------------------------------------------------------------------
--------------------------------------------------,-X-.-X---,-X-.-.-.-.-.-.-.-.-.-.-.-.-,-.-.-.-.-.-.-X-X-X---------------------------------------------------------------------------
--------------------------------------------------,-X-.-X---,-X-.-.-.-.-E-.-.-.-.-.-.-.-,-.-A-.-W-.-.-.-K-X---------------------------------------------------------------------------
--------------------------------------------------,-X-.-X---,-X-X-.-.-.-.-.-.-.-.-.-.-.-,-.-.-.-.-.-.-X-X-X---------------------------------------------------------------------------
--------------------------------------------------,-X-X-X-------,-X-X-.-.-.-.-.-.-.-.-.-,-.-.-.-.-.-.-X-------------------------------------------------------------------------------
------------------------------------------------------------------,-X-.-.-.-,-,-.-E-.-.-,-.-.-.-.-.-.-X-------------------------------------------------------------------------------
--------------------------------------------------------------------,-X-.-,-,-,-,-,-.-.-,-,-.-.-.-.-B-X-------------------------------------------------------------------------------
------------------------------------------------------------------,-,-X-,-,-.-.-.-,-,-.-.-,-,-.-.-,-X---------------------------------------------------------------------------------
------------------------------------------------------------------,-.-X-.-.-.-.-.-.-,-,-.-.-,-X-X-X-----------------------------------------------------------------------------------
------------------------------------------------------------------,-X-.-.-.-.-.-.-.-.-,-.-,-X-----------------------------------------------------------------------------------------
--------------------------------------------------------------------,-X-X-.-.-.-.-.-.-,-,-X-------------------------------------------------------------------------------------------
------------------------------------------------------------------------,-X-X-.-.-,-X-X-X---------------------------------------------------------------------------------------------
----------------------------------------------------------------------------,-X-X-X---------------------------------------------------------------------------------------------------
