------------------------------,-X-X-X---------------------------------------------------------------------------------------------------------------------------------------------------------------------------------------------------------
------------------------------,-X-.-X---------------------------------------------------------------------------------------------------------------------------------------------------------------------------------------------------------
----------------------,-,-,-,-,-X_,?X_--------------------------------------------------------------------------------------------------------------------------------------------------------------------------------------------------------
----------------X-X-X-,-X-X-X---X---X---X-X-X-------------------------------------------------------------------------------------------------------------------------------------------------------------------------------------------------
----------------X-<-X-,-X-<-X---X-<-X---X-<-X-------------------------------------------------------------------------------------------------------------------------------------------------------------------------------------------------
----------------X---X-,-X-.-X---X---X---X---X-------------------------------------------------------------------------------------------------------------------------------------------------------------------------------------------------
----------,-,-,-X-A-X-,-X-W-X-,-X-H-X-,-X-A-X-,-,-----------------------------------------------------------------------------------------------------------------,-,-,-,---------------------------------------------------------------------
----------,-X-X-X-.-X-,-X-,-X-,-X-.-X-,-X-.-X-X-X-------------------------------------------------------------------------------------------------------------,-,-,-X-X-X-,-------------------------------------------------------------------
----------,-X-.-.-.-X-X-X-.-X-X-X-.-X-X-X-.-.-.-X-----------------------------------------------------------------------------------------------------------,-,-X-X-.-.-.-X-,-----------------------------------------------------------------
----------,-X-.-.-.-.-.-.-.-.-.-.-.-.-.-.-.-.-.-X-----------------------------------------------------------------------------------------------------------,-X-X-.-.-.-.-.-X-----------------------------------------------------------------
----------,-X-.-.-.-.-.-.-.-.-.-.-.-.-.-.-.-.-,-X-,-,-,-,-----------------------------------,-,-,-,-,-,-,-,-,-,-,-,-,-,-,-,-,---------------------------,-,-,-,-X-.-.-T-.-.-X-,-,-,-----------------------------------------------------------
----X-X-X-X-X-.-.-.-.-.-.-.-.-.-.-.-.-.-.-.-.-,-X-X-X-X-X-,-----------------------------,-,-,-X-X~X~X~X~X~X~X~X~X~X~X~X~X~X~X~,-,-----------------------,-X-X-X-X-.-.-.-.-.-X-X-X-X-----------------------------------------------------------
,-X-------,-.-.-.-.-.-.-.-.-.-.-.-.-.-.-.-.-.-,-.-,-,-.-.-X-,-------------------------,-,-X-X~.~.~.~.~.~.~.~.~.~.~.~.~.~.~.~.~X~X~,-,-------------------,-X-.-.-.-.-.-.-.-.-.-.-.-X-,-,-,-,---------------------------------------------------
X-,-,-,---,-.-.-.-.-.-.-E-H-.-E-H-.-E-.-.-.-.-,-.-,-,-.-,-,-X-------------------------,-X~.~.~.~.~.~.~.~.~.~.~.~.~.~.~.~.~.~.~.~.~X~X~,-----------------,-X-.-.-.-.-.-.-.-.-.-.-.-X-X-X-X-X---------------------------------------------------
X-,-,-,-,-,-.-.-.-.-.-.-.-.-.-.-.-.-.-.-.-.-.-,-.-,-,-,-,---X-----------------------,-,-X~.~.~.~.~.~.~.~.~.~.~.~.~.~.~.~.~.~.~.~.~.~.~X-----------------,-X-.-.-.-.-.-.-.-.-.-.-.-,-.-K-.-X---------------------------------------------------
X-.-.-.-X-X-X-.-.-.-.-.-.-.-.-.-.-.-.-.-.-.-.-,-X-X-X-------X-----------------------,-X~.~.~.~.~.~.~X~X~.~.~.~.~.~X~X~.~.~.~.~.~.~.~.~X~,---------------,-X-.-.-.-.-.-.-.-.-.-.-.-,-.-.-.-X---------------------------------------------------
X-.-.-.-X-,-X-.-.-.-.-.-.-.-.-.-.-.-.-.-.-.-.-.-X---X-------X-----------------,-,-,-,-X~.~.~.~.~.~X~,~X~.~.~.~.~,~X~,~X~.~.~.~.~.~.~.~.~X---------------,-X-.-.-.-.-.-.-.-.-.-.-.-,-.-.-.-X---------------------------------------------------
X-.-.-.-X-,-X-.-.-.-.-.-.-.-.-.-.-.-.-.-.-.-.-.-X---X-------X---------------,-,-X-,-X~.~.~.~.~.~X~,~X-X-,~H~.~A~,~X-X-,~.~.~.~.~.~.~.~.~X~--------------,-X-.-.-.-.-.-.-.-.-.-.-.-t5t5t5t5X5--------------------------------------------------
X-.-.-.-X-,-X-.-.-.-.-.-.-,-,-,-,-,-,-,-,-,-,-.-X---X-------X-----,-,-,-,-,-,-X-.-X-X~.~.~.~.~X~,~X-.-.-,-,~,~,~.-.-.-L-,~X~.~.~.~.~.~.~X~----,-,-,-,-,-,-X-.-.-.-.-.-.-.-.-.-.-.-,-.-.-.-X---------------------------------------------------
X-.-.-.-X-,-X-X-X-,-,-,-X-X-X-.-X-X-X-.-.-.-X-X-X---X-------X-X-X-X-X1X1X1X1X1.-.-X-X1.~.~,~X~,~X-.-H-.-.-X-X~X-.-.-<-.-X-.~X~.~.~.~.~.~X~----,-X-X-X-X-X-X-.-.-.-.-.-.-.-.-.-.-.-,-.-E-.-X---------------------------------------------------
X-.-.-.-X-----,-X-,-,-,-X-X-X-,-X-X-X-.-.-.-X-------X-------------,-.1.1.1.1,1.-.-.-.1.~.~,~X-X-X-.-.-E-.-X-X-X-.-.-.-,-X-X~X~.~.~.~.~,~X~,-,-,-Xb+b.-.-,-.-.-.-.-.-.-.-.-.-.-.-.-,-.-.-.-X---------------------------------------------------
X-.-.-.-X-----,-XS+S+S+SXS.-.-.-.-X-X3,3,3,3X3------X-------------,-.1.1.1.1,1.-E-.-.1.~.~,~.-.-.-.-.-.-.-.-.-.-.-.-,-,-.~.~.~.~.~.~.~,~X-X8X8X8Xb+b.-.-X-X-.-.-.-.-.-.-.-.-.-.-.-,-.-.-.-X---------------------------------------------------
X-.-.-.-X-----,-XS+S+S+SXS.-.-E-.-X-X3-3-3-3X3------X-------------,-.1.1.1.1,1.-.-.-.1.~.~,~.-.-A-.-X-.-.-.-.-.-.-X-X-.~H~.~.~.~.~.~.~,~.8.8.8H8+b+b.-.-X-X-.-.-,-,-,-,-,-,-.-.-.-,-.-.-.-X---------------------------------------------------
X-.-.-.-X-,-,---X-----,-X-.-.-.-.-X-X---,-,-X-,-,---X-------------,-.1.1E1.1,1.-.-.-.1.~.~,~.-.-.-.-X-.-.-.-H-.-.-X-X~.~.~.~.~.~.~.~.~,~.8.8E8,8+b+b.-.-X-X-.-,-,-.-.-.-.-,-,-.-.-,-.-.-.-X---------------------------------------------------
X-.-.-.-X-X-X-X-X-----,-X-H-.-.-.-X-X-,-,-.-X-X-X-X-X-------------,-.1.1.1.1,1.-.-.-.1.~.~,~.-.-H-.-X-.-.-.-.-.-.-X-X-,~A~.~.~.~.~.~.~,~.8.8.8,8+b+b.-.-X-X-,-,-.-.-.-.-.-.-,-,-.-,-.-.-.-X---------------------------------------------------
X-.-.-.-.-.-,---------,-X-X-X-.-X-X-X-.-.-.-.-.-,-----------------,-.1.1.1.1,1.-E-.-.1.~.~,~.-.-.-.-.-.-.-.-.-.-.-.-.-,-,~.~.~.~.~.~.~,~.8.8E8,8+b+b.-.-X-X-X-.-.-.-.-.-.-.-.-,-X-X-.-.-.-X---------------------------------------------------
X-.-.-.-.-.-,-------------,-.-H-,-.-.-.-.-.-.-.-,-----------,-,-,-,-.1.1.1:1,1.-.-.-.1.~.~,~X-X-X-.-.-E-.-.-.-.-.-E-.-.-X-X~X~.~.~.~.~,~.8.8.8H8+b+b.-.-X-,-X-.-.-.-.-.-.-.-.-.-X-X-.-.-.-X---------------------------------------------------
X-.-.-.-.-.-,-------------,-,-,-,-.-.-.-.-.-.-.-,-----------X-X-.-X-X1X1X1X1X1.-.-X-X1.~.~.~X~,~X-.-.-.-,-X-X-X-.-.-H-,-X-.~X~.~.~.~.~,~X-X8X8X8Xb+b.-.-X-X-X-.-E-.-.-E-.-.-E-.-X-X-.-.-.-X---------------------------------------------------
X-.-.-.-.-.-,-------------,-.-.-.-.-.-.-.-.-.-.-,-----------X-X1X1X1--------,-X-,-X-X~.~.~.~.~X~,~X-.-,-,-.~.~,~,-.-,-X-.~X~.~.~.~.~.~.~X~----,-Xb+b.-.-.-.-,-.-.-.-.-.-.-.-.-.-X-X-.-.-X-X---------------------------------------------------
X-.-.-.-.-.-,-------------,-.-.-.-.-.-.-.-.-.-.-,-----------X-----------------,-X-,-X~.~.~.~.~.~X~,~X-X-.~A~.~H~,~X-X-.~X~.~.~.~.~.~.~.~X~----,-X-X-X-X-X-X-X-.-.-.-.-.-.-.-.-,-X-X-.-.-X-,---------------------------------------------------
X-.-.-.-.-.-,-------------,-.-.-.-.-.-.-.-.-.-.-,-----------X---------------------,-X~.~.~.~.~.~.~X~.~X~.~.~.~.~.~X~.~X~.~.~.~.~.~.~.~.~X~------------------,-X-.-E-.-.-.-E-,-X-,-X-.-.-X-X---------------------------------------------------
X-.-.-.-.-.-,-------------,-.-.-.-.-.-.-.-.-.-.-,-----------X---------------------,-X~.~.~.~.~.~.~.~X~X~.~.~.~.~.~X~X~.~.~.~.~.~.~.~X~X~X~--------------------,-X-.-.-.-.-,-X-,-X-.-.-.-.-X---------------------------------------------------
X-.-.-.-.-.-,-------------,-.-.-.-.-.-.-.-.-.-.-,-----------X---------------------,-X~.~.~.~.~.~.~.~.~.~.~.~.~.~.~.~.~.~.~.~.~.~.~.~X~,-,-,-,-,-,-,-,-,-,-,-,-,-,-X-X-,-X-X-,-X-.-.-.-.-.-X---------------------------------------------------
X-.-.-.-.-X-X-------------,-.-.-.-.-.-.-.-.-.-X-X-X---------X---------------------,-X~.~.~.~.~.~.~.~.~.~.~.~.~.~.~.~.~.~.~.~.~.~.~.~X~X-X-X-X-X-X-X-X-X-X-X-X-X-X-X-X-.-X-X-X-.-.-.-.-.-.-X---------------------------------------------------
X-.-.-.-A-X-X-------------,-.-.-.-.-.-.-.-.-.-X-,-X-A-------X---------------------,-X~.~.~.~.~.~.~.~.~.~.~.~.~.~.~.~.~.~.~.~.~.~.~.~X~X-.-.-.-.-.-.-.-.-.-X-X-.-.-.-.-.-.-.-.-.-.-.-.-.-.-X---------------------------------------------------
X-.-.-.-.-X-X-------------,-.-.-.-.-.-.-.-.-.-X-X-X---------X---------------------,-X~.~.~.~X~X~X~X~X~X~X~X~X~X~X~X~X~X~X~X~X~.~.~.~X~X-.-.-.-.-.-.-.-.-.-X-X-.-.-.-.-.-.-.-.-.-.-.-.-.-.-X---------------------------------------------------
X-.-.-.-.-.-,-------------,-.-.-.-.-.-.-.-.-.-.-,-----------X---------------------,-X~.~.~.~X~X-X-X-X-X-X-X-X-X2X2X2X2X2X2X2X~.~.~,~X~X-.-.-.-.-.-.-.-.-.-X-X-.-.-.-.-.-.-.-.-.-.-.-.-.-.-X---------------------------------------------------
X-.-.-.-.-.-,-------------,-,-,-.-.-.-.-.-.-.-.-,-----------X---------------------,-X~.~.~.~X~X-A-.-A-.-.-.-,-.2.2.2.2.2.2X2X~.~.~,~X-X-.-.-.-.-E-.-.-.-.-.-.-.-.-.-.-.-.-.-.-.-.-.-.-.-.-X---------------------------------------------------
X-.-.-.-.-.-,-----------------,-.-.-.-.-.-.-.-.-,-----------X---------------------,-X~.~.~.~X~X-.-.-.-.-.-.-,-.2.2.2.2.2.2X2X~.~.~,~,-.-.-.-.-.-.-.-.-.-.-X-X-.-.-.-.-.-.-.-.-.-.-.-.-.-.-X---------------------------------------------------
X-.-.-.-.-.-,-------X-X-X-X-X-,-X-X-X-X-X-.-.-.-,-----------X---------------------,-X~.~.~.~X~X-.-.-.-.-.-.-,-.2.2.2.2.2.2X2X~.~.~,~X-X-.-.-.-.-.-.-.-.-.-X-X-.-.-.-.-.-.-.-.-.-.-.-.-.-.-X---------------------------------------------------
X-.-.-.-.-.-,-------X-X-X-X-X---X-X-X-X-X-.-.-.-,-----------X---------------------,-X~.~.~.~X~X-.-.-.-.-.-.-,-.2.2.2.2.2.2X2X~.~.~.~X~X-A-.-.-.-.-.-.-.-.-X-X-.-.-.-.-.-.-.-.-.-.-.-.-.-.-X---------------------------------------------------
X-.-.-.-.-.-,-------X---------------,-X-X-.-.-.-,-----------X---------------------,-X~.~.~.~X~X-.-.-E-.-.-.-,-.2.2.2.2.2.2X2X~.~.~.~X~X-X-X-X-X-X-.-X-X-X-X-X-X-X-X-X-X-X-X-X-X-X-.-X-X-X-X---------------------------------------------------
X-.-.-.-.-.-,-----------------------,-.-,-.-.-.-,-----------X---------------------,-X~.~.~.~X~X-.-.-.-.-.-.-,-.2.2W2.2.2.2X2X~.~.~.~X~X-X-X-X-X-X-,-X-X-X-X-X-X-X-X-X-X-X-X-X-X-X-.-X-X-X-X---------------------------------------------------
X-.-.-.-.-.-,-------X---E-----------E-X-X-.-.-.-,-----------X---------------------,-X~.~.~.~X~X-.-.-.-.-.-.-,-.2.2.2.2.2.2X2X~.~.~.~X~X-.-.-.-.-.-.-.-.-.-.-.-.-.-.-.-,-X-X-.-.-.-.-.-.-.-X---------------------------------------------------
X-.-.-.-.-.-,-------X-----------------X-X-.-.-.-,-----------X---------------------,-X~.~.~.~X~X-.-.-.-.-.-.-,-.2.2.2.2.2.2X2X~.~.~.~X~X-.-.-.-.-.-.-.-.-.-.-.-.-.-.-.-,-X-X-.-.-.-.-.-.-.-X---------------------------------------------------
X-.-.-.-.-.-,-------X-----------------X-X-.-.-.-,---------X---------------------,-,-X~.~.~.~X~X-.-.-.-.-.-.-,-.2.2.2.2.2.2X2X~.~.~.~X~X-.-.-.-.-.-.-.-.-.-.-.-.-.-.-.-,-.-.-.-.-.-.-.-.-.-X---------------------------------------------------
,-X-.-.-.-,-,-,-,-,-X-,-,-,-,-,-,-,-,-X-X-,-,-,-,---------X-------------------,-,-X~.~.~.~.~X~X-.-.-.-.-.-.-,-.2.2.2.2.2.2X2X~.~.~.~,~,-.-.-.-.-.-.-.-.-.-.-.-.-.-.-.-,-X-X-.-.-.-.-.-.-.-X---------------------------------------------------
--,-X-X-X-X-X-.-.-.-X-X-X-X/./././X/X-X-X-.-.-.-X-X-X---X-------------------,-,-X~.~.~.~.~,~X~X-.-.-.-.-.-.-,2.2.2.2.2.2.2X2X~.~.~.~X~X-.-.-.-.-.-.-.-.-.-.-.-.-.-.-.-,-X-X-.-.-.-.-.-.-X-X---------------------------------------------------
----,-,-X-,-X-.-.-.-.-X-,-././././,/X-.-.-.-.-.-X---X-X-------------------,-,-X~.~.~.~.~,~X~,-X-.-.-.-.-.-.-,-.-.-.-.-.-.-X-X~.~.~.~X~X-.-.-.-.-.-.-.-.-.-.-.-.-.-.-.-,-X-X-.-.-.-.-.-.-X-X-,-,-,-,-,-,-,-,-,-----,-,-,-,-,-,-,-,-,-,---------
--------,-X-X-.-.-.-.-X-X-././././,/X-X-.-.-.-.-X-----------------------,-,-X~.~.~.~.~,~X~--,-X-H-.-.-.-.-.-,-.-.-.-.-.-.-X-X~.~.~.~X~X-,-,-,-,-,-,-,-,-,-,-,-,-,-,-,-,-X-X-.-.-:-.-.-.-,-X-X-X-X-X-X-X-X-X-X-----,-X-X-X-X-X-X-X-X->-X-X-X-X-
--------,-X-.-.-.-.-.-X-,-././././,/X-.-.-.-.-.-X---------------------,-,-X~.~.~.~.~,~X~----,-X-X-.-X-X-,-X-X-X-X-,-,-X-X-X-X~.~.~.~X~X-X-,-X-X-X-X-X-X-X-X-X-X-X-X-X-X-X-X-.-.-.-.-.-.-,-,-.-.-.-.-.-.-.-.-X-,---,-X-.-.-.-.-.-.-.->-------X-
--------,-X-.-.-.-.-.-X-X-,/,/,/,/,/X-X-.-.-.-.-X-------------------,-,-X~.~.~.~.~,~X~--------,-X2X2X2X2.2X2X~X~X-,-,-X-X~X~X~.~.~.~X~X~X-,-X-X~X~X~X~X~X~X~X-X-X-X-X-,-,-X-.-.-.-.-.-.-,-,-.-.-.-.-.-.-.-.-X[X=X-X-X-.-.-.-.-.-.-X->-X-X-X-X-
--------,-X-.-.-.-.-.-.-X-X-.-.-.-X-X-.-.-.-.-.-X-----------------,-,-X~.~.~.~.~,~X~------,-,-,-,-,-,-X2.2X2X~.~.~.~.~.~.~.~.~.~.~.~.~.~.~.~.~.~.~.~.~.~.~,~.-.-.-.-.-X-,-X-.-.-.-.-.-.-,-,-.-.-.-.-E-.-.-.-+[,=--,-.-.-.-.-.-.-.-X-,---------
--------,-X-.-.-.-.-.-.-X-.-.-.-.-X-.-.-.-.-.-.-X---------------,-,-X~.~.~.~.~,~X~--------,-X-X-X-X-X-X-.-X-X~.~.~.~.~.~.~.~.~.~.~.~.~.~.~.~.~.~.~.~.~.~.~,~.-.-.-.-A-.-X-X-.-.-.-.-.-.-,-,-.-.-.-.-.-.-.-.-+[,=--,-.-.-.-.-.-.-.-X->-X-X-X-X-
--------,-X-.-.-.-.-.-.-.-.-.-.-.-.-.-.-.-.-.-,-X-------------,-,-X~.~.~.~.~,~X~----------,-X-.-.-.-.-.-.-X-X~.~.~.~.~.~.~.~.~.~.~.~.~.~.~.~.~.~.~.~.~.~.~,~.-.-.-.-.-,-X-X-.-.-.-.-.-.-,-,-.-.-.-.-.-.-.-.-+[,=--,-.-.-.-.-.-.-.-.->-------X-
------,-,-X~,-.-.-.-.-.-.-.-.-.-.-.-.-.-.-.-,-,-X~,---------,-,-X~.~.~.~.~,~X~------------,-X-.-.-.-.-.-.-X-X~.~.~.~.~.~.~.~.~.~.~.~.~.~.~.~.~.~.~.~.~.~.~,~.-.-X-X-X-,-X-X-.-.-.-.-.-.-,-,-.-.-.-.-.-.-.-,-X[X=X-X-X-.-.-.-.-.-.-X->-X-X-X-X-
----,-,-X~.~,~,-,-.-.-.-.-.-.-.-.-.-.-.-.-,-,-.~.~X~,-----,-,-X~.~.~.~.~,~X~--------------,-X-.-.-.-.-.-,-X-X~.~.~,~,~,~,~,~,~,~,~,~,~,~,~,~,~,~,~,~,~.~.~,~.-.-X-.-X-,-.-,-.-.-.-.-.-.-,-,-.-.-.-.-E-.-.-,-X-,-,-,-X-.-.-.-E-.-.-X-,---------
--,-,-X~.~.~.~.~,-,-.-.-.-.-.-.-.-.-.-.-,-,-.~.~.~.~X~,-,-,-X~.~.~.~.~,~X~----------------,-X-.-.-.-E-.-,-X-X-.~.~,~.-.-.-.-.-.-.-.-.-.-.-.-.-.-.-.-,-.~.~,~.-.-X-X-X-,-X-X-.-.-.-.-.-.-,-,-.-.-.-.-.-.-.-,-X;X;X-X-X-.-.-.-.-.-.-X->-X-X-X-X-
--,-X~.~.~.~.~.~.~,-,-.-.-H-.-.-.-H-.-,-,-.~.~.~.~.~.~X~,-X~.~.~.~.~,~X~------------------,-X-.-.-.-.-.-,-.-,-.~.~,~.-,-,-,-.-.-.-.-.-.-.-.-.-.-.-A-,-.~.~,~.-.-.-.-.-.-X-X-.-.-.-.-.-.-,-,-.-.-.-.-.-.-.-.-+].;.-.-.-.-.-.-.-.-.-.->-----<-X-
--,-X~.~.~.~.~.~.~,~X~X-X-X-X-X-X-X-X-X-X~.~.~.~.~.~.~.~X~.~.~.~.~,~X~--------------------,-X-.-.-.-.-.-,-X-X-.~.~,~.-,-X-X-X-.-.-.-.-.-.-.-.-.-.-.-,-.~.~,~.-.-E-.-.-.-X-X-.-.-.-.-.-.-,-,-.-.-.-.-.-.-.-.-+].;.-.-.-.-.-.-.-.-.-X->-X-X-X-X-
--,-X~.~.~.~.~.~,~X~X-X-X-X-X-X-X-X-X-X-,-X~.~.~.~.~.~.~.~.~.~.~,~X~----------------------,-X-.-.-.-.-.-.-X-X~.~.~,~.-,-X-X-X-.-.-.-.-.-.-.-.-.-.-.-,-.~.~,~.-,-,-,-,-.-,-X-X-.-.-.-.-.-,-,-.-.-.-.-E-.-.-.-+].;.-.-.-.-.-.-.-.-.-X-,-,-,-,-,-
--,-X~.~.~.~.~.~X~X-.-.-.-A-.-.-.-A-.-.-X-X-X~.~.~.~.~.~.~.~.~,~X~------------------------,-X-.-.-.-E-.-.-X-X~.~.~,~.-,-X-X-X-.-.-.-.-.-.-.-.-.-.-.-,-.~.~,~.-,-.-.-,-.-.-X-,-X-.-.-.-.-,-,-.-.-.-.-.-.-.-.-X]X;X-X-X-.-.-.-.-.-.-X->-X-X-X-X-
--,-X~.~.~.~.~.~X~X-.-H-.-.-.-.-.-.-.-H-.-X-X~.~.~.~.~.~.~.~,~X~--------------------------,-X-.-.-.-.-.-.-X-X~.~.~,~.-.-.-,-,-,-,-,-,-,-,-,-,-,-,-.-,-.~.~,~.-,-.-H-,-.-.-X-,-X-.-.-.-.-,-,-.-.-.-.-.-.-.-.-X-----,-X-.-.-.-.-.-.-,->-.-.-.-X-
--,-X~.~.~.~.~.~X~X-.-.-.-.-E-.-E-.-.-.-,-X-X~.~.~.~.~.~.~,~X~----,-,-,-,-,-,-,-,-,-,-,-,-,-X-X-.-X-X-X-X-X-X~.~.~,~.-.-.-,-.-.-.-.-.-.-.-.-.-.-,-.-,-.~.~,~.-,-,-,-,-.-.-X-X-X-.-.-.-.-,-X-X-X-X-X-X-X-X-X-X-----,-X-X-X-X-X-X-X-X->-X-X-X-X-
--,-X~.~.~.~.~.~.~X~X-.-.-.-.-.-.-.-.-,-X-X~.~.~.~.~.~.~,~X~------,-X-X-X-X-X-X-X-X-X-X-X-X-X-X-.-X-X-X-X-X-X~.~.~,~.-.-.-,-,-,-,-,-,-,-,-,-,-.-,-.-,-.~.~,~.-.-.-.-.-.-.-.-L-.-.-.-.-.-X-X---------------------------------------------------
--,-X~.~.~.~.~.~.~.~X~X-,-,-,-,-,-,-,-X-X~.~.~.~.~.~.~,~X~--------,-X-.-.-.-.-.-.-.-.-.-.-.-.-.-.-.-.-.-.-X-X~.~.~,~.-.-.-,-,-.-.-.-.-.-A-.-A-.-,-.-,-.~.~,~.-.-E-.-.-.-.-.-L-.-.-.-.-.-X-X---------------------------------------------------
----,-X~.~.~.~.~.~.~.~.~.~.~.~.~.~.~.~.~.~.~.~.~.~.~,~X~----------,-X-.-.-.-.-.-.-.-.-.-.-.-.-.-.-.-.-.-.-X-X~.~.~,~.-.-.-,-,-.-.-.-.-.-.-.-,-.-,-.-,-.~.~,~.-.-.-.-.-.-.-.-L-.-.-.-.-.-.-X---------------------------------------------------
------,-X~.~.~.~.~.~.~.~.~.~.~.~.~.~.~.~.~.~.~.~.~,~X~------------,-X-.-E-.-.-.-.-.-.-.-.-.-.-.-.-.-.-.-.-X-X~.~.~,~.-.-.-,-,-.-.-.-E-.-.-.-,-.-,-.-,-.~.~,~.-.-X-X-X-.-.-X-X-X-.-.-.-.-.-X---------------------------------------------------
--------,-X~.~.~.~,~,~,~,~,~,~,~,~,~,~,~,~.~.~.~,~X~--------------,-X-.-.-.-.-.-.-.-.-.-.-.-.-.-.-.-.-.-.-X-X~.~.~,~.-.-.-,-,-H-.-.-.-.-,-,-,-.-,-.-,-.~.~,~.-.-X-.-X-.-.-X-,-X-.-.-.-.-.-X---------------------------------------------------
----------,-X~X~X~X~X-.-.-.-.-.-.-.-.-.-X-X~X~X~X~----------------,-X-.-.-.-.-.-.-.-.-.-.-.-.-.-.-.-.-.-.-X-X~.~.~,~.-.-.-,-,-,-,-,-,-,-,-,-,-.-,-.-,-.~.~,~.-.-X-X-X-.-.-X-,-X-X-X-X-X-X-X---------------------------------------------------
------------------,-X-.-.-.-.-.-.-.-.-.-X-,-,-,-,-,-,-------------,-X-.-.-.-.-,-,-,-,-,-,-,-,-.-.-.-.-.-.-X-X~.~.~,~.-.-.-,-.-.-.-.-.-.-.-,-,-.-,-.-,-.~.~,~.-.-.-.-.-.-,-X-------------------------------------------------------------------
--------X-X-X-X-X-X-X-.-.-.-.-.-.-.-.-.-X-X-X-X-X-X-X-------------,-X-.-.-.-,-,-.-.-.-.-.-.-,-,-.-.-.-.-.-X-X~.~.~,~.-.-.-,-,-,-,-,-,-,-,-,-,-,-,-.-,-.~.~,~.-.-E-.-.-.-X---------------------------------------------------------------------
--------X---------,-.-.-.-.-.-.-.-.-.-.-.-.-.-.-.-.-X-,-,-,-,-,-,-,-X-.-.-,-,-,-,-,-,-,-,-,-,-,-,-.-.-.-X-X-X~.~.~,~.-.-.-.-.-.-.-.-.-.-.-.-.-.-.-.-,-.~.~,~.-.-.-.-.-.-X---------------------------------------------------------------------
--------X---------,-.-.-H-.-.-.-.-.-H-.-.-.-.-.-.-.-X-X-X-X-X-X-X-X-X-.-.-,-.-,-.~.~.~.~.~.~,~.-,-.-.-.-X-X-X-.~.~,~.-.-.-.-.-.-.-.-.-.-.-.-.-.-.-.-,-.~.~,~.-.-X-X-X-.-X---------------------------------------------------------------------
--------X-----E---,-.-.-.-.-.-.-.-.-.-.-.-.-.-E-.-.-.-.-.-.-.-.-.-.-.-.-.-,-.-,-.~.~.~.~.~.~,~.-,-.-.-.-.-L-,-.~.~,~.-.-.-.-.-.-.-.-.-.-.-.-.-.-.-.-,-.~.~,~.-.-X-.-X-.-X---------------------------------------------------------------------
--------X---------,-X-.-.-.-W-.-W-.-.-,-X-.-.-.-.-.-X-X-X-X-X-X-X-X-X-.-.-,-.-,-.~.~.~.~.~.~,~.-,-.-.-.-.-L-,-.~.~,~,-,-,-,-,-,-,-,-,-,-,-,-,-,-,-,-,-.~.~,~.-.-X-X-X-.-X---------------------------------------------------------------------
--------X-H-----X-X-,-X-.-.-.-.-.-.-X-X-,-X-.-.-.-H-X-------------,-X-.-.-,-.-,-.~.~.~.~.~.~,~.-,-.-.-.-.-L-,-.~.~.~.~.~.~.~.~.~.~.~.~.~.~.~.~.~.~.~.~.~.~,~.-.-.-.-.-.-X---------------------------------------------------------------------
--------X-------X---,-,-X-.-.-.-.-.-X---,-,-X-.-.-,-X-------------,-X-.-.-,-.-,-:~.~.~.~.~.~,~.-,-.-.-.-X-X-X-.~.~.~.~.~.~.~.~.~.~.~.~.~.~.~.~.~.~.~.~.~.~,~.-.-.-.-<-,-X---------------------------------------------------------------------
--------X-------X-,-,-X-.-.-.-.-.-.-X-,-,-X-.-.-.-X---------------,-X-H-.-,-.-,-.~.~.~.~.~.~,~.-,-.-.-A-X-,-X~.~.~.~.~.~.~.~.~,~,~,~,~,~,~,~,~,~,~,~,~.~.~,~.-.-.-.-,-X-----------------------------------------------------------------------
----------X-------X-X-X-.-.-.-.-.-.-.-X-X-X-.-.-,-X---------------,-X-X-X-X-X-X-.~.~.~.~.~.~,~X-X-X-X-X-X-,-X~X~X~X~X~,~,~,~X~X~X-.-.-.-X-X~X-.-.-.-X-X~X~X~X-X-X-X-X-------------------------------------------------------------------------
------------X-----,-.-.-.-,-,-E-,-.-.-.-.-.-.-,-X---------------------------,-X~A~.~.~.~.~.~H~X~--------------------X-X-X-X-X-,-X-.-K-.-X-,-X-X-X-X-X-----------------------------------------------------------------------------------------
--------------X---,-.-.-.-,-.:.:,:.-.-.-.-.-,-X-----------------------------,-X~.~.~.~.~.~.~.~X~------------------------------,-X@.@.@.@X@----------------------------------------------------------------------------------------------------
----------------X-X-.-.-.-,-,-,-,-.-.-.-.-,-X-------------------------------,-X~.~.~.~E~.~.~,~X~,-,-,-,-,-,-,-,-,-,-,---------,-X@.@.@.@X@----------------------------------------------------------------------------------------------------
------:-:---:-----,-XZ+Z+Z+Z+Z+Z+Z+Z+Z+ZXZX---------------------------------,-X~.~.~.~.~.~.~,~XaXaX-X-X-X-X-X-X-X-X-X-X-X-X-X@X-X@,@,@,@X@----------------------------------------------------------------------------------------------------
----:-------:-----,-XZ+Z+Z+Z+Z+Z+Z+Z+Z+ZXZ,-,-,-,-,-,-,-,-,-,-,-,-,-,-,-,-,-,-X~.~.~.~.~.~.~,~+a+a.-.-.-,-.-,-.-.-.-,--------@----------X-----------------------------------------------------------------------------------------------------
----:---:-:-:-----,-X-.-.-.-.-.-.-.-.-.-X:X-X-X-X-X-X-X-X-X-X-X-X<X<X<X~X~X~X~X~.~.~.~.~.~.~,~+a+a.-.-.-,-.-,-.-.-.-,--------@----E-----X-----------------------------------------------------------------------------------------------------
------:-:---:-----,-X-.-.-.-.-.-.-.-.-.-.:.-.-.-.-.-.-.-.-.-.-.-.<.<,<.~.~.~.~.~.~.~.~.~.~.~,~+a+a.-.-.-,-.-,-.-.-.-,--------@----------X-----------------------------------------------------------------------------------------------------
------------------,-X-.-.-E-.-.-.-E-.-.-X:X-X-X-X-X-X-X-X-X-X-X-X<X<X<X~X~X~X~X~.~.~.~.~.~.~,~XaXa.-.-.-,-X-X-.-.-.-X-------X@----------X-----------------------------------------------------------------------------------------------------
------------------,-X-.-.-.-.-A-.-.-.-.-X-------------------------------------,-X~X~X~X~X~X~X~,-X-X-X-X-X-X-X-X-X-X-X-X-X-X-X-X-X-X-X-X-X-----------------------------------------------------------------------------------------------------
------------------,-X-X-X-X-X-X-X-X-X-X-X-----------------------------------------------------------------------------------------------------------------------------------------------------------------------------------------------------
