X-X-X-X-X-X-X-X-X-X-X-X-X-X-X-X-X-X-X-X-X-X-X-X-X-X-X-X-X-X-X-X-X-X-X-X-X-X-X-X-X-X-X-X-X-X-X-X-X-X-X-X-X-X-X-X-X-X-X-X-X-X-X-X-X-X-X-X-X-X-X-X-X-X-X-X-X-X-X-X-X-X-X-X-X-X-X-X-X-X-X-X-X-X-X-X-X-X-X-X-X-X-X-X-X-
X-.-.-.-.-.-.-.-.-.-.-.-.-.-.-.-.-.-.-.-.-.-.-.-.-.-.-.-.-.-.-.-.-.-.-.-.-.-.-.-.-.-.-.-.-.-.-.-.-.-.-.-.-.-.-.-.-.-.-.-.-.-.-.-.-.-.-.-.-.-.-.-.-.-.-.-.-.-.-.-.-.-.-.-.-.-.-.-.-.-.-.-.-.-.-.-.-.-.-.-.-.-.-.-X-
X-.-.-.-.-.-.-.-.-.-.-.-.-.-.-.-.-.-.-.-.-.-.-.-.-.-.-.-.-.-.-.-.-.-.-.-.-.-.-.-.-.-.-.-.-.-.-.-.-.-.-.-.-.-.-.-.-.-.-.-.-.-.-.-.-.-.-.-.-.-.-.-.-.-.-.-.-.-.-.-.-.-.-.-.-.-.-.-.-.-.-.-.-.-.-.-.-.-.-.-.-.-.-.-X-
X-.-.-.-.-.-.-.-.-.-.-.-.-.-.-.-.-.-.-.-.-.-.-.-.-.-.-.-.-.-.-.-.-.-.-.-.-.-.-.-.-.-.-.-.-.-.-.-.-.-.-.-.-.-.-.-.-.-.-.-.-.-.-.-.-.-.-.-.-.-.-.-.-.-.-.-.-.-.-.-.-.-.-.-.-.-.-.-.-.-.-.-.-.-.-.-.-.-.-.-.-.-.-.-X-
X-.-.-.-.-.-.-.-.-.-.-.-.-.-.-.-.-.-.-.-.-.-.-.-.-.-.-.-.-.-.-.-.-.-.-.-.-.-.-.-.-.-.-.-.-.-.-.-.-.-.-.-.-.-.-.-.-.-.-.-.-.-.-.-.-.-.-.-.-.-.-.-.-.-.-.-.-.-.-.-.-.-.-.-.-.-.-.-.-.-.-.-.-.-.-.-.-.-.-.-.-.-.-.-X-
X-.-.-.-.-.-.-.-.-.-.-.-.-.-.-.-.-.-.-.-.-.-.-.-.-.-.-.-.-.-.-.-.-.-.-.-.-.-.-.-.-.-.-.-.-.-.-.-.-.-.-.-.-.-.-.-.-.-.-.-.-.-.-.-.-.-.-.-.-.-.-.-.-.-.-.-.-.-.-.-.-.-.-.-.-.-.-.-.-,-,-,-,-.-.-.-.-.-.-.-.-.-.-.-X-
X-.-.-.-.-.-.-.-.-.-.-.-.-.-.-.-.-.-.-.-.-.-.-.-.-.-.-.-.-.-.-.-.-.-.-.-.-.-.-.-.-.-.-.-.-.-.-.-.-.-.-.-.-.-.-.-.-.-.-.-.-.-.-.-.-.-.-.-.-.-.-.-.-.-.-.-.-.-.-.-.-.-.-.-.-.-.-,-,-,-.-.-,-.-.-.-.-.-.-.-.-.-.-.-X-
X-.-.-.-.-.-.-.-.-.-.-.-.-.-.-.-.-.-.-.-.-.-.-.-.-.-.-.-.-.-.-.-.-.-.-.-.-.-.-.-.-.-.-.-.-.-.-.-.-.-.-.-.-.-.-.-.-.-.-.-.-.-.-.-.-.-.-.-.-.-.-.-.-.-.-.-.-.-.-.-.-.-.-.-.-,-,-,-.-.-.-.-,-,-.-.-.-.-.-.-.-.-.-.-X-
X-.-.-.-.-.-.-.-.-.-.-.-.-.-.-.-.-.-.-.-.-.-.-.-.-.-.-.-.-.-.-.-.-.-.-.-.-.-.-.-.-.-.-.-.-.-.-.-.-.-.-.-.-.-.-.-.-.-.-.-.-.-.-.-.-.-.-.-.-.-.-.-.-.-.-.-.-.-.-.-.-.-.-,-,-,-.-.-.-.-.-.-.-,-.-.-.-.-.-.-.-.-.-.-X-
X-.-.-.-.-.-.-.-.-.-.-.-.-.-.-.-.-.-.-.-.-.-.-.-.-.-.-.-.-.-.-.-.-.-.-.-.-.-.-.-.-.-.-.-.-.-.-.-.-.-.-.-.-.-.-.-.-.-.-.-.-.-.-.-.-.-.-.-.-.-.-.-.-.-.-.-.-.-.-.-.-.-,-,-.-.-.-.-.-.-.-.-.-,-,-.-.-.-.-.-.-.-.-.-X-
X-.-.-.-.-.-.-.-.-.-.-.-.-.-.-.-.-.-.-.-.-.-.-.-.-.-.-.-.-.-.-.-.-.-.-.-.-.-.-.-.-.-.-.-.-.-.-.-.-.-.-.-.-.-.-.-.-.-.-.-.-.-.-.-.-.-.-.-.-.-.-.-.-.-.-.-.-.-.-.-.-,-,-.-.-.-.-.-.-.-.-.-.-.-,-.-.-.-.-.-.-.-.-.-X-
X-.-.-.-.-.-.-.-.-.-.-.-.-.-.-.-.-.-.-.-.-.-.-.-.-.-.-.-.-.-.-.-.-.-.-.-.-.-.-.-.-.-.-.-.-.-.-.-.-.-.-.-.-.-.-.-.-.-.-.-.-.-.-.-.-.-.-.-.-.-.-.-.-.-.-.-.-.-.-.-,-,-.-.-.-.-.-.-.-.-.-.-.-.-,-,-.-.-.-.-.-.-.-.-X-
X-.-.-.-.-.-.-.-.-.-.-.-.-.-.-.-.-.-.-.-.-.-.-.-.-.-.-.-.-.-.-.-.-.-.-.-.-.-.-.-.-.-.-.-.-.-.-.-.-.-.-.-.-.-.-.-.-.-.-,-,-,-.-.-.-.-.-.-.-.-.-.-.-.-.-.-.-.-.-,-,-.-.-.-.-.-.-.-.-.-.-.-.-.-.-,-,-.-.-.-.-.-.-.-X-
X-.-.-.-.-.-.-.-.-.-.-.-.-.-.-.-.-.-.-.-.-.-.-.-.-.-.-.-.-.-.-.-.-.-.-.-.-.-.-.-.-.-.-.-.-.-.-.-.-.-.-.-.-.-.-.-.-.-,-,-.-,-,-,-.-.-.-.-.-.-.-.-.-.-.-.-.-.-,-,-.-.-.-.-.-.-.-.-.-.-.-.-.-.-.-.-,-,-.-.-.-.-.-.-X-
X-.-.-.-.-.-.-.-.-.-.-.-.-.-.-.-.-.-.-.-.-.-.-.-.-.-.-.-.-.-.-.-.-.-.-.-.-.-.-.-.-.-.-.-.-.-.-.-.-.-.-.-.-.-.-.-.-,-,-.-.-.-.-,-,-,-.-.-.-.-.-.-.-.-.-.-.-,-,-.-.-.-.-.-.-.-.-.-.-.-.-.-.-.-.-.-.-,-,-.-.-.-.-.-X-
X-.-.-.-.-.-.-.-.-.-.-.-.-.-.-.-.-.-.-.-.-.-.-.-.-.-.-.-.-.-.-.-.-.-.-.-.-.-.-.-.-.-.-.-.-.-.-.-.-.-.-.-.-.-.-.-,-,-.-.-.-.-.-.-.-,-,-,-.-.-.-.-.-.-.-.-,-,-.-.-.-.-.-.-.-X-X-.-.-X-X-.-.-.-.-.-.-.-,-,-.-.-.-.-X-
X-.-.-.-.-.-.-.-.-.-.-.-.-.-.-.-.-.-.-.-.-.-.-.-.-.-.-.-.-.-.-.-.-.-.-.-.-.-.-.-.-.-.-.-.-.-.-.-.-.-.-.-.-.-.-,-,-.-.-.-.-.-.-.-.-.-.-,-,-,-,-,-,-,-,-,-,-.-.-.-.-.-.-.-.-X-X-.-.-X-X-.-.-.-.-.-.-.-.-,-.-.-.-.-X-
X-.-.-.-.-.-.-.-.-.-.-.-.-.-.-.-.-.-.-.-.-.-.-.-.-.-.-.-.-.-.-.-.-.-.-.-.-.-.-.-.-.-.-.-.-.-.-.-.-.-.-.-.-.-,-,-.-.-.-.-.-.-.-.-.-.-.-.-.-.-.-.-.-.-.-.-.-.-.-.-.-.-.-.-.-.-.-.-.-.-.-.-.-.-.-.-.-.-.-,-.-.-.-.-X-
X-.-.-.-.-.-.-.-.-.-.-.-.-.-.-.-.-.-.-.-.-.-.-.-.-.-.-.-.-.-.-.-.-.-.-.-.-.-.-.-.-.-.-.-.-.-.-.-.-.-.-.-.-,-,-.-.-.-.-.-.-.-.-.-.-.-.-.-.-.-.-.-.-.-.-.-.-.-.-.-.-.-.-.-.-.-.-.-W-.-.-.-.-.-.-.-.-.-.-,-.-.-.-.-X-
X-.-.-.-.-.-.-.-.-.-.-.-.-.-.-.-.-.-.-.-.-.-.-.-.-.-.-.-.-.-.-.-.-.-.-.-.-.-.-.-.-.-.-.-.-.-.-.-.-.-.-.-,-,-.-.-.-.-.-.-.-.-.-.-.-.-.-.-.-.-.-.-.-.-.-.-.-.-.-.-.-.-.-.-.-X-X-.-.-X-X-.-.-.-.-.-.-.-.-,-.-.-.-.-X-
X-.-.-.-.-.-.-.-.-.-.-.-.-.-.-.-.-.-.-.-.-.-.-.-.-.-.-.-.-.-.-.-.-.-.-.-.-.-.-.-,-,-,-,-,-,-,-,-,-,-,-,-,-.-.-.-.-.-.-.-.-.-.-.-.-.-.-.-.-.-.-.-.-.-.-.-.-.-.-.-.-.-.-.-.-X-X-.-.-X-X-.-.-.-.-.-.-.-.-,-.-.-.-.-X-
X-.-.-.-.-.-.-.-.-.-.-.-.-.-.-.-.-.-.-.-.-.-.-.-.-.-.-.-.-.-.-.-.-.-.-.-.-.-.-.-,-.-.-.-.-.-.-.-.-.-.-.-.-.-.-.-.-.-.-.-.-.-.-.-.-.-.-.-.-.-.-.-.-.-.-.-.-.-.-.-.-.-.-.-.-.-.-.-.-.-.-.-.-.-.-.-.-.-.-,-.-.-.-.-X-
X-.-.-.-.-.-.-.-.-.-.-.-.-.-.-.-.-.-.-.-.-.-.-.-.-.-.-.-.-.-.-.-.-.-.-.-.-.-.-,-,-.-.-.-.-.-.-.-.-.-.-.-.-.-.-.-.-.-.-.-.-.-.-.-.-.-.-.-.-.-.-.-.-.-.-.-.-.-.-.-.-.-.-.-.-.-.-.-.-.-.-.-.-.-.-.-.-.-.-,-.-.-.-.-X-
X-.-.-.-.-.-.-.-.-.-.-.-.-.-.-.-.-.-.-.-.-.-.-.-.-.-.-.-.-.-.-.-.-.-.-.-.-.-.-,-.-.-.-.-.-.-.-.-.-.-.-.-.-.-.-.-.-.-.-.-.-.-.-.-.-.-.-.-.-.-.-.-.-.-.-.-.-.-.-.-.-.-.-.-.-.-.-.-.-.-.-.-.-.-.-.-.-.-.-,-.-.-.-.-X-
X-.-.-.-.-.-.-.-.-.-.-.-.-.-.-.-.-.-.-.-.-.-.-.-.-.-.-.-.-.-.-.-.-.-.-.-.-.-,-,-.-.-.-.-.-.-.-.-.-.-.-.-.-.-.-.-.-.-.-.-.-.-.-.-.-.-.-.-.-.-.-.-.-.-.-.-.-.-.-.-.-.-.-.-.-.-.-.-.-.-.-.-.-.-.-.-.-.-.-,-.-.-.-.-X-
X-.-.-.-.-.-.-.-.-.-.-.-.-.-.-.-.-.-.-.-.-.-.-.-.-.-.-.-.-.-.-.-.-.-.-.-.-.-,-.-.-.-.-.-.-.-.-.-.-.-.-.-,-,-,-,-,-,-,-,-,-,-,-,-.-.-.-.-.-.-.-.-.-.-.-.-.-.-.-.-.-.-.-.-.-.-.-.-.-.-.-.-.-.-.-.-.-.-.-,-.-.-.-.-X-
X-.-.-.-.-.-.-.-.-.-.-.-.-.-.-.-.-.-.-.-.-.-.-.-.-.-.-.-.-.-.-.-.-.-.-.-.-,-,-.-.-.-.-.-.-.-.-.-.-.-,-,-X-X-X-.-X-X-X-,-,-,-X-X-X-X-.-.-.-.-.-.-.-.-.-.-.-.-.-.-.-.-.-.-.-.-.-.-.-.-.-.-.-.-.-.-.-.-.-,-.-.-.-.-X-
X-.-.-.-.-.-.-.-.-.-.-.-.-.-.-.-.-.-.-.-.-.-.-.-.-.-.-.-.-.-.-.-.-.-.-.-.-,-.-.-.-.-.-.-.-.-.-.-,-,-X-X-,-X-.-.-.-.-.-.-.-.-.-X-,-,-X-X-.-.-.-.-.-.-.-.-.-.-.-.-.-.-.-.-.-.-.-.-.-.-,-,-,-,-,-,-,-,-,-,-.-.-.-.-X-
X-.-.-.-.-.-.-.-.-.-.-.-.-.-.-.-.-.-.-.-.-.-.-.-.-.-.-.-.-.-.-.-.-.-.-.-,-,-.-.-.-.-.-.-.-.-.-,-X-X---,-,-X-.-.-,-E-,-,-E-,-H-X-----,-,-X-.-.-.-.-.-.-.-.-.-.-.-.-.-.-.-.-.-.-.-,-,-,-.-.-.-.-.-.-.-.-.-.-.-.-.-X-
X-.-.-.-.-.-.-.-.-.-.-.-.-.-.-.-.-.-.-.-.-.-.-.-.-.-.-.-.-.-.-.-.-.-.-.-,-.-.-.-.-.-.-.-.-.-,-X-,-,-,-,-X-X-X-X-X-X-X-X-X-X-X-X-,-,-,-,-,-X-.-.-.-.-.-.-.-.-.-.-.-.-.-.-.-.-,-,-,-.-.-.-.-.-.-.-.-.-.-.-.-.-.-.-X-
X-.-.-.-.-.-.-.-.-.-.-.-.-.-.-.-.-.-.-.-.-.-.-.-.-.-.-.-.-.-.-.-.-.-.-,-,-.-.-.-.-.-.-.-.-.-X-,-X-X-X-X-X=,=,=,=X=X-X-X-X-X-X-X-X-X-X-X-X-,-X-.-.-.-.-.-.-.-.-.-.-.-.-.-,-,-,-.-.-.-.-.-.-.-.-.-.-.-.-.-.-.-.-.-X-
X-.-.-.-.-.-.-.-.-.-.-.-.-.-.-.-.-.-.-.-.-.-.-.-.-.-.-.-.-.-.-.-.-,-,-,-.-.-.-.-.-.-.-.-.-X-,-,-X-,-.-.-.-.-.-.-.-.-.-.-.-.-.-.-.-.-.-H-X---X-.-.-.-.-.-.-.-.-.-.-.-.-,-,-.-.-.-.-.-.-.-.-.-.-.-.-.-.-.-.-.-.-.-X-
X-.-.-.-.-.-.-.-.-.-.-.-.-.-.-.-.-,-,-,-.-.-.-.-.-.-.-.-.-.-.-,-,-,-.-.-.-.-.-.-.-.-.-.-.-X-,-,-X=,-.-.-.-.-<-.-.-.-.-.-.-.-.-.-.-.-.-.-X---,-X-.-.-.-.-.-.-.-.-.-.-.-,-.-.-.-.-.-.-.-.-.-.-.-.-.-.-.-.-.-.-.-.-X-
X-.-.-.-.-.-.-.-.-.-.-.-.-.-.-.-,-,-.-,-,-,-.-.-.-.-.-.-.-,-,-,-.-.-.-.-.-.-.-.-.-.-.-.-X-,-X-X-X=,=.-.-.-.-.-.-.-.-.-.-.-.-.-.-.-.-.-A-X-----X-,-.-.-.-.-.-.-.-.-.-.-,-.-.-.-.-.-.-.-.-.-.-.-.-.-.-.-.-.-.-.-.-X-
X-.-.-.-.-.-.-.-.-.-.-.-.-.-.-,-,-.-.-.-.-,-,-,-,-,-,-,-,-,-.-.-.-.-.-.-.-.-.-.-.-.-.-.-X-X-A-.-,=,=.-.-.-.-.-.-.-.-X-X-,-,-,-X8X-.-.-.-X---,-,-X-.-.-.-.-.-.-.-.-.-.-,-.-.-.-.-.-.-.-.-.-.-.-.-.-.-.-.-.-.-.-.-X-
X-.-.-.-.-.-.-.-.-.-.-.-.-.-,-,-.-.-.-.-.-.-.-.-.-.-.-.-.-.-.-.-.-.-.-.-.-.-.-.-.-.-.-.-X-X-.-X-X=+Y.-.-.-.-.-.-.-.-X-X-.-.-.-X8X-.-.-.-X-,-,-X-,-.-.-.-.-.-.-.-.-.-.-,-.-.-.-.-.-.-.-.-.-.-.-.-.-.-.-.-.-.-.-.-X-
X-.-.-.-.-.-.-.-.-.-.-.-.-,-,-.-.-.-.-.-.-.-.-.-.-.-.-.-.-.-.-.-.-.-.-.-.-.-.-.-.-.-.-.-X-X-A-X-X=,-.-.-.-.-E-.-.-.-X-X-,-,-,-X-X-X-L-X-X-,-X-,-,-.-.-.-.-.-.-.-.-.-.-,-.-.-.-.-.-.-.-.-.-.-.-.-.-.-.-.-.-.-.-.-X-
X-.-.-.-.-.-.-.-.-.-.-.-,-,-.-.-.-.-.-.-.-.-.-.-.-.-.-.-.-.-.-.-.-.-.-.-.-.-.-.-.-.-.-.-X-X-.-X-X-.-.-.-.-.-.-.-.-.-X-X-------X8X-X-.-X-X-X-,-,-,-,-.-.-.-.-.-.-.-.-.-,-.-.-.-.-.-.-.-.-.-.-.-.-.-.-.-.-.-.-.-.-X-
X-.-.-.-.-.-.-.-.-.-.-,-,-.-.-.-.-.-.-.-.-.-.-.-.-.-.-,-,-,-,-,-,-,-,-,-,-,-.-.-.-.-.-.-X-X-A-X-X-X-X-.-.-.-.-.-.-.-X-X-------X8X-.-.-.-,-,-,-,-,-,-.-.-.-.-.-.-.-.-.-,-.-.-.-.-.-.-.-.-.-.-.-.-.-.-.-.-.-.-.-.-X-
X-.-.-.-.-.-.-.-.-.-,-,-.-.-.-.-.-.-.-.-.-.-.-.-.-.-.-,-.-.-.-,-,-,-.-,-,-,-,-.-.-.-.-.-X-X-.-X---,-X-.-.-.-.-.-.-.-X7X-,-,-,-X-X-.-<-.-,-,-,-,-,-,-.-.-.-.-.-.-.-.-.-,-.-.-.-.-.-.-.-.-.-.-.-.-.-.-.-.-.-.-.-.-X-
X-.-.-.-.-.-.-.-.-,-,-.-.-.-.-.-.-.-.-.-.-.-.-.-.-.-.-,-.-A-.-,-,-,-.-,-,-.-,-.-.-.-.-.-X-X-H-X---,-X-.-.-+Y.-+Y.-.-X7XW+W+W+WXWX-.-.-.-,-,-,-,-,-,-.-.-.-.-.-.-.-.-.-,-.-.-.-.-.-.-.-.-.-.-.-.-.-.-.-.-.-.-.-.-X-
X-.-.-.-.-.-.-.-,-,-.-.-.-.-.-.-.-.-.-.-.-.-.-.-.-.-.-,-.-.-.-X-X-X-X-X-X-X-X-X-X-X-X-X-X-X-X-X-,-,-X-,-,-,-,-,-+Y,-X7XW+W+W+WXWX-X-X-X-X-X-X-X-X-X-X-.-.-.-.-.-.-.-.-,-,-.-.-.-.-.-.-.-.-.-.-.-.-.-.-.-.-.-.-.-X-
X-.-.-.-.-.-.-,-,-.-.-.-.-.-.-.-.-.-.-.-.-.-.-.-.-.-.-,-.-.-E-X-X-X-X-X-X-X-X-X-X-X-X-X-X-X-X-X-X-X-X-X-,-,-,-.-.-X-X7X-,-,-,-X-X-X-X-X-X-X-X-X-X-,-X-.-.-.-.-.-.-.-.-.-,-.-.-.-.-.-.-.-.-.-.-.-.-.-.-.-.-.-.-.-X-
X-.-.-.-.-.-,-,-.-.-.-.-.-.-.-.-.-.-.-.-.-.-.-.-.-.-.-,-.-.-,-X-X-.-.-.-.-.-.-.-.-X-X-.-.-.-.-.-.-X-X-X-,-,-,-,-,-X-X-X-.-.-.-X-X-.-.-.-.-.-.-.-X-,-X-.-.-.-.-.-.-.-.-.-,-,-.-.-.-.-.-.-.-.-.-.-.-.-.-.-.-.-.-.-X-
X-.-.-.-.-.-,-,-.-.-.-.-.-.-.-.-.-.-.-.-.-.-.-.-.-.-.-,-.-.-,-.-,-.-.-.-.-.-.-.-.-X-X-.-.-.-.-.-.-.-.-.-E-.-.-.-.-.-.-.-E-.-.-.-.-.-.-.-E-.-.-.-X-,-X-.-.-.-.-.-.-.-.-.-.-,-.-.-.-.-.-.-.-.-.-.-.-.-.-.-.-.-.-.-X-
X-.-.-.-.-.-.-,-.-.-.-.-.-.-.-.-.-.-.-.-.-.-.-.-.-.-.-,-.-.-,-X-X-.-.-.-.-.-.-.-.-X-X-.-.-.-.-.-.-.-.-.-.-.-.-.-.-.-.-.-.-.-.-.-.-.-.-.-.-.-.-.-X-,-X-.-.-.-.-.-.-.-.-.-.-,-,-.-.-.-.-.-.-.-.-.-.-.-.-.-.-.-.-.-X-
X-.-.-.-.-.-.-,-,-.-.-.-.-.-.-.-.-.-.-.-.-.-.-.-.-.-.-,-.-X-X-X-X-.-.-.-.-.-.-.-.-.-.-.-.-.-X-X-X-,-,-,-,-,-,-,-,-,-,-,-,-,-,-,-,-,-X-X-X-.-.-.-X-,-X-.-.-.-.-.-.-.-.-.-.-.-,-.-.-.-.-.-.-.-.-.-.-.-.-.-.-.-.-.-X-
X-.-.-.-.-.-.-.-,-.-.-.-.-.-.-.-.-.-.-.-.-.-.-.-.-.-,-X-X-X-X-.-.-.-.-.-.-.-.-.-.-.-.-.-.-.-X-,-X-,-,-,-,-,-,-,-E-,-,-,-,-,-,-,-E-,-X-,-X-.-.-.-X-,-X-.-.-.-.-.-.-.-.-.-.-.-,-,-.-.-.-.-.-.-.-.-.-.-.-.-.-.-.-.-X-
X-.-.-.-.-.-.-.-,-,-.-.-.-.-.-.-.-.-.-.-.-.-.-.-.-,-,-,-X-.-.-.-.-.-.-.-.-.-.-.-.-X-X-.-.-.-X-X-X-,-,-,-,-,-,-,-,-,-,-,-,-,-,-,-,-.-X-X-X-.-.-.-X-,-X-.-.-.-.-.-.-.-.-.-.-.-.-,-.-.-.-.-.-.-.-.-.-.-.-.-.-.-.-.-X-
X-.-.-.-.-.-.-.-.-,-.-.-.-.-.-.-.-.-.-.-.-.-.-.-,-X-,-.-.-.-.-.-.-.-.-.-.-.-.-.-.-X-X-.-.-.-,-,-,-.-.-.-.-.-.-.-.-.-.-.-.-.-.-.-,-.-,-,-.-.-.-.-X-,-X-.-.-.-.-.-.-.-.-.-.-.-.-,-,-.-.-.-.-.-.-.-.-.-.-.-.-.-.-.-X-
X-.-.-.-.-.-.-.-.-,-,-.-.-.-.-.-.-.-.-.-.-.-.-.-X-,-X-.-.-.-.-.-.-.-.-.-.-.-.-.-.-X-X-.-.-.-,-,-,-.-.-.-.-.-.-.-.-.-.-.-.-.-.-.-,-.-,-,-.-.-E-.-X-,-X-X-.-.-.-.-.-.-.-.-.-.-.-.-,-.-.-.-.-.-.-.-.-.-.-.-.-.-.-.-X-
X-.-.-.-.-.-.-.-.-.-,-.-.-.-.-.-.-.-.-.-.-.-.-,-X-,-X-.-.-.-.-.-.-.-.-.-.-.-.-.-.-.-.-.-.-.-,-,-,-.-.-.-.-.-.-.-.-K-.-.-.-.-.-.-,-.-,-,-.-.-.-.-X---,-,-X-.-.-.-.-.-.-.-.-.-.-.-,-,-.-.-.-.-.-.-.-.-.-.-.-.-.-.-X-
X-.-.-.-.-.-.-.-.-.-,-,-.-.-.-.-.-.-.-.-.-.-.-X-,-X-.-.-.-.-.-.-.-.-,-,-,-,-,-,-.-.-.-.-.-.-,-,-,-.-.-.-.-.-.-.-.-.-.-.-.-.-E-.-,-.-,-,-.-.-.-.-X-------,-X-.-.-.-.-.-.-.-.-.-.-.-,-.-.-.-.-.-.-.-.-.-.-.-.-.-.-X-
X-.-.-.-.-.-.-.-.-.-.-,-.-.-.-.-.-.-.-.-.-.-.-X-,-X-.-.-.-.-.-.-.-.-,-.-.-.-.-,-,-X-X-.-.-.-,-,-,-.-.-.-.-.-.-.-.-.-.-.-.-.-.-.-,-.-,-,-.-.-.-.-X---------,-X-.-.-.-.-.-.-.-.-.-.-,-,-.-.-.-.-.-.-.-.-.-.-.-.-.-X-
X-.-.-.-.-.-.-.-.-.-.-,-,-.-.-.-.-.-.-.-.-.-.-,-X-.-.-.-.-.-.-.-.-.-,-,-H-,-,-H-,-X-X-.-.-.-,-,-,-.-.-.-.-.-.-.-.-.-.-.-.-.-.-.-,-.-,-,-.-.-.-.-X-----------X-.-.-.-.-.-.-.-.-.-.-.-,-.-.-.-.-.-.-.-.-.-.-.-.-.-X-
X-.-.-.-.-.-.-.-.-.-.-.-,-.-.-.-.-.-.-.-.-.-,-X-.-.-.-.-.-.-.-.-.-.-X0X0X-X0X0X-X-X-X-X-.-.-,-,-,-.-.-.-.-.-.-,-,-,-,-.-.-.-.-.-,-.-,-,-,-,-.-.-X-----------,-X-.-.-.-.-.-.-.-.-.-.-,-,-.-.-.-.-.-.-.-.-.-.-.-.-X-
X-.-.-.-.-.-.-.-.-.-.-,-,-.-.-.-.-.-.-.-.-.-X-X-.-.-.-.-.-.-.-.-.-.-X-X-XPX-X-X-XQXQX-X-.-.-,-,-,-.-.-.-.-.-,-,-.-.-,-,-.-,-,-,-,-,-,-,-.-,-.-.-X-,-,-,-,---,-X-.-.-.-.-.-.-.-.-.-.-,-,-.-.-.-.-.-.-.-.-.-.-.-.-X-
X-.-.-.-.-.-.-.-.-.-.-,-.-.-.-.-.-.-.-.-.-.-X-X-.-.-.-.-.-.-.-.-.-.-,-,-,-----,-+Q+Q.-,-.-.-,-,-,-.-.-.-.-.-,-.-.-.-.-,-,-,-,-,-.-,-,-,-,-,-.-.-,-X-X-X-X---,-X-.-.-.-.-.-.-.-.-.-,-,-.-.-.-.-.-.-.-.-.-.-.-.-.-X-
X-.-.-.-.-.-.-.-.-.-,-,-.-.-.-.-.-.-.-.-.-.-X-X-.-.-.-.-.-.-W-.-.-.-,-,-,-----,-+Q+Q.-,-.-.-,-,-,-.-.-.-.-.-,-.-.-.-.-.-,->-,-,-.-.-.-,-.-.-.-.-,-.-E-X-X---,-X-.-.-.-.-.-.-.-.-,-,-.-.-.-.-.-.-.-.-.-.-.-.-.-.-X-
X-.-.-.-.-.-.-.-.-.-,-.-.-.-.-.-.-.-.-.-.-.-.-X-.-.-.-.-.-.-.-.-.-.-,-,-,---,-,-+Q+Q.-,-.-.-,-,-,-.-.-.-.-.-,-,-.-.-.-,-,->-,-,-.-.-.-,-.-.-.-.-,-.-.-X-X---,-X-.-.-.-.-.-.-.-,-,-.-.-.-.-.-.-.-.-.-.-.-.-.-.-.-X-
X-.-.-.-.-.-.-.-.-,-,-.-.-.-.-.-.-.-.-.-.-.-.-X-.-.-.-.-.-.-.-.-.-.-X-X-XPX-X-X1XQXQX1X-.-.-,-,-,-.-.-.-E-.-.-,-,-.-,-.-,-,-,-,-,-,-,-,-.-.-.-.-,-X-X-X-X---,-X-.-.-.-.-.-.-,-,-.-.-.-.-.-.-.-.-.-.-.-.-.-.-.-.-X-
X-.-.-.-.-.-.-.-.-,-.-.-.-.-.-.-.-.-.-.-.-.-.-,-.-.-.-.-.-.-.-.-.-.-X-X-X-X-X-X-X-X-X-X-.-.-,-,-,-.-.-.-.-.-.-.-,-,-,-,-,-.-.-.-.-,---,-.-.-.-.-X---------,-,-X-.-.-.-.-.-,-,-.-.-.-.-.-.-.-.-.-.-.-.-.-.-.-.-.-X-
X-.-.-.-.-.-.-.-,-,-.-.-.-.-.-.-.-.-.-.-.-.-.-X-X-.-.-.-.-.-.-.-.-.-.-.-A-.-.-A-.-X-X-.-.-.-,-,-,-.-.-.-.-.-.-.-.-.-.-.-.-.-.-.-.-,---,-.-.-.-.-X---------,-.-X-.-.-.-.-,-,-.-.-.-.-.-.-.-.-.-.-.-.-.-.-.-.-.-.-X-
X-.-.-.-.-.-.-.-,-.-.-.-.-.-.-.-.-.-.-.-.-.-.-.-X-.-.-.-.-.-.-.-.-.-.-.-.-.-.-.-.-X-X-.-.-.-,-,-,-.-.-.-.-.-.-.-.-.-.-.-.-.-.-.-.-,---,-.-.-.-.-X-------,-,-X-.-.-.-.-,-,-.-.-.-.-.-.-.-.-.-.-.-.-.-.-.-.-.-.-.-X-
X-.-.-.-.-.-.-.-,-.-.-.-.-.-.-.-.-.-.-.-.-.-.-.-X-X-.-.-.-.-.-.-.-.-.-.-.-.-.-.-.-.-.-.-.-.-,-,-,-.-.-.-.-.-.-.-.-.-.-.-.-.-E-.-.-,---,-.-.-E-.-X-----,-,-X-.-.-.-.-.-,-.-.-.-.-.-.-.-.-.-.-.-.-.-.-.-.-.-.-.-.-X-
X-.-.-.-.-.-.-.-,-.-.-.-.-.-.-.-.-.-.-.-.-.-.-.-,-X-,-.-.-.-.-.-.-.-.-.-.-.-.-.-.-.-.-.-.-.-,-,-,-.-.-.-.-.-.-.-.-.-.-.-.-.-.-.-.-,---,-.-.-.-.-X-,-,-X-X-.-.-.-.-.-.-,-.-.-.-.-.-.-.-.-.-.-.-.-.-.-.-.-.-.-.-.-X-
X-.-.-.-.-.-.-.-,-.-.-.-.-.-.-.-.-.-.-.-.-.-.-.-,-X-X-,-.-.-.-.-.-.-.-.-.-.-.-.-.-X-X-.-.-.-,-,-,-,-,-,-,-,-,-,-,-,-,-.-.-.-.-.-.-,---,-.-.-.-.-X-,-X-.-.-.-.-.-.-.-.-,-,-.-.-.-.-.-.-.-.-.-.-.-.-.-.-.-.-.-.-.-X-
X-.-.-.-.-.-.-.-,-.-.-.-.-.-.-.-.-.-.-.-.-.-.-.-.-,-,-,-,-.-.-.-.-.-.-.-.-.-.-.-,-X-X-.-.-.-,-,-.-.-.-.-.-.-.-,-,-,-,-,-,-,-,-,-,-,---,-.-.-.-.-X-,-X-.-.-.-.-.-.-.-.-.-,-.-.-.-.-.-.-.-.-.-.-.-.-.-.-.-.-.-.-.-X-
X-.-.-.-.-.-.-.-,-.-.-.-.-.-.-.-.-.-.-.-.-.-.-.-.-.-,-X-X-X-.-.-.-.-.-.-.-.-.-.-,-X-X-.-.-.-X-X-X-,-,-,-,-,-,-,-.-.-,---------------X-X-X-.-.-.-X-,-X-.-.-.-.-.-.-.-.-.-,-.-.-.-.-.-.-.-.-.-.-.-.-.-.-.-.-.-.-.-X-
X-.-.-.-.-.-.-.-,-.-.-.-.-.-.-.-.-.-.-.-.-.-.-.-.-.-.-.-X-X-X-X-.-.-.-.-.-.-.-.-,-.-,-.-.-.-X-,-X-,-,-E-,-,-,-,-.-.-,-,-,-,-,-,-,-,-X-,-X-.-.-.-X-,-X-.-.-.-.-.-.-.-.-.-,-.-.-.-.-.-.-.-.-.-.-.-.-.-.-.-.-.-.-.-X-
X-.-.-.-.-.-.-.-,-.-.-.-.-.-.-.-.-.-.-.-.-.-.-.-.-.-.-.-.-.-X-X-X-.-.-.-.-.-.-.-,-.-,-.-.-.-X-X-X-.-.-.-.-.-.-,-,-,-,-.-.-.-.-.-.-.-X-X-X-.-.-.-X-,-X-.-.-.-.-.-.-.-.-.-,-,-.-.-.-.-.-.-.-.-.-.-.-.-.-.-.-.-.-.-X-
X-.-.-.-.-.-.-.-,-.-.-.-.-.-.-.-.-.-.-.-.-.-.-.-.-.-.-.-.-.-.-X-X-.-.-.-.-.-.-.-,-X-X-.-.-.-.-.-.-.-.-.-.-.-.-.-.-.-.-.-.-.-.-.-.-.-.-.-.-.-.-.-X-,-X-.-.-.-.-.-.-.-.-.-.-,-.-.-.-.-.-.-.-.-.-.-.-.-.-.-.-.-.-.-X-
X-.-.-.-.-.-.-.-,-.-.-.-.-.-.-.-.-.-.-.-.-.-.-.-.-.-.-.-.-.-.-,-.-.-.-.-.-.-.-.-.-X-X-.-E-.-.-.-.-.-.-.-.-.-E-.-.-.-.-.-.-.-.-.-.-.-.-.-.-.-.-.-X-,-X-.-.-.-.-.-.-.-.-.-.-,-.-.-.-.-.-.-.-.-.-.-.-.-.-.-.-.-.-.-X-
X-.-.-.-.-.-.-,-,-.-.-.-.-.-.-.-.-.-.-.-.-.-.-.-.-.-.-.-.-.-.-X-X-,-,-,-,-,-,-.-.-X-X-.-.-.-.-.-.-.-.-.-.-.-.-,-,-,-,-.-.-.-.-.-.-.-.-.-.-.-.-.-X-,-X-.-.-.-.-.-.-.-.-.-.-,-.-.-.-.-.-.-.-.-.-.-.-.-.-.-.-.-.-.-X-
X-.-.-.-.-.-.-,-.-.-.-.-.-.-.-.-.-.-.-.-.-.-.-.-.-.-.-.-.-.-,-X-X-X-X-+-+-+-X-X-X-X-X-X-X-X-X-X-X-X-X-X-X-X-X-X-X-,-X-X-X-X-X-X-X-X-X-X-X-X-X-X-X-,-X-.-.-.-.-.-.-.-.-.-.-,-,-.-.-.-.-.-.-.-.-.-.-.-.-.-.-.-.-.-X-
X-.-.-.-.-.-.-,-.-.-.-.-.-.-.-.-.-.-.-.-.-.-.-.-.-.-.-.-,-X-X-,-,-,-X-+-+-+-X-,-,-,-,-,-,-,-,-,-,-X;X;X;,-----,-X-,-X-,-,-,-,-,-,-,-,-,-,-,-,-X-X-X-X-.-.-.-.-.-.-.-.-.-.-.-,-.-.-.-.-.-.-.-.-.-.-.-.-.-.-.-.-.-X-
X-.-.-.-.-.-.-,-.-.-.-.-.-.-.-.-.-.-.-.-.-.-.-.-.-.-.-,-X---,-X<X-XRXR.-.-.-X2X-X-X-X-X-X-X-X-X-X-.;.;.;X;----,-X-,-X-,-X-X-X-X-X-X-X-X-X-X-X-,-X-.-.-.-.-.-.-.-.-.-.-.-.-.-,-.-.-.-.-.-.-.-.-.-.-.-.-.-.-.-.-.-X-
X-.-.-.-.-.-,-,-.-.-.-.-.-.-.-.-.-.-.-.-.-.-.-.-.-.-,-X-----,-X<E-+R+R.-.-.-.2.-.-.-.-.-.-.-H-.-,-.;E;.;X;,-,-,-X-.-X-,-X-.-H-.-.-A-.-.-H-.-X---,-X-.-.-.-.-.-.-.-.-.-.-.-.-,-.-.-.-.-.-.-.-.-.-.-.-.-.-.-.-.-.-X-
X-.-.-.-.-.-,-.-.-.-.-.-.-.-.-.-.-.-.-.-.-.-.-.-.-,-X-------,-X<X-XRXR.-.-.-X2X-X-X-X-X-X-X-X-X-X-,;,;,;X;X-X-X-X-.-X-X-X-,-,-,-,-,-,-,-,-,-X-----,-X-.-.-.-.-.-.-.-.-.-.-.-,-,-.-.-.-.-.-.-.-.-.-.-.-.-.-.-.-.-X-
X-.-.-.-.-.-,-.-.-.-.-.-.-.-.-.-.-.-.-.-.-.-.-.-,-X-----,-,-X-X-X-X\X\.-.-.-X<X-X-,-,-------,-X-X-X;,;X;.-.-.-.-.-.-.-.-.-.-.-.-.-.-.-,-,-,-X-------X-.-.-.-.-.-.-.-.-.-.-.-.-,-.-.-.-.-.-.-.-.-.-.-.-.-.-.-.-.-X-
X-.-.-.-.-.-,-.-.-.-.-.-.-.-.-.-.-.-.-.-.-.-.-,-X-----,-,-X-,---,-+\+\.-.-.-,<,-.-X-X-------,-X-.-.-.-.-.-.-B-.-.-.-.-.-.-.-.-.-B-.-.-.-.-,-X-,-----,-X-.-.-.-.-.-.-.-.-.-.-.-,-.-.-.-.-.-.-.-.-.-.-.-.-.-.-.-.-X-
X-.-.-.-.-,-,-.-.-.-.-.-.-.-.-.-.-.-.-.-.-.-,-X-----,-,-X-.-,-E-X-X\X\.-.-.-X<X-.-E---X-----,-X-.-.-.-.-.-.-,-,-,-,-,-,-,-,-.-.-.-.-.-.-.-.-.-X-,-----X-.-.-.-.-.-.-.-.-.-.-,-,-.-.-.-.-.-.-.-.-.-.-.-.-.-.-.-.-X-
X-.-.-.-.-,-.-.-.-.-.-.-.-.-.-.-.-.-.-.-.-,-X-----,-,-X-.-,-X-,-X-X-X-,-,-,-X-X-,-X-----X---,-X-.-.-E-.-.-.-,-.-.-.-.-,-,-,-.-.-.-.-B-.-.-.-.-.-X-----,-X-.-.-.-.-.-.-.-.-.-,-.-.-.-.-.-.-.-.-.-.-.-.-.-.-.-.-.-X-
X-.-.-.-.-,-.-.-.-.-.-.-.-.-.-.-.-.-.-.-.-X-----,-,-X-,-,-X-X-X-.-.-.-.-,-+R+R.-,-X-X-----X-,-X-.-.-.-.-.-,-,-.-.-,-,-,-,-,-,-.-.-.-.-.-.-.-.-.-X-,-,-,-X-.-.-.-.-.-.-.-.-,-,-.-.-.-.-.-.-.-.-.-.-.-.-.-.-.-.-.-X-
X-.-.-.-.-,-.-.-.-.-.-.-.-.-.-.-.-.-.-.-,-X-----,-.-X-,-X-X-X-.-.-.-.-.-.-.-.-.-.-.-X-X-----X-X-,-,-,-,-,-,-.-.-,-,-.-.-.-.-,-,-.-.-.-.-.-.-E-.-X-X-X-X-X-.-.-.-.-.-.-.-.-,-.-.-.-.-.-.-.-.-.-.-.-.-.-.-.-.-.-.-X-
X-.-.-.-,-,-.-.-.-.-.-.-.-.-.-.-.-.-.-.-X-------X-X-.-E-,-X-.-.-H-.-.-.-.-.-.-.-H-.-X-----E-X-X-.-.-.-.-.-.-.-,-,-.-.-E-.-.-.-,-,-.-.-.-.-.-.-.-X-X-.-X-X-.-.-.-.-.-.-.-,-,-.-.-.-.-.-.-.-.-.-.-.-.-.-.-.-.-.-.-X-
X-.-.-.-,-.-.-.-.-.-.-.-.-.-.-.-.-.-.-.-X-----X---,-,-X-X-.-.-.-.-.-.-.-E-.-.-.-.-.-,-,-X-X-,-X-.-.-.-.-.-.-.-,-.-.-,-,-,-,-.-.-,-.-.-.-.-.-.-.-X-X-.-.-,-.-.-.-.-.-.-.-,-.-.-.-.-.-.-.-.-.-.-.-.-.-.-.-.-.-.-.-X-
X-.-.-.-,-.-.-.-.-.-.-.-.-.-.-.-.-.-.-.-X---X---------X-X-.-.-.-.-.-.-.-.-.-.-.-.-.-.-X-,---,-X-X-X-.-.-.-.-.-,-.-.-,-X-X-X-.-.-,-.-.-.-.-.-.-,-X-X-.-X-X-.-.-.-.-.-.-,-,-.-.-.-.-.-.-.-.-.-.-.-.-.-.-.-.-.-.-.-X-
X-.-.-.-,-,-.-.-.-.-.-.-.-.-.-.-.-.-.-.-X---X---X-X-X-X-X-.-.-.-.-.-.-.-.-.-.-.-.-.-.-.-X---,-X-X-X-.-.-.-.-.-,-.-E-,-X-X-,-.-.-,-.-.-.-.-.-.-,-X-X-E-X-X-.-.-.-.-.-.-,-.-.-.-.-.-.-.-.-.-.-.-.-.-.-.-.-.-.-.-.-X-
X-.-.-.-.-,-.-.-.-.-.-.-.-.-.-.-.-.-.-.-X---X---X-X4X-X-X-.-.-.-.-E-.-X-X-X-.-E-.-.-.-.-X-X-X-XUXTX-.-.-.-.-.-,-.-.-,-X-X-,-.-.-,-.-.-.-.-.-.-,-X-,-,-X-X-.-.-.-.-.-.-,-.-.-.-.-.-.-.-.-.-.-.-.-.-.-.-.-.-.-.-.-X-
X-.-.-.-.-,-,-.-.-.-.-.-.-.-.-.-.-.-.-.-X---X---X-X4E-,-.-.-.-.-.-.-.-X-,-X-.-.-.-.-.-.-,---E-H-.-.-.-.-.-.-.-,-.-.-,-X-X-,-.-.-,-.-.-.-E-.-.-<-X-,-,-.-,-.-.-.-.-.-.-,-.-.-.-.-.-.-.-.-.-.-.-.-.-.-.-.-.-.-.-.-X-
X-.-.-.-.-.-,-.-.-.-.-.-.-.-.-.-.-.-.-.-X---X---X-X4X-X-X-.-.-.-.-.-.-X2X-X2.-.-.-.-.-.-X-X-X-XUXTX-.-.-.-.-.-,-.-.-,-X-X-,-.-.-,-.-.-.-.-.-.-,-X-,-,-.-,-.-.-.-.-.-.-,-.-.-.-.-.-.-.-.-.-.-.-.-.-.-.-.-.-.-.-.-X-
X-.-.-.-.-.-,-,-.-.-.-.-.-.-.-.-.-.-.-.-X---X-------,-X-X-.-.-.-.-.-.2.-.-.2.-.-.-.-.-,-X---,-X-X-X-.-.-.-.-.-,-.-E-,-X-X-X-.-.-,-.-.-.-.-.-.-,-X-X-E-.-,-.-.-.-.-.-.-,-.-.-.-.-.-.-.-.-.-.-.-.-.-.-.-.-.-.-.-.-X-
X-.-.-.-.-.-.-,-.-.-.-.-.-.-.-.-.-.-.-.-X---X-X-,-,-,-X-X-,-.-.-.-.-.2.-.-.-.2.-.-.-.-X-X---,-X-.-.-.-.-.-.-.-,-.-.-,-X-X-X-.-.-,-.-.-.-.-.-.-.-X-X-H-X-X-.-.-.-.-.-.-,-.-.-.-.-.-.-.-.-.-.-.-.-.-.-.-.-.-.-.-.-X-
X-.-.-.-.-.-.-,-,-.-.-.-.-.-.-.-.-.-.-.-X-,-----X-X-.-,-,-,-.-.-A-.2.-.-.-.-.2.-A-.-,-,---X-X-X-.-.-.-.-.-.-.-,-,-.-B-.-.-.-.-,-,-.-.-.-.-.-.-.-X-X-X-X-X-.-.-.-.-.-.-,-.-.-.-.-.-.-.-.-.-.-.-.-.-.-.-.-.-.-.-.-X-
X-.-.-.-.-.-.-.-,-.-.-.-.-.-.-.-.-.-.-.-.-X-------X-,-E-X-X-,-,-.-.2.-.-.-.-.-.2.-.-X-X---X-,-X-.-.-.-.-.-.-.-.-,-,-.-.-.-E-,-,-.-.-.-.-.-.-.-.-X-----,-X-.-.-.-.-.-.-,-.-.-.-.-.-.-.-.-.-.-.-.-.-.-.-.-.-.-.-.-X-
X-.-.-.-.-.-.-.-,-.-.-.-.-.-.-.-.-.-.-.-.-X-,-----,-X-----X-X-X-,2,-,-,-,-,-.-.2,-X-X-----X-,-X-,-.-.-.-.-.-.-.-.-,-,-,-,-,-,-.-.-.-.-.-.-.-E-.-X---,-,-X-.-.-.-.-.-.-,-.-.-.-.-.-.-.-.-.-.-.-.-.-.-.-.-.-.-.-.-X-
X-.-.-.-.-.-.-.-,-.-.-.-.-.-.-.-.-.-.-.-.-.-X---------X---,-X-,-,2X-,-.-.-,-,-X-,2X-----X---,-X-,-.-.-.-.-.-.-.-.-.-.-.-,-,-.-.-.-.-.-.-.-.-.-.-X---,-.-X-.-.-.-.-.-,-,-.-.-.-.-.-.-.-.-.-.-.-.-.-.-.-.-.-.-.-.-X-
X-.-.-.-.-.-.-.-,-.-.-.-.-.-.-.-.-.-.-.-.-.-X-,---------X-----,-X-X-X-X-.-X-X-X-------X-----,-X-,-,-,-,-,-,-,-,-,-,-,-,-,-,-.-.-.-.-B-.-.-.-.-,-X-,-,-X-.-.-.-.-.-.-,-.-.-.-.-.-.-.-.-.-.-.-.-.-.-.-.-.-.-.-.-.-X-
X-.-.-.-.-.-.-.-,-.-.-.-.-.-.-.-.-.-.-.-.-.-.-X-,---------X-X-E-----X-X-.-X-------E-X-------,-X-.-.-.-.-.-.-.-.-.-.-.-.-.-.-.-.-.-.-.-.-.-.-.-X---,-.-X-.-.-.-.-.-,-,-.-.-.-.-.-.-.-.-.-.-.-.-.-.-.-.-.-.-.-.-.-X-
X-X-X-X-X-X-X-X-X-.-.-.-.-.-.-.-.-.-.-.-.-.-.-.-X-,-----------X-----X-X-E-X-----X-X---------,-X-.-.-B-.-.-.-.-.-.-.-.-.-.-.-.-.-.-.-.-.-B-.-,-X-,-,-X-.-.-.-.-.-.-,-.-.-.-.-.-.-.-.-.-.-.-.-.-.-.-.-.-.-.-.-.-.-X-
----:-:-:---,-.-X-.-.-.-.-.-.-.-.-.-.-.-.-.-.-.-.-X-,---------X-----X-X5X5X5----X---------,-,-,-X-X-.-.-.-E-.-.-.-E-.-.-.-.-.-.-.-.-.-.-.-,-X-,-,-X-.-.-.-.-.-.-,-,-.-.-.-.-.-.-.-.-.-.-.-.-.-.-.-.-.-.-.-.-.-.-X-
--:-----:-,-,-X-.-.-.-.-.-.-.-.-.-.-.-.-.-.-.-.-.-.-X-,-------X-X---------------X-------,-,-X-,---,-X-X-X-X-X-X-X-X-X-X-X-X-X-X-X-X-X-X-X-X-,-,-X-.-.-.-.-.-.-.-,-.-.-.-.-.-.-.-.-.-.-.-.-.-.-.-.-.-.-.-.-.-.-.-X-
:-:-:-:-:-,-.-X-.-.-.-.-.-.-.-.-.-.-.-.-.-.-.-.-.-.-.-X-,---------X-X-X-X-X-X-X-----,-,-,-X-.-X-,-,---------X-X-X-------X-X-X-X-X---------,-,-X-.-.-.-.-.-.-.-,-,-.-.-.-.-.-.-.-.-.-.-.-.-.-.-.-.-.-.-.-.-.-.-.-X-
----:-:-:-,-X-.-.-.-.-.-.-.-.-.-.-.-.-.-.-.-.-.-.-.-.-.-X-,-,-------------------,-,-,-X-X-.-.-.-X-,-,-,-----X-H-E-------E-------X-----,-,-X-X-.-.-.-.-.-.-.-,-,-.-.-.-.-.-.-.-.-.-.-.-.-.-.-.-.-.-.-.-.-.-.-.-.-X-
----------,-X-.-.-.-.-.-.-.-.-.-.-.-.-.-.-.-.-.-.-.-.-.-.-X-X-,-,-,-,-,-,-,-,-,-,-X-X-.-.-.-.-.-.-X-X-,-,-,-X-X-,-,-,-X-X-X-,-X-X-,-,-X-X-.-.-.-.-.-.-.-.-,-,-.-.-.-.-.-.-.-.-.-.-.-.-.-.-.-.-.-.-.-.-.-.-.-.-.-X-
----------,-X-.-.-.-.-.-.-.-.-.-.-.-.-.-,-,-,-.-.-.-.-.-.-.-.-X-X-X-X-X-X-X-X-X-X-.-.-.-.-.-.-.-.-.-.-X-X-X-X-X-.-.-.-X-X-X-.-X-X-X-X-.-.-.-.-.-.-.-.-.-,-,-.-.-.-.-.-.-.-.-.-.-.-.-.-.-.-.-.-.-.-.-.-.-.-.-.-.-X-
----------,-X-.-.-.-.-.-.-.-.-.-.-.-.-,-,-.-,-,-.-.-.-.-.-.-.-.-.-.-.-.-.-.-.-.-.-.-.-.-.-.-.-.-.-.-.-.-.-.-.-.-.-.-.-.-.-.-.-.-.-.-.-.-.-.-.-.-.-.-.-,-,-.-.-.-.-.-.-.-.-.-.-.-.-.-.-.-.-.-.-.-.-.-.-.-.-.-.-.-X-
----------,-X-.-.-.-.-.-.-.-.-.-.-.-.-,-X-.-.-,-,-.-.-.-.-.-.-.-.-.-.-.-.-.-.-.-.-.-.-.-.-.-.-.-.-.-.-.-.-.-.-.-.-.-.-.-.-.-.-.-.-.-.-.-.-.-.-.-.-.-,-,-.-.-.-.-.-.-.-.-.-.-.-.-.-.-.-.-.-.-.-.-.-.-.-.-.-.-.-.-X-
----,-,-,-,-X-.-.-.-.-.-.-.-.-.-.-.-.-X-X-.-.-.-,-,-.-.-.-.-.-.-.-.-.-.-.-.-,-,-,-.-.-.-.-.-.-.-.-.-.-.-.-.-.-.-.-.-.-.-.-.-.-.-.-.-.-.-.-.-.-.-.-,-,-.-.-.-.-.-.-.-.-.-.-.-.-.-.-.-.-.-.-.-.-.-.-.-.-.-.-.-.-.-X-
----,-X-X-X-X-X-X-X-X-,-X-X-X-.-.-.-.-X-X-.-.-.-.-,-,-.-.-.-.-.-.-.-.-.-,-,-,-.-,-,-,-.-.-.-.-.-.-.-.-.-.-.-.-.-.-.-.-.-.-.-.-.-.-.-.-.-.-.-.-.-,-,-.-.-.-.-.-.-.-.-.-.-.-.-.-.-.-.-.-.-.-.-.-.-.-.-.-.-.-.-.-.-X-
----,-X-<-.-.-.-.-.-.-.-.-X-X-.-.-.-X-,-X-.-.-.-.-.-,-,-.-.-.-.-.-.-,-,-,-.-.-.-.-.-,-,-,-,-,-,-,-.-.-.-.-.-.-.-.-.-.-.-.-.-,-,-,-,-,-,-,-,-,-,-,-.-.-.-.-.-.-.-.-.-.-.-.-.-.-.-.-.-.-.-.-.-.-.-.-.-.-.-.-.-.-.-X-
----,-X-.-.-.-.-A-.-A-.-A-X-X-W-,-,-X-,-X-.-.-.-.-.-.-,-,-.-.-.-,-,-,-.-.-.-.-.-.-.-.-.-.-.-.-.-,-,-,-.-.-.-.-.-.-.-.-.-,-,-,-.-.-.-.-.-.-.-.-.-.-.-.-.-.-.-.-.-.-.-.-.-.-.-.-.-.-.-.-.-.-.-.-.-.-.-.-.-.-.-.-.-X-
----,-X-<-.-.-.-.-.-.-.-.-X-X-,-X-X---,-X-.-.-.-.-.-.-.-,-,-,-,-,-.-.-.-.-.-.-.-.-.-.-.-.-.-.-.-.-.-,-,-,-.-.-.-.-.-,-,-,-.-.-.-.-.-.-.-.-.-.-.-.-.-.-.-.-.-.-.-.-.-.-.-.-.-.-.-.-.-.-.-.-.-.-.-.-.-.-.-.-.-.-.-X-
----,-X-<-,-.-.-A-.-A-.-A-X-X-X-------,-X-.-.-.-.-.-.-.-.-,-,-.-.-.-.-.-.-.-.-.-.-.-.-.-.-.-.-.-.-.-.-.-,-,-,-.-,-,-,-.-.-.-.-.-.-.-.-.-.-.-.-.-.-.-.-.-.-.-.-.-.-.-.-.-.-.-.-.-.-.-.-.-.-.-.-.-.-.-.-.-.-.-.-.-X-
----,-X---,-,-.-.-.-.-.-.-X-----------,-X-.-.-.-.-.-.-.-.-.-.-.-.-.-.-.-.-.-.-.-.-.-.-.-.-.-.-.-.-.-.-.-.-.-,-,-,-.-.-.-.-.-.-.-.-.-.-.-.-.-.-.-.-.-.-.-.-.-.-.-.-.-.-.-.-.-.-.-.-.-.-.-.-.-.-.-.-.-.-.-.-.-.-.-X-
----,-X-<---,-,-A-.-A-.-A-X-----------,-X-.-.-.-.-.-.-.-.-.-.-.-.-.-.-.-.-.-.-.-.-.-.-.-.-.-.-.-.-.-.-.-.-.-.-.-.-.-.-.-.-.-.-.-.-.-.-.-.-.-.-.-.-.-.-.-.-.-.-.-.-.-.-.-.-.-.-.-.-.-.-.-.-.-.-.-.-.-.-.-.-.-.-.-X-
------X-X-X-X-X-X-X-X-X-X-X-----------,-X-.-.-.-.-.-.-.-.-.-.-.-.-.-.-.-.-.-.-.-.-.-.-.-.-.-.-.-.-.-.-.-.-.-.-.-.-.-.-.-.-.-.-.-.-.-.-.-.-.-.-.-.-.-.-.-.-.-.-.-.-.-.-.-.-.-.-.-.-.-.-.-.-.-.-.-.-.-.-.-.-.-.-.-X-
--------------------------------------,-X-.-.-.-.-.-.-.-.-.-.-.-.-.-.-.-.-.-.-.-.-.-.-.-.-.-.-.-.-.-.-.-.-.-.-.-.-.-.-.-.-.-.-.-.-.-.-.-.-.-.-.-.-.-.-.-.-.-.-.-.-.-.-.-.-.-.-.-.-.-.-.-.-.-.-.-.-.-.-.-.-.-.-.-X-
--------------------------------------,-X-.-.-.-.-.-.-.-.-.-.-.-.-.-.-.-.-.-.-.-.-.-.-.-.-.-.-.-.-.-.-.-.-.-.-.-.-.-.-.-.-.-.-.-.-.-.-.-.-.-.-.-.-.-.-.-.-.-.-.-.-.-.-.-.-.-.-.-.-.-.-.-.-.-.-.-.-.-.-.-.-.-.-.-X-
--------------------------------------,-X-X-X-X-X-X-X-X-X-X-X-X-X-X-X-X-X-X-X-X-X-X-X-X-X-X-X-X-X-X-X-X-X-X-X-X-X-X-X-X-X-X-X-X-X-X-X-X-X-X-X-X-X-X-X-X-X-X-X-X-X-X-X-X-X-X-X-X-X-X-X-X-X-X-X-X-X-X-X-X-X-X-X-X-X-
