------------------------------------------------------------------------------X-X---------X-X-X-X-------------X-X-X---------------------------------------------------------
----------------------------------------------------------------------------X-,-,-X-X-X-X-,-------X-X-X-X-X-X-------X-------------------------------------------------------
--------------------------------------------------------------------------X-,-X-X-,-,-,-X-X-,-,-,-,-,-,-,-,-,-,-,-,---X-----------------------------------------------------
--------------------------------------------------------------------------X-,-X-X-.-.-.-X:X-.-.-.-.-.-.-.-.-.-.-.-,-,---X---------------------------------------------------
----------------------------------------------------------------------------X-,-.-.-.-.-t:,-.-.-.-.-.-.-.-.-.-.-.-.-,-X-----------------------------------------------------
----------------------------------------------------------------------------X-,-.-.-.-.-t:,-.-.-E-.-.-.-E-.-.-.-E-.-,-X-----------------------------------------------------
----------------------------------------------------------------------------X-,-.-.-.-.-t:,-.-.-.-.-.-.-.-.-.-.-.-,-,-X-----------------------------------------------------
--------------------------------------------------------------------------X-,-X-X:t:t:t:X:X-,-,-,-,-,-,-,-,-,-,-,-,---X-----------------------------------------------------
--------------------------------------------------------------------------X-,-X-X-,-,-,-X-X-----------------------------X---------------------------------------------------
--------------------------------------------------------------------------X---,-,-,-,-,-,---<---------------------------X---------------------------------------------------
--------------------------------------------------------------------------X---,-,-.9.9,9,-------------------------------X---------------------------------------------------
--------------------------------------------------------------------------X---,-,-.9E9,9,-------------------------------X---------------------------------------------------
----------------------------------------------------------------------------X-,-,-,9,9,9,-----------------------------X-----------------------------------------------------
----------------------------------------------------------------------------X-,-,-,-,-,-,-----------------------------X-----------------------------------------------------
----------------------------------------------------------------------------X-,-,-.8.8,8,-----------------------------X-----------------------------------------------------
------------------------------------------------------------------------------X-,-.8E8,8,-----------E-----------------X-----------------------------------------------------
------------------------------------------------------------------------------X-,-,8,8,8,-------------------------------X---------------------------------------------------
----------------------------------------------------------------------------X-,-,-,-,-,-,-------------------------------X---------------------------------------------------
--------------------------------------------------------------------------X---,-,-.7.7,7,-------------------------------X---------------------------------------------------
----------------------------------------------------------,-,-,-,-,-,-----X---,-,-.7E7,7,-------------------,-,-------X-----------------------------------------------------
--------------------------------------------------------,-,-X-X-X-X-X-,-,-,-X-,-,-,7,7,7,---------------,-,-,-,-------X-----------------------------------------------------
------------------------------------------------------,-,-X-.-A-.-A-.-X-X-,-X-,-,-,-,-,-------------,-,-,-.-.-,-,---X-------------------------------------------------------
----------------,-,-,-------------------------------,-,-X-.-.-.-.-E-.-.-X-X-.-.-,-,-,-----------X-X-X-X-.-.-.-.-X-X-X-------------------------------------------------------
------------,-,-,-X-X-,-----------------------------,-X-.-A-.-A-.-,-A-,-.-.-.-.-.-,-X-----X-X-X-------X-.-.-.-.-,-X---------------------------------------------------------
------,-,-,-,-X-X-.-.-X-,-------,-,-,---------------,-X-.-.-E-.-.-A-.-,-X-X-X-X-X-X-X---X-------------,-X-.-.-.-.-X---------------------------------------------------------
------,-X-X-X-.-.-.-.-.-X-,-,-,-,-X-X-,-,-------------,-X-.-.-A-.-,-,-,-X-X-X-X-X-,-,-X-----------------X-.-.-.-.-,-X-------------------------------------------------------
----,-,-X-.-.-.-.-.-.-.-.-X-,-X-X-.-.-X-X-,-,-,-,-,-,-,-X-.-.-.-A-.-,-,-.-.-.-.-.-X-X-,-,---------------,-X-.-.-.-.-X-------------------------------------------------------
----,-X-.-,-,-,-,-,-,-.-.-.-X-.-.-.-.-A-,-X-X-X-X-X-X-X-X-,-.-.-.-,-,-.-.-.-.-.-.-.-.-X-X-,---------------X-.-.-.-.-,-X-----------------------------------------------------
--,-,-X-.-X-X-,-,-,-X-X-.-.-.-.-.-.-.-,-K-,-.-,-.-.-.-.-.-,-,-,-,-,-.-.-.-.-.-.-.-.-.-.-.-X-------------,-,-X-.-.-A-,-X-----------------------------------------------------
--,-X-.-.-X-X-.-.-.-X-X-.-.-.-.-E-.-.-,-,-,-,-,-.-.-.-.-.-.-.-,-,-.-.-.-.-.-.-.-.-.-.-.-.-X-,-------,-,-,-X-.-.-.-,-X-------------------------------------------------------
--,-X-.-.-,-.-.-.-.-,-.-.-.-.-.-.-.-.-A-.-.-,-.-.-.-.-.-.-.-.-.-.-.-.-.-.-.-.-.-.-.-.-.-.-.-X-----,-,-X-X-.-.-,-X-X---------------------------------------------------------
--,-X-.-.-,-.-.-t:.-,-.-.-.-.-.-.-,-,-,-,-,-,-.-.-.-.-.-.-.-.-.-.-.-.-.-.-.-.-.-.-.-.-.-.-.-X---,-,-X-.-.-.-,-X-------------------------------------------------------------
--,-X-.-.-,-.-.-.-.-,-.-.-.-.-.-,-,-.-.-.-.-.-.-.-.-.-.-.-.-.-.-.-.-.-.-.-.-.-.-.-.-.-.-.-.-X---,-X-.-+^.>+^X---------------------------------------------------------------
,-,-X-.-.-X-X-,-,-,-X-X-.-.-.-.-,-.-.-.-.-.-.-.-.-.-.-.-.-.-.-.-.-.-.-.-,-,-,-,-,-,-,-,-,-,-X---,-X9,9,9,9,9X9,-------------------------------------------------------------
,-X-.-.-.-X-X-.-.-.-X-X-.-.-.-.-,-.-.-.-.-.-.-.-.-.-.-.-.-.-.-.-.-.-.-.-,-.-.-.-.-.-.-.-.-,-X-,-,-X-.-.-.-.-X-X>------------------------------------------------------------
X-.-.-.-.-.-.-.-.-.-.-.-.-.-.-.-,-,-.-.-.-.-.-.-.-.-.-.-.-.-.-.-.-.-.-.-,-.-,-,-,-,-,-,-,-,-X7X-X-X8.-.-.-.-.-X>------------------------------------------------------------
,-X-.-.-.-.-.-.-.-.-.-.-.-.-.-.-.-,-.-.-.-.-.-.-.-.-.-.-.-.-.-.-.-.-.-.-,-.-,-.-.-.-.-.-.-,-.7,-.-,8.-.-.-.-X-X>------------------------------------------------------------
--,-X-.-.-.-.-.-.-.-.-.-E-.-.-.-.-,-,-.-.-.-.-.-.-.-.-.-.-.-.-.-.-.-.-.-,-.-,-.-,-,-,-,-,-,-X7X-X-X8.-.-.-.-X---------------------------------------------------------------
----,-X-.-.-.-.-.-.-.-.-.-.-.-.-.-.-,-,-,-,-,-.-.-.-.-.-.-.-.-.-.-.-.-.-,-.-,-.-,-.-.-.-.-.-X---,-X-.-.-.-.-X---------------------------------------------------------------
------,-X-.-.-.-.-.-.-.-.-.-.-.-.-.-.-.-.-.-,-,-,-.-.-.-.-.-.-.-.-.-.-.-,-.-,-.-,-.-.-.-.-.-X---,-X-.-.-.-+_X---------------------------------------------------------------
------,-X-.-.-.-.-.-.-.-.-.-.-.-.-.-.-.-.-.-.-.-,-,-,-.-.-.-.-.-.-.-.-.-,-.-,-.-,-.-.-.-.-.-X-,-,-X-.-.-.-+_X-,-,-,---------------------------------------------------------
------,-X-.-.-.-.-.-.-.-.-.-.-.-.-.-.-.-H-.-.-.-.-.-,-,-.-.-.-.-.-.-.-.-,-.-,-.-,-.-.-.-.-.-X-X-X`X`.-.-.-.-X-X-X-X?--------------------------------------------------------
------,-X-.-.-.-.-.-.-.-.-.-.-.-.-.-.-.-.-.-.-.-.-.-.-,-,-.-.-.-.-.-.-.-,-.-,-.-,-.-.-.-.-.-X-E-+`+`.-.-.-.-.-.-E-X?--------------------------------------------------------
------,-X-.-.-.-.-.-.-.-.-.-.-.-.-.-.-.-.-.-.-.-H-.-.-.-,-X-X-.-.-.-X-,-,-.-,-.-,-.-.-.-.-.-X-,-+`+`.-.-.-.-.-.-.-X?--------------------------------------------------------
------,-X-.-.-.-.-.-.-.-.-.-.-,-X-X-X-X-X-X-.-.-.-.-.-,-X-,-X-.-.-.-X-X-.-.-,-.-,-,-,-,-,-,-X-E-+`+`.-.-.-.-.-.-E-X?--------------------------------------------------------
------,-X-X-.-.-.-.-.-,-X-X-X-X-----------,-X-X-.-,-X-X---,-X-.-.-X-X-X-,-,-,-.-.-.-.-.-.-.-X-X-X`X`.?.?.?.?X?X-X-X?--------------------------------------------------------
----------,-X-X-.-,-X-X-----------------------,-X-X-------,-X-.-.-X-,-X-.-.-.-.-.-.-.-.-.-.-X---,-X@.@.@.@.@X@--------------------------------------------------------------
--------------,-X-X-,-,-,-,-,-,-,-,-,-,-,-,-,-,-,-,-,-,-,-,-X-.-.-X-,-X-H-.-.-.-.-.-E-.-.-A-X---,-X-.-.-.-.-X---------------------------------------------------------------
------------------,-X-X-X-X-X-X-X-X-X-X-X-X-X-X-X-X-X-X-X-X-X-.-.-X-X-X3.-.-.-.-.-.-.-.-.-.-X---,-X-,-,-,-,-X---------------------------------------------------------------
------------------,-X-.-.-.-.-.-.-.-.-.-.-.-.-.-.-.-.-.-.-<-.-.-.-.-E-X3X-.-.-.-.-.-.-.-.-.-X-----X---------X---------------------------------------------------------------
------------------,-X-.-.-.-.-.-.-.-.-.-.-.-.-.-.-.-.-+S+S.-.-.-.-X-X-X3X-.-.-.-.-.-.-.-.-A-X-----X---------X---------------------------------------------------------------
------------------,-X-.-.-X-X-X-X-X-X-X-X-X-X-X-X-X-X-X-X-X-X-.-.-X-,-X-X-X-X-X-X-X-X-,-X-X-X-----X-A-----A-X---------------------------------------------------------------
------------------,-X-.-.-X-------------------,-,-,-,-,-,-,-X-.-.-X-,-,-,-,-,-,-,-,-X-+-X-,-,-----X-,-,-,-,-X---------------------------------------------------------------
------------------,-X-.-.-X---------X-X-X-X-X-X-X-X-X-X-X-X-X-.-.-X-X-X-X-X-X-X-X-X-X-.-X-X-X---,-X-.-.-.-,-X---------------------------------------------------------------
------------------,-X-.-.-X---------X-----------,-.-.-.-.-,-.-.-.-,-,-.-.-.-,-.-.-.-.-.-.-H-X---,-X-,-,-,-,-X---------------------------------------------------------------
------------------,-X-.-.-X---------X-------X-X-,-.-.-.-.-,-.-.-.-,-,-.-.-.-,-.-.-X-X-.-.-.-X---,-X-X-.-.-X-X---------------------------------------------------------------
------------------,-X-.-.-X---------X-------X-X-,-.-.-.-.-,-,-,-H-,-,-.-.-.-,-.-.-X-X-.-.-.-X---,-X-X-.-.-X-X---------------------------------------------------------------
------------------,-X-.-.-X---------X---E-------,-.-.-.-.-.-.-.-.-.-.-.-.-.-,-.-.-.-.-.-E-.-X---,-X-X-.-.-X-X---------------------,-,-,---,-,-,-----------------------------
------------------,-X-.-.-X---------X-----------,-.-.-.-.-.-.-.-.-.-.-.-.-.-,-.-.-.-.-.-.-.-X-----,-X-.-.-X-----------,-,-,-,-,-,-X-X-,-,-X-X-X-,---------------------------
------------------,-X-.-.-X---------X-----------,-.-.-.-.-.-.-.-E-.-.-.-.-.-,-.-.-.-.-.-.-.-X-----,-X-.-.-X---------,-,-X-X-X-X-X-.-.-X-X-.-.-.-X-,-,-,---------------------
------------------,-X-.-.-X---------X-----------,-.-.-.-.-.-.-.-.-.-.-.-.-.-,-.-.-.-.-.-.-.-X-----,-X-.-.-X---------,-X-.-.-.-,-,-.-.-.-.-.-.-.-.-X-X-X---------------------
------------------,-X-.-.-X---------X---E---X-X-,-.-.-.-.-.-.-.-.-.-.-.-.-.-,-.-.-X-X-.-E-.-X-----,-X-.-.-X-,-,-,-,-,-X-X-.-.-,-.-.-.-.-.-.-.-.-.-.-.-X---------------------
------------------,-X-.-.-X---------X-------X-X-,-.-.-.-.-.-.-.-.-.-.-.-.-.-,-.-.-X-X-.-.-.-X-----,-X-,-,-X1X-X-X-X-X-X-X-.-.-,-.-.-.-.-.-.-.-.-.-.-.-,-X-------------------
------------------,-X-.-.-X-------,-X-,-,-,-,-,-,-.-.-.-.-,-,-,-,-,-,-.-.-.-,-,-.-.-.-.-.-.-X-----,-X-.-.-.1.-.-.-.-.-,-.-.-.-,-.-.-.-.-.-.-.-.-E-.-.-.-X-------------------
------------------,-X-.-.-X-------,-X-,-,-,-,-X-X-X-X-X-X-X-X0.0.0.0X0X-X-X-X-X-X-X-,-,-,-,-X-----,-X-,-,-,1.-.-.-.-,-,-.-.-.-,-.-.-.-.-.-.-.-.-.-.-.-.-X-------------------
------------------,-X-.-.-X-------,-X-.-.-.-.-X-X-X-X-X-X-X-X0,0,0,0X0X-X-X-X-X-X-X---------X-----,-X-.-.-X1X-X-X-X-X-X-X-.-.-,-.-.-.-.-E-.-.-.-.-.-.-.-X-------------------
------------------,-X-.-.-X-------,-X-.-.-.-.-,-.-.-.-.-.-.-.-.-.-.-.-.-.-.-.-H-.-,---------X-,-,-,-XQ+Q.-X-,-,-,---,-X-.-.-.-,-.-.-.-.-.-.-.-.-.-.-.-.-X-------------------
------------------,-X-.-.-X-------,-X-.-.-E-.-X-X-.-.-.-E-.-.-.-.-.-.-.-E-.-.-,-X-X---E-----X-,-X-X-X-.-.-X-X-X-X-----X-.-.-.-,-.-.-.-.-.-.-.-.-.-.-.-.-X-------------------
------------------,-X-.-.-X-------,-X-H-.-.-,-X-X-.-.-.-.-.-.-.-.-.-.-.-.-.-.-.-X-X-------A-X-,-X-X-X-,-,-X-.-.-X-,-,-,-X-.-.-,-.-.-.-.-.-.-.-.-.-.-.-.-X-------------------
------------------,-X-.-.-X-------,-X-X-,-X-X-X-.-.-.-.-.-.-.-.-E-.-.-.-.-.-.-.-.-X-X-,-X-X-X-,-X-.-.-.-.-.-,-,-X-X-X-,-,-X-.-,-,-.-.-.-.-.-.-.-E-.-,-X-,-------------------
------------------,-X-.-.-X-------,-X-X-.-X-X-,-,-,-,-,-.-.-.-.-.-.-.-.-.-.-.-.-.-.-X-.-X-X-X-X-X-.-.-.-,-,-,-.-.-.-.-X-X-,-X-.-,-.-.-.-.-.-.-.-.-,-,-X---------------------
------------------,-X-.-.-X-------,-X-.-.-,-,-,-.-.-.-,-,-,-,-,-.-.-.-.-.-,-,-,-,-.-.-.-.-,-,-,-.-.-,-,-,-.-.-.-.-.-.-.-.-X-X-X-,-,-,-.-.-.-.-.-.-,-.-X---------------------
--------------,-,-,-X-.-.-X-,-,---,-X-,-,-,---,-.-.-.-,-.-.-.-,-,-,-.-,-,-,-.-.-,-,-,-,-,-,-X-X-X-,-,-.-.-.-.-.-.-.-.-.-.-.-X-X-.-.-,-,-,-,-,-,-,-,-.-,-X-------------------
------------,-,-X-X-X-.-.-X-X-,-,-X-X-,-------,-.-.-.-,-.-.-.-.-.-,-,-,-.-.-.-.-.-.-.-.-,-,-X-X-X-.-.-.-.-.-.-.-.-.-.-.-.-.-X-X-A-,-,-,-,-.-.-.-.-.-.-H-X-------------------
----------,-,-X-.-.-X-.-.-X-X-X-X-.-,---------,-.-.-.-,-.-.-.-.-.-.-.-.-.-.-.-.-.-.-.-.-.-.-.-.-.-.-.-.-.-.-.-.-.-.-.-.-.-.-X-,-X-X-.-.-X-.-X-,-,-X-X-,-X-------------------
----------,-X-.-.-.-X-.-.-X-X-.-.-.-,---------,-.-.-.-,-.-.-.-.-.-.-.-.-.-.-.-.-.-.-.-.-.-.-.-.-.-.-.-.-.-.-.-.-.-.-.-.-.-.-X-,-X-X-.-.-X-X-X-----X-X-X---------------------
----------,-X-.-.-.-.-.-.-.-.-.-.-.-,---------,-.-.-.-,-.-.-.-.-.-.-.-.-.-.-.-.-.-.-.-.-.-.-.-.-.-.-.-.-.-.-.-.-.-.-.-.-.-.-X---,-X-.-.-X---X-----X-------------------------
----------,-X-.-.-.-.-.-.-.-.-.-.-.-,---------,-.-.-.-,-.-.-.-.-.-.-.-.-.-.-.-.-.-.-.-.-.-.-.-.-.-.-.-.-.-.-.-,-,-,-,-.-,-X-X---,-X-.-.-X---X-----X-------------------------
----------,-X-.-.-.-.-.-.-.-.-.-.-.-,---------,-.-.-.-,-.-.-.-.-.-.-.-.-,-,-,-,-.-.-.-.-.-.-.-.-.-.-.-.-,-,-,-,-.-.-X-X-X-------,-X-.-.-X---X-----X-------------------------
----------,-X-.-.-.-.-.-.-.-.-,-X-X-X---------,-.-.-,-,-,-.-.-.-.-,-,-,-,-.-.-,-,-,-.-.-.-.-.-.-.-.-,-,-,-.-.-.-.-.-X-,---------,-X-.-.-X---X-----X-------------------------
----------,-X-.-.-.-.-.-.-.-,-X-----X---------,-,-.-,-.-,-,-,-,-,-,-.-.-.-.-.-.-.-,-,-,-,-,-.-.-.-,-,-.-.-.-.-.-.-.-.-X---------,-X-.-.-X---X-----X-------------------------
----------,-X-.-.-.-.-.-.-.-X-----X-------------,-,-,-,-,-,-.-.-.-.-.-.-.-.-.-.-.-.-.-.-.-,-X-X-X-X-X-.-.-.-.-.-.-.-.-X-,-------,-X-.-.-X---X-----X-------------------------
------------X-.-.-.-.-.-.-X-,-----X-----------------------,-.-.-.-.-.-.-.-.-.-.-.-.-.-.-.-.-.-X-,-,-X-.-.-.-.-.-.-.-.-.-X-------,-X-.-.-X---X-----X-------------------------
------------,-X-.-.-.-.-.-X-----X-------------------------,-.-.-H-.-H-.-.-.-.-.-.-.-.-.-.-.-.-.-X-,-X-.-.-.-.-.-E-.-.-,-X-------,-X-.-.-X---X-----X-------------------------
--------------X-.-.-.-.-X-,-----X-------------------------,-.-.-.-.-.-.-.-.-.-.-.-.-.-.-.-.-.-.-.-X-,-X-.-.-.-.-.-.-.-X---------,-X-.-.-X---X-----X-------------------------
------------,-,-X-.-.-.-X-------X-------------------------,-.-.-.-.-.-.-.-.-.-.-.-.-.-.-.-.-.-.-.-.-X-,-X-.-.-.-.-.-,-X---------,-X-.-.-X---X-----X-------------------------
------------,-.-X-.-.-.-,-X-------X-----------------------,-.-.-.-.-.-.-.-.-.-.-E-.-.-A-.-.-.-.-.-.-.-X-,-X-H-,-,-H-X-----------,-X-.-.-X---X-----X-------------------------
----------,-,-X-.-.-.-.-.-X-------X-----------------------,-.-.-.-.-.-.-.-.-.-.-.-.-.-.-.-.-.-.-.-.-.-X---,-X-X/./X/X-------,-,-,-X-.-.-X-,-X-----X-,-,-,-,-,-,-,-----------
----------,-.-X-.-.-.-.-.-,-X-----X-----------------------,-.-.-.-.-.-.-.-.-.-.-.-.-.-.-.-.-.-.-.-.-.-X---,-,-X/./X/,-------,-X-X-X-.-.-X-X-X-,-,-X-X-X-X-X-X-X-X-,-,-------
----------,-X-.-.-.-.-.-.-.-X-----X-----------------------,-.-.-.-.-.-.-.-.-.-.-.-.-.-.-.-.-.-.-.-.-.-X-,-,-X-X/,/X/X-,-,---,-X-X-X-,-,-X-.-X-.-.-X-X-,-.-.-.-.-.-X-X-,-----
------------X-.-.-.-.-.-.-,-X-,-,-,-X---------------------,-,-,-,-.-.-.-.-.-.-.-.-.-.-.-.-.-E-.-.-.-.-X-,-X-.-.-.-.-.-X-X---,-X-.-.-.-.-,-.-,-.-.-.-.-,-.-.-.-.-.-.-.-X-,---
------------,-X-.-.-.-.-,-,-X-X-X-X-X-,-------------------,-.-.-,-.-.-.-.-.-.-.-.-.-.-.-.-.-.-.-.-.-.-X-,-X-.-.-E-.-.-H-X---,-X-.-.-.-.-,-.-,-.-.-.-.-,-,-.-.-.-.-.-.-.-X-,-
--------------X-.-.-.-.-,-.-,-,-,-.-,-,-------------------,-.-.-,-.-.-.-.-.-E-.-.-W-.-.-.-.-.-.-.-.-.-X-,-X-.-.-.-.-.-.-X---,-X-.-.-.-.-,-.-,-.-.-.-.-.-,-.-.-.-.-.-.-.-.-X-
--------------,-X-.-.-.-,-.-,-.-,-.-,-,-,-----------------,-.-,-,-.-.-.-.-.-.-.-.-.-.-.-.-.-.-.-.-.-,-X-,-X-.-.-.-.-.-.-X-,-,-X-.-.-E-.-,-.-,-.-E-.-.-,-,-.-.-.-.-.-.-.-.-X-
--------------,-X-.-.-.-,-,-,-.-,-,-,-.-,-----------------,-.-,-.-.-.-.-.-.-.-.-.-.-.-.-.-.-.-.-.-,-X---,-X-.-.-.-.-.-.-.-X-X-.-.-.-.-.-,-.-,-.-.-.-.-,-.-.-.-.-.-.-.-.-.-X-
--------------,-X-.-.-.-.-,-,-,-,-,-.-,-,-----------------,-.-,-.-.-.-.-.-.-.-.-.-.-.-.-.-.-.-.-.-X-------,-X-.-.-.-.-.-.-.-.-.-.-.-.-.-,-.-,-.-.-.-,-,-.-.-.-.-E-.-.-.-.-X-
--------------,-X-,-,-,-,-,-X-X-X-X-,-,-------------------,-.-,-.-.-.-.-.-.-.-.-.-.-.-.-E-.-.-.-.-X---------,-X-.-.-.-.-.-.-.-.-.-.-.-.-,-.-,-.-.-.-,-.-.-.-.-.-.-.-.-.-.-X-
--------------,-X-.-.-.-,-,-X-----,-X---------------------,-.-,-.-.-.-.-.-.-.-.-.-.-.-.-.-.-.-.-X-,-----------,-X-X-X-X-.-A-.-,-X-X-X-X-X-,-,-.-.-,-,-.-.-.-.-.-.-.-.-.-.-X-
--------------,-X-H-.-.-H-,-X-------X---------------------,-,-,-.-.-.-.-.-.-.-.-.-.-.-.-.-.-.-.-X---------------------,-X-X-X-X---------,-X-.-,-,-,-.-.-.-.-.-.-.-<-.-.-.-X-
--------------,-X-.-.-W-.-X---------X---------------------,-,-.-.-.-.-.-,-,-X-X-X-.-.-.-.-.-.-,-X-----------------------------------------,-X-,-.-.-.-.-.-.-.-.-.-.-.-.-.-X-
----------------,-X-.-.-,-X-------,-X-,-------,-,-,-,-,-,-,-,-.-.-.-,-,-X-X---,-,-X-X-X-X-.-,-X-------------------------------------------,-X-.-.-.-.-.-.-.-.-.-.-.-.-.-.-X-
------------------,-X-X-X-------,-,-X-,-,-,-,-,-.-.-.-.-.-,-X-X-X-X-X-X---------------,-,-X-X---------------------------------------------,-X-.-.-.-.-.-.-.-E-.-.-.-.-.-,-X-
--------------------------------,-.-X-.-.-,-,-.-.-.-.-.-,-X-------------------------------------------------------------------------------,-X-.-.-.-.-.-.-.-.-.-.-.-.-.-X---
------------------------------,-,-X-.-.-.-.-.-.-.-.-.-,-X-----------------------------------------------------------------------------------,-X-.-.-.-.-.-.-.-.-.-.-.-,-X---
------------------------------,-.-X-.-.-.-.-.-.-.-.-,-X---------------------------------------------------------------------------------------,-X-.-.-.-.-.-.-.-.-.-,-X-----
------------------:-:-:-------,-X-.-.-.-.-.-.-.-.-.-X-------------------------------------------------------------------------------------------,-X-X-.-.-.-.-.-.-,-X-------
----------------:-----:---------X-.-.-.-.-.-.-.-.-.-,-X---------------------------------------------------------------------------------------------,-X-X-X-X-X-X-X---------
--------------:-:-:-:-:---------,-X-.-.-.-.-.-.-.-.-.-X-------X-X---------X-X-X-X-X-----------------------------------------------------------------------------------------
------------------:-:-:-----------X-.-.-.-.-.-.-.-.-.-,-X-X-X-----X---X-X-----------X-X-------------------------------------------------------------------------------------
--------------------------------,-,-X-.-.-.-.-.-.-.-.-.-X-----------X-------------------X-----------------------------------------------------------------------------------
------------------------------,-,-X-.-.-.-.-.-.-.-.-.-.-,-----------------,-,-,-,---------X---------------------------------------------------------------------------------
------------------------------,-X-.-.-.-.-.-.-.-.-.-.-.-,-----------------,-.-,-,-,-,-----,-X-,-,-,-,-,---------------------------------------------------------------------
------------------------------,-X-.-.-.-.-.-.-.-.-.-.-.-,-----------------,-.-,-,-,-,-,---,-X-X-X-X-X-X-,-------------------------------------------------------------------
--------------------------------X-.-.-.-.-.-.-.-.-.-.-.-,-----------------,-,-,-,-.-,-,---,-,-.-.-.-.-:-X-------------------------------------------------------------------
--------------------------------,-X-.-.-.-.-.-.-.-.-.-.-,---------------------,-,-,-,-,-----,-.-.-.-.-.-X-------------------------------------------------------------------
--------------------------------,-X-.-.-W-.-.-.-.-.-.-.-,-----------A-------,-,-,-,-.-,-,-,-,-.-.-.-.-:-X-------------------------------------------------------------------
--------------------------------,-X-.-.-.-.-.-.-.-.-.-.-,-------------------,-,-,-,-,-,-,-,-,-X-X-X-X-X---------------------------------------------------------------------
----------------------------------X-.-.-.-.-.-.-.-.-.-.-,-------------,-,-,-,-,-.-.-.-.-,-,---X-----------------------------------------------------------------------------
----------------------------------,-X-.-.-.-.-.-.-.-.-.-,-------------,-X-X-.-,-.-<-.-<-,-,-A-X-----------------------------------------------------------------------------
--------------------------------,-,-X-.-.-.-.-.-.-.-.-.-,-------------,-X-X-,-,-.-.-.-.-,-,---X-----------------------------------------------------------------------------
--------------------------------,-.-X-.-.-.-.-.-.-.-.-.-,-------------------,-,-.-<-.-<-,-,-A-X-----------------------------------------------------------------------------
------------------------------,-,-X-.-.-.-.-.-.-.-.-.-.-,-------------------,-,-,-,-,-,-,-,---X-----------------------------------------------------------------------------
------------------------------,-.-X-.-.-.-.-.-.-.-.-.-.-,-------------------,-,-,-.-.-,-,-,---X-----------------------------------------------------------------------------
------------------------------,-X-.-.-.-.-.-.-.-.-.-.-.-,-----------W---------,-,-,-.-,-------X-----------------------------------------------------------------------------
--------------------------,-,-,-X-.-.-.-.-.-.-.-.-.-.-.-,-----------------,-,-,-,-,-,-,-----X-------------------------------------------------------------------------------
--------------------------,-X6X-X-.-.-.-.-.-.-.-.-.-.-.-,-----------------,-,-.-.-,-,-------X-------------------------------------------------------------------------------
--------------------------,-X6.-,-,-.-.-.-.-.-.-.-.-.-.-,-----------------,-,-,-.-,-,-------X-------------------------------------------------------------------------------
--------------------------,-X6X-X-,-.-.-.-.-.-.-.-.-.-.-,-----------------,-,-,-,-,-------X---------------------------------------------------------------------------------
------------------------------,-X-,-.-.-.-.-.-.-.-.-.-.-,---------------------------------X---------------------------------------------------------------------------------
------------------------------,-X-,-.-.-.-.-.-.-.-.-.-.-,-----------X-X-----------------X-----------------------------------------------------------------------------------
--------------------------------X-.-.-.-.-.-.-,-,-,-.-.-,-------X-X-----X-X-----------X-------------------------------------------------------------------------------------
--------------------------------,-X-X-X-X-.-.-,-X-X-X-X-X-X-X-X-------------X-X-X-X-X---------------------------------------------------------------------------------------
--------------------------------------,-X-,-.-.-X---------------------------------------------------------------------------------------------------------------------------
--------------------,-,-,-,-----------,-X-+V.-.-X---------------------------------------------------------------------------------------------------------------------------
--------------------,-X-X-X-----------,-X-,-,-,-X-----------,-,-,-,---------------------------------------------------------------------------------------------------------
------------------,-,-X-.-X-,---------,-X-,-,-,-X---------,-,-X-X-X-,-,-----------------------------------------------------------------------------------------------------
------------------,-X-.-.-.-X-,-,-,-,-,-X-.-.-.-X-,-,-,-,-,-X-.-.-.-X-X-----------------------------------------------------------------------------------------------------
------------------,-X-.-E-.-,-X-X-X-X-X-.-.-.-.-.-X-X-X-X-X-.-.-E-.-,-X-----------------------------------------------------------------------------------------------------
------------------,-X-.-,-,-,-.-.-.-.-.-.-.-.-.-.-.-.-.-.-,-,-,-.-,-X-X-----------------------------------------------------------------------------------------------------
--------------------,-X-,-.-H-.-.-.-.-.-.-.-E-.-.-.-.-.-.-.-H-,-,-X---------------------------------------------------------------------------------------------------------
----------------------,-X-.-.-.-.-.-.-.-.-.-.-.-.-.-.-.-.-.-.-,-X-----------------------------------------------------------------------------------------------------------
----------------------,-X-.-.-.-.-.-E-.-.-.-.-.-.-.-E-.-.-.-.-.-X-----------------------------------------------------------------------------------------------------------
----------------------,-X-.-.-.-.-.-.-.-.-.-.-.-.-.-.-.-.-.-.-.-X-----------------------------------------------------------------------------------------------------------
----------------------,-X-.-.-.-.-.-.-.-.-,-A-.-.-.-.-.-.-.-.-.-X-----------------------------------------------------------------------------------------------------------
--------------------,-,-X-.-.-.-.-.-.-.-,-,-,-,-.-.-.-.-.-.-.-.-,-X---------------------------------------------------------------------------------------------------------
--------------------,-X-.-.-.-.-E-.-.-,-,-.-.-,-,-.-.-.-E-.-.-.-.-X---------------------------------------------------------------------------------------------------------
--------------------,-X-.-.-.-.-.-.-,-X-X-,-,-,-X-X-.-.-.-.-.-.-.-,-X-------------------------------------------------------------------------------------------------------
------------------,-,-X-.-.-.-.-.-,-,-X->->->->->-X-,-.-.-.-.-.-.-.-X-------------------------------------------------------------------------------------------------------
------------------,-X-.-.-.-.-.-,-,-.-,->-.-.-.->-.-,-,-.-.-.-.-.-,-X-------------------------------------------------------------------------------------------------------
------------------,-X-.-.-.-E-.-A-,-.-,->-.-.-.->-.-,-,-A-.-E-.-.-X---------------------------------------------------------------------------------------------------------
--------------------,-X-.-.-.-.-.-,-,-,->-.-.-.->-,-,-.-.-.-.-.-.-X---------------------------------------------------------------------------------------------------------
----------------------,-X-.-.-.-.-.-,-X->->->->->-X-.-.-.-.-.-.-,-X---------------------------------------------------------------------------------------------------------
----------------------,-X-.-.-.-.-.-.-X-X-,-,-,-X-X-.-.-.-.-.-.-X-----------------------------------------------------------------------------------------------------------
----------------------,-X-.-.-.-E-.-.-.-,-,-,-,-.-.-.-.-E-.-.-.-X-----------------------------------------------------------------------------------------------------------
----------------------,-X-.-.-.-.-.-.-.-.-,-,-.-.-.-.-.-.-.-.-.-X-----------------------------------------------------------------------------------------------------------
----------------------,-X-.-.-.-.-.-.-.-.-.-A-.-.-.-.-.-.-.-.-.-X-----------------------------------------------------------------------------------------------------------
----------------------,-X-.-.-.-.-.-.-.-.-.-.-.-.-.-.-.-.-.-.-.-X-----------------------------------------------------------------------------------------------------------
--------------------,-,-X-,-H-.-.-.-E-.-.-.-.-.-.-.-E-.-.-.-H-.-X-----------------------------------------------------------------------------------------------------------
----------------,-,-,-X-.-,-.-.-.-.-.-.-.-.-.-.-.-.-.-.-.-.-.-,-,-X---------------------------------------------------------------------------------------------------------
----------------,-X-X-,-,-,-,-,-.-.-.-.-.-.-E-,-,-,-.-.-.-,-,-,-----X-------------------------------------------------------------------------------------------------------
----------------,-X-.-E-,-,-,-X-X-X-X-,-X-X-.-X-X-X-X-X-X-X-----E---X-------------------------------------------------------------------------------------------------------
----------------,-X-X-.-.-,-X-------X---X-X-X-X-X-X---------X-------X-------------------------------------------------------------------------------------------------------
--------------------,-X-X-X---------X-X-X-----,-X-X-----------X-X-X---------------------------------------------------------------------------------------------------------
