--------------------------------------------------------,-,-X-X-X-X-X-,-----------------------------------------------------------------------------------------------------------------------------------------------------------------
--------------------------------------------------------,-X-X-.-.-.-X-X-----------------------------------------------------------------------------------------------------------------------------------------------------------------
--------------------------------------------------------,-X-.-.-E-.-.-X-----------------------------------------------------------------------------------------------------------------------------------------------------------------
--------------------------------------------------------,->->->->->->->-----------------------------------------------------------------------------------------------------------------------------------------------------------------
--------------------------------------------------------,-X-.-.-.-.-.-X-----------------------------------------------------------------------------------------------------------------------------------------------------------------
--------------------------------------------------------,-X-.-.-.-.-.-X-----------------------------------------------------------------------------------------------------------------------------------------------------------------
--------------------------------------------------------,-X-.-.-.-.-.-X-----------------------------------------------------------------------------------------------------------------------------------------------------------------
--------------------------------------------------------,-X-.-.-.-.-.-X-----------------------------------------------------------------------------------------------------------------------------------------------------------------
------------------------------,-,-,-,-,-,-,-,-,-,-,-,-,-,-X-.-.-.-.-.-X-------------------------------------------------------,-,-,-,-------,-,-,-,-,-,-,-,-,-,-,-,-,-,-,-,-,-,-,-,-,-,-,-----------------------------------------------
------------------------------,-X-X-X-X-X-X-X-X-X-X-X-X-X-X-.-.-.-.-.-X-X-X-X-X-X-X-X-X-X-X-X-X-X-----------X-X-X-X-X-X-X-X-X-X-X-X-X---,-,-,-X-X~X~X~X~X~X~X~X~X~X~X~X~X~X~X~X~X~X~X~X~X~,---------------------------------------------
------------------------------,-X-.-.-.-.-.-.-.-.-.-.-.-,-,-.-.-.-.-.-,-------------------------X-----------X---E-------------,-.-A-X-,-,-X-X~.~.~.~.~.~.~.~.~.~.~.~.~.~.~.~.~.~.~.~.~.~.~X~,-------------------------------------------
------------------------------,-X-.-X-X-X-X-X-X-X-X-X8.8X8X-,-,-,-,-,-X-X-X-X-X-X-X-X-X-X-X-X---X-----------X---X-X-X-X-X-X-X-X-X-,-X~X~X~.~.~.~.~.~.~.~.~.~.~.~.~.~.~.~.~.~.~.~.~.~.~.~.~.~X~,-----------------------------------------
------------------------------,-X-.-X-,-,-,-,-,-,-,-X-.-X-X-.-.-.-.-.-X---------------------X---X-----------X---X-------------,-X-,-.~.~.~.~.~.~.~.~.~.~.~.~.~.~.~.~.~.~.~.~.~.~.~.~.~.~.~.~.~X~,---------------------------------------
------------------------------,-X-.-X-,-X-X-X-X-X-,-X-.-X-X-.-.-.-.-.-X---------------------X-E-X-----------X---X-------------,-X-,-.~.~.~.~.~.~.~.~.~.~.~.~.~.~.~.~.~.~.~.~.~.~.~.~.~.~.~.~.~.~X~,-------------------------------------
------------------------------,-X-.-X-,-X-A-.-H-X-,-X-.-X-X-,-,-,-,-,-X---------------------X---X-----------X---X-------------,-X-,-.~.~.~.~.~.~.~.~.~.~.~.~.~.~.~.~.~.~.~.~.~.~.~.~.~.~.~.~.~.~.~X~,-----------------------------------
------------------------------,-X-.-X-,-X-.-.-.-X-X-X-.-X-X-.-.-.-.-.-X---------------------X---X-----------X---X-------------,-X-,-.~.~.~.~.~.~.~.~.~.~.-.-.-.-.-.~.~.~.~.~.~.~.~.~.~.~.~.~.~.~.~.~X~----------------------------------
------------------------------,-X-.-X-,-X-W-.-A-.-.-.-.-X-X-,-,-,-,-,-X---------------------X---X-----------X---X-------------,-X-,-.~.~.~.~.~.~.~.~.~.-.-.-.-.-.-.-.~.~.~.~.~.~.~.~.~.~.~.~.~.~.~.~,~X---------------------------------
------------------------------,-X-.-X-,-X-.-.-.-.-.-.-.-X-X-.-.-.-.-.-X---------------------X---X-----------X---X-------------,-X-,-.~.~.~.~.~.~.~.~.-.-.-.-.-.-.-.-.-.~.~.~.~.~.~.~.~.~.~.~.~.~.~.~.~X~--------------------------------
------------------------------,-X-E-X-,-X-.-.-.-.-.-.-.-X-X-X-,-,-,-X-X-,-,-----------------X---X-----------X-E-X-------------,-X-,-.~.~.~.~.~.~.~.~.-.-.-.-.-.-.-.-.-.~.~.~.~.~.~.~.~.~.~.~.~.~.~.~.~,~X-------------------------------
------------------------------,-X-.-X-,-X-X-X-.-X-X-X-X-X-,-X-L-L-L-X-,-X-X-,-,-,-,-,-,-----X---X-----------X---X-------------,-X-,-.~.~.~.~.~.~.~.~.-.-.-.-H-.-.-.-.-.~.~.~.~.~.~.~.~.~.~.~.~.~.~.~.~.~X~------------------------------
------------------------------,-X-.-X-X-X-X-X-,-X-X-,-,-X-X-X-L-L-L-X-X-X-X-X-X-X-X-X-X-X-X-X---X-----------X---X-------------,-X-,-.~.~.~.~.~.~.~.~.-.-.-.-.-.-.-.-.-.~.~.~.~.~.~.~.~.~.~.~.~.~.~.~.~.~,~X-----------------------------
------------------------------,-X-.-X-X-.-,-.-.-.-.-.-.-.-X-X-.-.-.-X-X-.-.-.-.-.-.-.-,-,-X-X---X-X-X-X-X-X-X---X-----------,-,-X-,-.~.~.~.~.~.~.~.~.-.-.-.-.-.-.-.-.-.~.~.~.~.~.~.~.~.~.~.~.~.~.~.~.~.~.~X~----------------------------
------------------------------,-X-.-X-X-,-,-.-.-.-.-.-.-.-.-.-.-.-.-.-.-.-.-.-.-.-.-.-.-.-X-X-K-,-,-,-,-,-------X-----------,-X-,-,C.~.~.~.~.~.~.~.~.~.-.-.-.-.-.-.-.~.~.~.~.~.~.~.~.~.~.~.~.~.~.~.~.~.~.~,~X---------------------------
------------------------------,-X-.-X-X-.-.-.-.-.-.-.-.-.-.-.-.-.-.-.-.-.-.-.-.-.-.-.-.-.-X-X-,-X-X-X-X-X-X-X-X-X-------------,-X-,C.~.~.~.~.~.~.~.~.~.~.-.-.-.-.-.~.~.~.~.~.~.~.~.~.~.~.~.~.~.~.~.~.~.~.~.~X~--------------------------
------------------,-,-,-,-,-,-,-X-.-X-X-.-.-.-.-.-.-.-.-.-.-.-.-.-.-.-.-.-.-.-.-.-.-.-.-.-X-X-H-.-A-,-<-X-----------------------X-,-.~.~.~.~.~.~.~.~.~.~.~.~.~.~.~.~.~.~.~.~.~.~.~.~.~.~.~.~.~.~.~.~.~.~.~.~X~--------------------------
------------------,-X-X-X-X-X-X-X-.-X-X-.-.-.-.-.-.-.-.-.-.-.-.-.-.-.-.-.-.-.-.-.-.-.-.-.-X-X-,-,-,-,-.-X-----------------------X-,-.~.~.~.~.~.~.~.~.~.~.~.~.~.~.~.~.~.~.~.~.~.~.~.~.~.~.~.~.~.~.~.~.~.~.~.~X~--------------------------
------------------,-X-.-.-.-.-.-.-.-.-,-.-.-.-.-.-.-.-.-.-.-.-.-.-.-.-.-.-.-.-.-.-.-.-.-.-X-X-.-.-.-.-.-X-----------------------X-,-.~.~.~.~.~.~.~.~.~.~.~.~.~.~.~.~.~.~.~.~.~.~.~.~.~.~.~.~.~.~.~.~.~.~.~.~X~--------------------------
------------------,-X-.-X-X-X-X-X-X-X-X-.-.-<-.-.-.-.-.-.-.-.-.-.-.-.-.-.-.-.-.-.-.-.-.-.-X-X-.-.-.-.-.-X-----------------------X-X-X~X~X~X~.~.~.~.~.~.~.~.~.~.~.~.~.~.~.~.~.~.~.~.~.~.~.~.~.~.~.~.~.~.~.~.~X~--------------------------
------------------,-X-.-X-----------,-X-.-.-.-.-.-.-.-.-.-.-.-.-.-.-.-.-.-.-.-.-.-.-.-.-.-X-X-,-,-E-,-,-X---X-X-X-X-X-X-X-X-X-X-X-X-X-X---,-X~.~.~.~.~.~.~.~.~.~.~.~.~.~.~.~.~.~.~.~.~.~.~.~.~.~.~.~.~.~.~.~X~--------------------------
------------------,-X-.-X-----------,-X-.-.-<-.-.-.-.-.-.-.-.-.-.-.-.-.-.-.-.-.-.-.-.-.-.-X-X<X<X<.-.-X-X-X-X-------------------------X-X---,-X~.~.~.~.~.~.~X~X~X~X~X~X~X~X~X~X~X~X~X~.~.~.~.~.~.~.~.~.~.~.~X~--------------------------
------------------,-X-.-X-----------,-X-X-.-.-.-.-.-.-.-.-.-.-.-.-.-.-.-.-.-.-.-.-.-.-.-X-X-X-X-X-,-,-X-X-X-A-------------------------H-X-----,-X~.~.~.~.~.~X~----------------------,-X~.~.~.~.~.~.~.~.~.~.~X~--------------------------
------------------,-X-.-X-------------X-X-.-<-.-.-.-.-.-.-.-.-.-.-.-.-.-.-.-.-.-.-.-.-.-X-X-X-.-.-.-.-.-X---------------------,-,-,-----X-------,-X~X~X~X~X~X~------------------------,-X~.~.~.~.~.~.~.~.~.~X~--------------------------
------------------,-X-.-X-------------X-.-.-.-.-.-.-.-.-.-.-.-.-.-.-.-.-.-.-.-.-.-.-.-.-.-+-.-.-.-.-.-.-X---------------------,-.-,-,-,-X-------------,-,-,-,-,-,-,-,-,-,-,-,-,-,-,-,---,-X~.~.~.~.~.~.~.~.~X~--------------------------
------------------,-X-E-X-------------X-.-.-<-.-.-.-.-.-.-.-.-.-.-.-.-.-.-.-.-.-.-.-.-.-.-+-.-.-.-.-.-.-X---------------------,-,-,-,-X-X-------,-,-,-X-X-X-X-X-X-X-X-X-X-X-X-X-X-X-X-----,-X~.~.~.~.~.~.~.~X~--------------------------
------------------,-X-.-X-------------X-.-.-.-.-.-.-.-.-.-.-.-.-.-.-.-.-.-.-.-.-.-.-.-.-.-+-.-.-.-.-.-.-X-----------------------,-,-.-,-X-----,-,-X-X-.-.-.-,-.-,-.-.-.-.-.-.-.-.-H-X-------,-X~.~.~.~.~.~.~X~--------------------------
------------------,-X-.-X-----------,-X-X-.-.-.-.-.-.-.-.-.-.-.-.-.-.-.-.-.-.-.-.-.-.-.-X-X-X-.-.-.-.-.-X---------------E-------,-,-,-E-X---,-,-X-.-,-,-.-.-,-.-,-.-.-.-.-.-.-.-.-.-X---------,-X~.~.~.~.~.~X~--------------------------
------------------,-X-.-X-----------,-X-X-.-.-.-.-.-.-.-.-.-.-.-.-.-.-.-.-.-.-.-.-.-.-.-X-X-X-X-X-.-.-.-X-----------------------,-,-,-X-X-,-,-X-.-.-.-,-.-.-,-.-,-.-.-.-.-.-.-E-.-<-X---------,-X~.~.~.~.~.~X~--------------------------
------------------,-X-.-X-----------,-X-.-.-.-.-.-.-.-.-.-.-.-.-.-.-.-.-.-.-.-.-.-.-.-.-.-X---,-X-.-.-.-X-----------------------------X-X-,-X-,-,-.-.-,-,-.-,-.-,-.-.-.-.-.-.-.-.-.-X---------,-X~.~.~.~.~.~X~--------------------------
------------------,-X-.-X-,-,-,-,-,-,-X-.-.-.-.-.-.-.-.-.-.-.-.-.-.-.-.-.-.-.-.-.-.-.-.-.-X---,-X-.-+\+\X-------------------------------X-,-X-.-,-,-,-.-,-,-,-.-,-.-.-,-,-,-,-,-.-H-X---------,-X~.~.~.~.~.~X~--------------------------
------------------,-X-.-X-X-X-X-X-X-X-X-.-.-.-.-.-.-.-.-.-.-.-.-.-.-.-.-.-.-.-.-.-.-.-.-.-X---,-X-.<.-+\X-------------------------------X-,-X-.-.-.-,-,-,-X-X-X-X-X-X-X-X=,=,=X=X-X-X---------,-X~.~.~.~.~.~X~--------------------------
------------------,-X-.-.-.-.-.-.-.-,-.-.-.-.-.-.-.-.-.-.-.-.-.-.-.-.-.-.-.-.-.-.-.-.-.-.-X---,-X-.-.-.-X------------------------4,-,-,-X-X-,-,-,-,-,-,-X-----,-X-X-X-X-X-.-.-X-X-X-,---------,-X~.~.~.~.~.~X~,-------------------------
------------------,-X-X-X-X-X-X-X-.-X-X-.-.-.-.-.-.-.-.-.-.-.-.-.-.-.-.-.-.-.-.-.-.-.-.-.-X---,-X-.-.-.-X-----------------------,4,-+TXTXTX-.-.-.-.-.-.-X-X-X-X-X-.-.-.-.-.-.-.-.-X-X_X-X-----,-X~.~.~.~.~.~.~X~,-----------------------
------------------------------,-X-.-X-X-.-.-.-.-.-.-.-.-.-.-.-.-.-.-.-.-.-.-.-.-.-.-.-.-.-X---,-X-.-.-.-X-----------------------,-+T+T+TXTX-.-.-.-.-.-.-X-X-H-,-.-.-.-.-.-.-.-.-.-,-,-H-X-----,-X~.~.~.~.~.~.~.~X~,---------------------
------------------------------,-X-.-X-X-.-.-.-.-.-.-.-.-.-.-.-.-.-.-.-.-.-.-.-.-.-.-.-.-.-X---,-X-.-.-.-X-----------------------,-+T+T+TXTX-.-.-.-.-.-.-X-X-X-X-X-.-.-.-.-.-.-.-.-X-X_X-X-----,-X~.~.~.~.~.~.~.~.~X~,---,-,-,-,-,-,-,-,-
------------------------------,-X-.-X-X-,-.-.-.-.-.-.-.-.-.-.-.-.-.-.-.-.-.-.-.-.-.-.-,-,-X---,-X-.-.-.-X-X-,-,-,-,-,-,-,-------,-+T+TXTXTX-X-X-X-.-X-X-X-----,-X-.-.-,-,-,-,-,-.-X-----------,-X~.~.~.~.~.~.~.~.~.~X~,-,-X-X-X-X-X-X-X-
------------------------------,-X-.-X-X-,-.-.-.-.-.-.-.-.-X-X-.-.-.-X-X-.-.-.-.-.-.-.-,---X---,-X-.-.-.-X-X-X-X-X-X-.-X-X-X-----------X-X-X-X-X-X-,-X-X-X-X-X-X-X-.-.-,-.-.-.-,-.-X-X-X-X=----,-X~.~.~.~.~.~.~.~.~.~.~X~,-X-H-.-H-.-H-X-
--,-,-,-,-,-,-,-,-,-,-,-,-,-,-,-X-.-X-X-X-X-X-X-X-X-X-X-X-X-X-+-+-+-X-X-X-X-X-X-X-X-X-X-X-X---,-X-.-.-.-X-X-.-.-.-.-.-.-X-X-------------X-X-E---E---E---X-X-H-,-.-.-.-,-.-:-.-,-.-,---H-X=----,-X~.~.~.~.~.~.~.~.~H~.~,~X-.-.-.-.-.-.-X-
--,-X-X-X-X-X-X-X-X-X-X-X-X-X-X-X-E-X-X-X-X-X-------------,-X-.-.-.-X-------------------------,-X-,-,-,-X-X-.-E-.-.-E-.-X-X-H-----------X-X-------------X-X-X-X-X=.=.=,=,=,-,-,=,=X=X-X-X=----,-X~.~.~.~.~.~X~X~.~.~,~,~.-.-.-.-.-.-H-X-
--,-X-.-.-.-.-.-.-.-.-.-.-.-.-.-.-.-.-.-.-.-X-,-,-,-,-,-,-,-X-.-E-.-X-------------------------,-X-X-.-X-X-X-.-.-.-,-,-,-X-X-X-X-X-X---X-X-X-------,-,-,-X-----,-X-.-.-,-,-,-,-,-,-X-----------,-X~.~.~.~.~.~X~,-X~.~,~.-.-.-.-.-.-.-.-X-
X-X-X-X-X-+-X-X-X-X-X-X-X-X-X-X-X-X-X-X-X-+-X-X-X-X-X-X-X-X-X-.-.-.-X-X-X-X-X-X-X-X-X-X-------,-X-X-,-X-X-X-.-.-,-,-,-X-X-X-X-X-X-X---X-X-X-----,-,-.-X-X-X-X-X-X?.?.?,?,?X?X-X?.?X?X-X-X-----,-X~.~.~.~.~.~X~--,-X~,~.-.-.-.-.-.-.-H-X-
X-W---,-,-,-.-.-.-.-.-.-.-,-+Z+Z.-H-,-,-,-,-,-.-.-.-.-.-,-X-X-,-,-,-X-X-----,-,-,-,-,-X-------X-X-.-.-.-.-.-.-.-,-,-.-.-X-X---------------------,-.-.-.-X-X-H-,-.-.-.-.-.-X-X-X-.-,---H-X-----,-X~.~.~.~.~.~X~----,-X-.-.-.-.-.-.-.-.-X-
X---------,-.-.-.-.-.-.-.-,-+Z+Z.-E-,-,-.-.-,-.-.-.-.-.-,-.-.-.-.-.-.-,-----,-.-.-.-.-X-------X-.-.-.-.-.-.-.-E-,-,-,-E-X-----------------------,-.-.-E-X-X-X-X-X-.-.-.-.-.-.-.-.-X-X-X-X-----,-X~.~.~.~.~.~X~----,-X-.-.-.-.-.-.-.-H-X-
X-----,-,-,-.-.-.-.-.-,-,-,-+Z+Z.-H-,-,-.-.-,-.-.-.-.-.-,-.-.-.-.-.-.-,-----,-.-.-A-E-X-,-,-,-X-.-.-.-.-.-.-.-.-,-,-.-X-X-----------------------,-,-,-X-X-----,-X-.-.-.-.-.-.-.-.-X-----------,-X~.~.~.~.~.~X~----,-X-.-.-.-.-.-.-.-.-X-
X-----,-.-.-.-.-.-.-.-,-.-.-.-,-,-,-,-,-.-E-,-.-.-.-.-.-,-.-.-.-.-.-.-,-----,-.-.-.-,-X-X-X-X-X-.-.-.-.-.-.-.-.-.-,-,-X-X-----------------------------X-X-X-X-X-X-.-.-.-.-.-.-.-.-X-X-X-X-----,-X~.~.~.~.~.~X~----,-X-:-.-.-.-.-.-.-H-X-
X-,-,-,-.-.-.-.-.-.-.-,-.-,-,-,-,-,-,-,-.-.-,-,-,-A-,-.-,-.-.-.-.-.-.-,-----,-.-.-W-,-+-+-.-X-X-.-.-.-.-.-.-.-.-.-.-.-.-X-------------------------------X-X-H-,-,-.-.-.-.-.-.-.-.-,---H-X-----,-X~.~.~.~.~.~X~----,-X-,-,-,-,-.-.-.-.-X-
X-.-.-.-.-.-.-.-.-.-.-,-,-,-.-.-.-.-,-,-.-.-,-,-.-.-,-.-,-.-.-.-.-.-.-,-----,-.-.-.-E-X-X-.-X-X-.-.-.-.-.-.-.-.-.-.-.-.-X-------------------------------X-X-X-X-X-.-.-,-,-,-,-.-.-X-X-X-X-----,-X~.~.~.~.~.~X~----,-X-X-X-.-X-X-X-X-X-X-
X-.-.-.-.-.-.-.-.-.-.-.-.-,-.-.-.-W-,-,-.-.-,-A-.-.-,-.-,-.-.-.-.-.-.-,-----,-.-.-A-.-X-X-.-X-X-.-.-.-.-.-.-.-.-.-,-,-,-X-------------------------,-,-,-X-,-,-,-X-X-,-X-X-+-X-,-X-X-----------,-X~.~.~.~.~.~X~--------,-X-.-X-----------
X-.-<-.-.-.-.-.-.-.-.-.-.-,-.-.-E-.-,-,-.-E-,-,-,-,-,-.-,-.-.-.-.-.-.-,-----,-,-,-,-,-X-X-.-X-X-.-.-.-.-.-.-.-.-,-,-.-X-X-----------------------,-,-.-X-XPX-X-----X---X-X-A-X---X-------------,-X~.~.~.~.~.~X~--------,-X-.-X-----------
X-,-,-,-,-.-.-.-.-.-.-.-.-,-.-.-.-A-,-,-.-.-,-.-.-W-.-.-,-.-.-.-.-.-.-,---------------X-X-.-X-X-.-.-.-.-.-.-.-.-,-.-B-B-X-----------------------,-.-.-.-.-.-X-----X-H-X-X-.-X-H-X-----------,-,-X~.~.~.~.~.~X~--------,-X-.-X-----------
X-,-.-.-,-.-.-.-.-.-.-.-.-,-.-.-E-.-,-,-.-.-,-.-.-.-.-.-,-.-.-.-.-.-.-,---------------X-X7.7X7X-.-.-.-.-.-.-.-.-,-.-.-E-X---------------E-------,-.-.-E-.-E-X-----X-X-X-X-A-X-X-X-----------,-.-X~.~.~.~.~.~X~--------,-X-.-X-----------
X-,-.-.-,-.-.-.-.-.-.-.-.-,-.-.-.-H-,-,-.-E-,-,-,-.-.-.-,-.-.-.-.-.-.-,-------------,-X-X7.7X7X-.-.-.-.-.-.-.-.-,-,-B-X-X-----------------------,-,-,-X-XPX-X---------,-X-.-X-------------,-,-X~.~.~.~.~.~.~X~--------,-X-.-X-----------
X-,-,-,-,-.-.-.-.-.-.-.-.-,-,-,-,-,-,-,-.-H-.-.-,-.-.-.-,-.-.-.-.-.-.-,-------------,-X-X7,7X7X-.-.-.-.-.-.-.-.-.-.-.-X-X------------------------0----X-X-------------,-X-A-X-----------,-,-.-X~.~.~.~.~.~X~,---------,-X-.-X-----------
X-.-.-.-.-.-.-.-.-.-.-.-.-.-.-.-.-,-.-,-.-E-.-.-,-.-.-.-,-.-.-.-.-.-.-,-------------,-.-.-A-X-X-.-.-.-.-.-.-.-.-.-.-.-.-X------------------------0------X-,-,-,-,-,-,-,-X-.-X-------,-,-,-X-X~.~.~.~.~.~.~X~----------,-X-.-X-----------
X-.-.-.-.-.-.-.-.-.-.-.-.-.-.-.-.-,-.-,-,-,-,-,-,-.-.-.-,-.-.-.-.-.-.-,-------------,-X-X-.-X-X-.-.-.-.-.-.-.-.-.-.-.-.-X-------------------------------X-,-X-X-X-X-X-X-X-A-X---,-,-,-X-X~.~.~.~.~.~.~.~X~,-----------,-X-.-X-----------
X-.-.-.-.-.-.-.-.-.-.-.-.-.-.-.-.-,-.-.-,-.-.-.-.-.-.-.-,-.-.-.-.-.-.-,-----------W---X-X-.-X-X-X-A-,-,-,-,-,-,-,-,-,-A-X-X-A-------------------------H-X-,-X-E-.-,-,-,-.-.-X-,-,-X-X~.~.~.~.~.~.~.~.~.~X~------------,-X-.-X-----------
X-.-.-.-.-.-.-.-.-.-.-.-.-.-.-.-.-,-,-,-,-.-.-.-.-.-.-.-,-.-.-.-.-.-.-,---------------X-X-.-X-,-X-X-X-X-X-X-X-X-X-X-X-X-X-X-X-X-X-X-X-X-X-X-X-X-X-X-X-X-X-,-X-.-X-X-X~X~X-+~X-X~X~.~.~.~.~.~.~.~.~.~.~X~,-------------,-X-.-X-----------
X-.-.-.-.-.-.-.-.-.-.-.-.-.-.-.-.-.-.-.-.-.-.-.-.-.-.-.-,-,-,-,-,-,-,-,-,-------------X-X-.-X-,-,-,-,-,-,-,-,-,-,-,-,-,-,-,-,-,-,-,-,-,-,-,-,-,-,-,-,-,-,-,-X-.-X-,-X~.~.~.~.~.~.~.~.~.~.~.~.~.~.~.~.~X~--------------,-X-.-X-----------
X-,-X-X-X-.-.-.-X-X-X-.-.-.-.-.-.-.-.-.-.-.-.-.-.-.-.-.-X-X-X-.-.-.-X-X-X-,-----------X-X-.-X-X-X-X-X-X-X-X-X-X-X-X-X-X-X-X-X-X-X-X-X-X-X-X-X-X-X-X-X-X-X-X-X-.-X-X-.~.~.~.~.~.~.~.~.~.~.~.~.~.~.~.~X~,---------------,-X-.-X-----------
X-,-X-X.X.,.,.,.X.X.X-,-,-,-,-,-,-,-,-,-,-,-,-,-,-,-,-,-X-X-X-,-,-,-X-X-X-,-,---------X-X-.-.-.-.-.-.-.-.-.-.-.-.-.-.-.-.-.-.-.-.-.-.-.-.-.-.-.-.-.-.-.-.-.-.-,-X-X~.~.~.~.~.~.~.~.~.~.~.~.~.~.~,~,~X~----------------,-X-.-X-----------
X---X-X.........,.X-X-----------------------------------X-X-A-.-A-.-A-X-X-.-,-,-------X-X-X-X-X-X-X-X-X-X-X-X-X-X-X-X-X-X-X-X-X-X-X-X-X-X-X-X-X-X-X-X-X-X-X-X-X-X-.~.~.~.~.~.~.~.~.~.~.~.~.~,~,~X~X-------------------,-X-.-X-----------
X---X-X.........,..-,-----------------------------------,-.-.-.-.-.-.-X-X-.-.-,-,-----X-XZX-.-.-.-.-.-.-.-H-X-X~X~X~X~X~X~X~X~X~X~X~X~X~X~X~X~X~X-,-,-,-X-X~X~X~X~.~.~.~E~.~.~.~.~.~.~.~,~,~X~X-----------------------,-X-.-X-----------
X---X-X.........,..-,-----------------------------------,-.-A-.-A-.-A-X-X-.-.-.-,-,---,-,:,-.-.-.-.-E-.-.-,-X-X-,~,~,~.~.~.~.~.~.~.~.~.~.~.~.~.~.~X~X~X~.~,~,~.~.~.~.~.~.~.~.~.~,~,~X~X~X~X---------------------------,-X-.-X-----------
X---X-X.........,..-,-----------------------------------,-.-.-.-.-.-.-X-X-.-.-.-.-,-,-,-,:,-.-.-.-.-.-.-.-,-.-,-,~.A,A.~.~.~.~.~.~.~.~.~.~.~.~.~.~.~.~.~.~.~,~,~.~.~.~.~.~.~,~,~X~X-----------------------------------,-X-.-X-----------
X---X-X.........,.X-X-----------------------------------X-X-A-.-A-.-A-X-X-.-.-.-.-.-,-,-,:,-.-.-.-.-.-.-.-,-.-,-.AKA,A.~.~.~.~.~.~.~.~.~.~.~H~.~.~.~.~.~.~.~.~,~,~,~.~.~,~,~X~X---------------------------------------,-X-.-X-----------
X---X-X.X.X.X.X.X.X.X---------------------------------,-X-X-X-X-X-X-X-X-X-.-.-.-.-.-.-X-XZX-.-.-.-.-.-.-.-,-.-,-,A,A,A.~.~.~.~.~.~.~.~.~.~.~.~.~.~.~.~.~.~.~.~.~.~,~,~,~X~X-------------------------------------------,-X-.-X-----------
X---X-X-X-X-X-X-X-X-X---------------------------------,-X-X-X-X-X-X-X-X-X-.-.-.-.-.-.-X-X-X-.-.-.-.-.-.-.-,-.-,-.~.~.~.~.~.~.~.~.~,~X~X~X~.~.~.~.~.~.~.~.~.~.~.~H~.~.~.~X~--------------------------------------------,-X-.-X-----------
X-----------------,-,-,-,-,-,-,-,-,-,-,-,-,-,-,-,-,-,-,-,-,-.-.-.-.-.-.-.-.-.-.-.-.-.-X-X-.-.-.-.-.-.-.-.-,-X-X-.~.~,~,~,~.~.~.~,~X~----,-X~.~.~.~.~.~.~E~.~.~.~.~.~.~.~X~,-------------------------------------------,-X-.-X-----------
X-X-X-X-X-X-X-X-X-X-X-.-.-.-.-.-.-.-.-.-.-.-.-.-.-.-.-.-X-X-X-X-X-X-X-X-X-X-X-X-X-X-X-X-X-,-,-,-,-,-,-,-,-,-X-X~,~,~,~.~,-,~.~,~X~------,-,-X~.~.~.~.~.~.~.~.~.~.~.~.~.~.~X-------------------------------------------,-X-.-X-----------
------------------,-X-,-,-,-,-,-,-,-,-,-,-,-,-,-,-,-,-,-X-----,-X-X-X-X-X-X-X-X-X-X-X-X-X-.-.-.-.-.-.-.-.-.-X-X~,~.~.-B-B-,-,~X~------,-,-X~.~.~.~.~.~.~.~.~.~.~.~.~.~.~.~X~,-----------------------------------------,-X-.-X-----------
------------------,-X-B-.-.-B-.-.-.-B-.-.-B-.-.-B-.-.-B-X-----,-X-.-E-.-.-,-A-.-.-.-.-.-.-.-.-.-.-.-.-.-.-.-X-X~X-B-B-.-H-B-X-------,-,-X~.~B~.~.~.~.~.~.~.~.~.~.~.~.~.~.~.~X-,-,-,-,-,-,-----------------------------,-X-.-X-----------
------------------,-X-.-.-E-.-.-E-.-.-E-.-.-E-.-.-E-.-.-X-----,-X-.-,-,-,-,-.-.-.-.-.-.-.-.-.-.-.-.-.-.-.-.-X-,-X-,-,-,-,-X---------,-X~.~.~.~.~.~B~.~.~.~.~.~.~.~.~E~.~.~.~X~X~X~X~X~X~X~,-,-,-,-,-,-,-,-,-,-,-,-,-,-,-X-.-X-----------
,-,-,-,-,-,-,-,-,-,-X-B-.-.-B-.-.-.-B-.-.-B-.-.-B-.-.-X-X-,-,-,-X-,-,-,-,-,-,-,-,-,-,-,-,-,-,-,-,-,-,-,-,-A-X-,-X-XAXAXAX-----------,-X~.~B~.~B~.~.~.~.~.~.~B~.~.~.~.~.~.~.~.~.~.~.~.~:~X-X-X-X-X-X-X-X-X-X-X-X-X-X-X-X-XD.DXD----------
X-X-X-X-X-X-X-X-X-X-X-X-X-X-X-X-X-X-X-X-X-X-X-X-X-X-X-X-X-X-X-X-X-,-,-,-.-,-,-,-.-.-.-.-.-.-.-.-.-.-.-.-.-,-X-X-X-X-X-X-X-X-X-X-X-X-X-X~X~.~.~.~.~.~.~B~.~.~.~.~.~.~.~.~.~.~.~.~.~.~W~,~.-A-.-.-.-.-.-.-.-.-.-.-.-.-.-,-.D.DXD----------
X-,-,-,-,-,-,-,-,-,-,-,-,-,-,-,-,-,-,-,-,-,-,-,-,-,-,-,-,-,-,-,-,-.-.-,-,-,-,-,-,-,-,-,-,-,-,-,-,-,-,-,-,-,-.-.-.-.-.-.-.-.-.-.-.-.-.-,-.~.~.~.~.~.~B~.~.~.~.~.~B~.~.~.~.~.~.~.~.~.~.~:~X-X-X-X-X-X-X-X-X-X-X-X-X-X-X-X-XDXDXD----------
X-B-B-B-B-B-B-B-B-B-B-B-B-B-B-B-B-B-B-B-B-B-B-B-B-B-B-B-B-B-B-B-,-.-.-,---B---B-----,-.-.-B-A-.-B-.-B-B-.-B-.-.-.-.-.-.-B-.-.-.-B-.-.-,-.~.~H~.~B~,~,~,~,~.~.~.~.~.~.~.~.~,~X~X~X~X~X~X~X~----------------------------------------------
X-X-X-X-X-X-X-X-X-X-X-X-X-X-X-X-X-X-X-X-X-X-X-X-X-X-X-X-X-X-X-X-X-,-,-,-------------,-,-,-,-,-,-,-,-,-,-,-,-X-X-X-X-X-X-X-X-X-X-X-X-X-X-X~.~.~.~.~,~.-.-,-.~.~.~.~.~.~.~,~X~------------------------------------------------------------
----------------------------------------------------------------X-------------------------------------------X-----------------------,-X~X~B~.~.~B~,~.-.-,-.~.~.~.~.~.~,~X~--------------------------------------------------------------
----:-:-:-------------------------------------------------------X-------------------------------------------X-----------------------,-X~.~.~.~B~.~,~,-,-,-.~.~.~E~.~,~X~----------------------------------------------------------------
--:-----:-------------------------------------------------------X-------------------------------------------X-----------------------,-X~.~.~.~.~.~.~.~.~.~.~.~.~.~.~X~------------------------------------------------------------------
:-:-:-:-:-------------------------------------------------------X-----E-------------------------E-----------X-----------------------,-X~.~.~B~.~.~.~.~.~B~.~.~.~.~.~X~------------------------------------------------------------------
----:-:-:-------------------------------------------------------X-------------------------------------------X-----------------------,-X~.~.~.~.~.~.~.~.~.~.~.~.~.~.~X~------------------------------------------------------------------
----------------------------------------------------------------X---------W-------------------<-----------X-X-----------------------,-X~.~.~.~.~.~.~.~.~.~.~.~.~.~.~X~------------------------------------------------------------------
----------------------------------------------------------------X-X-X-X-X-X-X-X-X-X-X-X-,-A-----,-A-,-X-X-X-------------------------,-X~.~.~.~.~.~.~.~.~.~.~.~.~.~.~X~------------------------------------------------------------------
------------------------------------------------------------------------------------,-,-X-,-,-H-,-.-X-,-----------------------------,-X~.~.~.~.~.~.~.~.~.~.~.~.~.~,~X~------------------------------------------------------------------
------------------------------------------------------------------------------------,-X-X-.-.-.-.-.-,-X-----------------------------,-X~.~.~.~.~.~.~.~.~.~.~.~.~,~X~--------------------------------------------------------------------
----------------------------------------------------------------------------------------,-X-X-X-X-X-X-------------------------------,-X~.~.~.~.~.~.~.~.~.~.~.~,~X~----------------------------------------------------------------------
--------------------------------------------------------------------------------------------------------------------------------------,-X~.~.~.~.~.~.~.~.~.~,~X~------------------------------------------------------------------------
----------------------------------------------------------------------------------------------------------------------------------------,-X~X~X~X~X~X~X~X~X~X~--------------------------------------------------------------------------
