----------------------------------------------------------------------------------------------------------------------------,-,-,-,-,-X-X-X-,-----------------,-,-X-,-,---------------------------------------------------------------------
--------------------------------------------------------------------------------------------------------------------,-,-,-,-,-X-X-X-X-.-.-.-X-,-------------,-,-X-.-X-X-,-,-----------------------------------------------------------------
------------------------------------------------------------------------------------------------------------,-,-,-,-,-X-X-X-X-.-.-.-.-.-.-.-.-X-,---------,-,-X-.-.-.-.-X-X-,-,-------------------------------------------------------------
--------------------------------------------------------------------------------------------------------,-,-,-X-X-X-X-.-.-.-.-.-.-.-.-.-.-.-.-.-X-,-,-,-,-,-X-.-.-.-.-.-.-.-X-X-,-,-,-,-,-,-,-,-,-,-----------------------------------------
--------------------------------------------------------------------------------------------------------,-X-X-.-.-.-.-.-.-.-.-.-.-.-.-.-.-.-.-.-.-X-X-X-X-X-.-.-.-.-.-.-.-.-.-.-X-X-X-X-X-X-X-X-X-X-----------------------------------------
------------------------------------------------------------------------------------------------------,-,-X-.-.-.-.-.-.-.-.-.-.-.-.-<-.-.-.-.-.-.-.-.-.-.-.-.-.-.-.-.-.-.-.-.-.-.-.-.-.-.-.-.-.-.-X-,-X-X-X-X-X-X-X-X-X-X-------------------
------------------------------------------------------------------------------------------------------,-X-.-.-.-.-.-.-.-.-.-.-.-.-.-.-.-.-.-.-.-.-.-.-.-.-.-.-.-.-.-.-.-.-.-.-.-.-.-.-.-.-B-.-.-.-X-X-X-H-.-.-H-.-.-.-H-X-X-----------------
----------------------------------------------------------------------------------------------------,-,-X-.-.-.-.-.-.-.-.-.-.-.-.-.-.-.-.-.-.-.-.-.-.-.-.-.-.-.-.-.-.-.-.-.-.-.-.-.-.-.-.-.-H-.-,-X-X-.-.-.-.-.-.-.-.-.-,-X-----------------
----------------------------------------------------------------------------------------------------,-X-.-.-.-.-.-.-.-.-.-.-.-.-.-.-.-.-.-.-.-.-.-.-.-.-.-.-.-.-.-.-.-.-.-.-.-.-.-.-.-B-.-B-.-B-,-XUXU.-.-.-.-.-.-.-.-.-,-X-----------------
----------------------------------------------------------------------------------------------------,-X-.-.-.-.-.-.-.-.-.-.-.-.-.-.-.-.-.-.-.-.-.-.-.-.-.-.-.-.-.-.-.-.-.-.-.-.-.-.-.-.-.-.-.-.-,-+U+U.-E-.-.-E-.-.-E-.-,-X-----------------
----------------------------------------------------------------------------------------------------,-X-.-.-.-W-.-.-.-.-.-.-.-.-.-.-.-.-.-.-.-.-.-.-.-.-.-.-.-.-.-.-.-.-.-.-.-.-.-.-.-B-.-.-.-.-,-+U+U.-.-.-.-.-.-.-.-.-,-X-----------------
------------------------------------------------------------------------------------------------------,-X-.-.-.-.-.-.-.-.-.-.-.-.-.-.-.-.-.-.-.-.-.-.-.-.-.-.-.-.-.-.-.-.-.-.-.-.-.-.-.-.-.-.-.-,-+U+U.-E-.-.-E-.-.-E-.-,-X-----------------
------------------------------------------------------------------------------------------------------,-X-.-.-.-.-:-.-.-.-.-.-.-.-.-.-.-.-.-.-.-.-.-.-.-.-.-.-.-.-.-.-.-.-.-.-.-.-.-.-.-.-.-.-.-,-+U+U.-.-.-.-.-A-.-.-.-,-X-----------------
------------------------------------------------------------------------------------------------------,-X-.-.-.-.-.-.-.-.-.-.-.-.-.-.-.-.-.-.-.-.-.-.-.-.-.-.-.-.-.-.-.-.-.-.-.-.-.-.-.-.-.-.-.-,-+U+U.-E-.-.-A-.-.-A-.-,-X-----------------
------------------------------------------------------------------------------------------------------,-X-.-.-.-.-.-.-.-.-,-A-,-.-.-.-.-.-A-.-.-.-.-.-.-.-.-.-.-.-.-.-.-.-.-.-.-.-.-.-.-.-.-.-.-,-+U+U.-.-.-.-.-K-.-.-.-,-X-----------------
--------------------------------------------------------------------------------------------------------,-X-.-.-.-.-.-.-.-,-.-,-,-,-,-,-,-.-.-.-.-.-.-.-.-.-.-.-.-.-.-.-.-.-.-.-.-.-.-.-.-.-.-.-,-+U+U,-E-.-.-A-.-.-A-.-,-X-----------------
--------------------------------------------------------------------------------------------------------,-X-.-.-.-.-.-.-,-X-X-X-X-.-.-.-X-X-X-X-X-.-.-.-.-X-X-X-X-.-.-.-.-.-.-.-.-.-.-.-.-.-.-.-,-+U+U,-,-.-.-.-A-.-.-.-,-X-----------------
------------------------------------------------------------------------------------------------------,-,-X-.-.-.-.-,-X-X-,-,-,-X-+-+-+-X-,-,-,-X-.-.-.-.-X-----,-X-X-.-.-.-.-.-.-.-.-.-.-.-.-.-,-+U+U,-E-,-.-E-.-.-E-.-,-X-----------------
------------------------------------------------------------------------------------------------------,-X-.-.-.-,-X-X---,-X-X-X-X-,-,-,-X-X-X-X-X-.-H-.-.-X---------,-X-.-.-.-.-.-.-.-.-.-.-.-.-,-+U+U,-,-,-.-.-.-.-.-.-,-X-----------------
----------------------------------------------------------------------------------------------------,-,-X-.-.-,-X-------,-X-.-.-.-.-.-.-.-.-H-X-X-X-X-X-X-X-,-,-,-,-,-,-X-.-.-.-.-.-.-.-.-.-.-.-,-+U+U.-E-,-.-E-.-.-E-.-,-X-----------------
----------------------------------------------------------------------------------------------------,-X-.-.-,-X---------,-X-.-.-.-.-.-.-.-.-,-X-X-X-X-X-X-,-X-X-X-X-X-X-X-X-.-.-.-.-.-.-.-.-.-.-,-XUXUX-.-.-.-.-.-.-.-.-,-X-----------------
------------------------------------------------------------------------------------------------------,-X-,-X-----------,-X-.-.-.-.-.-.-.-.-,-.-.-.-.-,-X-X-,-,-.-,-,-.-.-X-X-.-.-.-.-.-.-.-.-.-.-X-X-A-.-.-.-E-.-.-E-.-,-X-----------------
--------------------------------------------------------------------------------------------------------,-X-------------,-X-.-,-,-,-,-,-,-.-,-.-.-.-E-,-X-X-.-,-.-,-.-,-,-,-X-X-.-.-.-.-.-.-.-.-.-X-X-,-X-X-.-.-.-.-.-.-X-X-----------------
------------------------------------------------------------------------------------------------------------------------,-X-.-,-.-.-.-.-,-.-,-.-.-.-.-,-.-,-.-A-,-,-,-,-.-.-,-X-.-.-.-.-.-.-.-.-.-.-X-X-,-X5,5,5,5,5,5X5X-,-----------------
------------------------------------------------------------------------------------------------------------------------,-X-.-,-.-.-.-.-,-.-,-X-X-.-.-,-X-X-.-.-,-X-X-X-.-.-.-X-X-.-.-.-.-.-.-.-.-.-.-X-X-X-.-.-.-.-.-X-X-X-----------------
------------------------------------------------------------------------------------------------------------------,-,-,-,-X-B-,-.-.-.-.-,-.-B-X-X-X-X-X-X-X-L-L-L-X-,-X-,-,-,-,-X-.-.-.-.-.-.-.-.-.-.-.-.-.-.-.-.-.-.-.-.-X-----------------
----------------------------------------------------------------------------------------------------------------,-,-X~X~X~X-,-,-,-,-,-,-,-,-,-X-X~X~X-,-X-X-,-,-,-X~X~X4.4.4.4.4X4X-.-.-.-.-.-.-.-.-.-.-.-.-.-.-.-.-.-.-.-X-----------------
----------------------------------------------------------------------------------------------------------------,-X~.~.~.~.~.~.~.~.~.~.~.~.~.~.~.~.~.~.~.~.~.~.~.~X~X~,~.4.4E4.4X4X-.-.-.-.-.-.-.-.-.-.-.-.-.-.-.-.-B-.-.-X-----------------
----------------------------------------------------------------------------------------------------------------,-X~.~.~.~.~.~.~.~.~.~.~.~.~.~.~.~.~.~.~.~.~.~.~.~X~X~,~,4,4,4,4X4,-X-.-.-.-.-.-.-.-.-.-.-.-.-.-.-.-.-.-.-X-,---------------
----------------------------------------------------------------------------------------------------------------,-X~.~.~,~,~,~,~.~.~.~.~.~.~B~.~.~.~.~.~.~.~.~.~.~X~X~,~.4.-.-.-X-,-X-.-.-.-.-.-.-.-.-.-.-.-.-.-B-.-B-.-.-.-X---------------
----------------------------------------------------------------------------------------------------------------,-X~.~,~,~.-.-,-,~.~.~.~E~.~.~.~E~.~.~.~.~.~.~.~.~X~X~,~.-.-.-E-X---X-.-.-.-.-.-.-.-.-.-.-.-.-.-.-B-.-B-.-.-X-,-------------
----------------------------------------------------------------------------------------------------------------,-X~.~,~.-.-.-.-,-.~.~.~.~.~B~H~.~.~.~.~.~.~.~.~.~X~X~,~,-,-,-,-,-X-,-X-.-.-.-.-.-.-.-.-.-.-.-.-.-.-.-.-.-.-.-X-------------
----------------------------------------------------------------------------------------------------------------,-X~.~,~.-.-.-E-,-.~.~.~.~.~.~.~.~.~.~.~.~.~.~.~.~X~X~,~.-.-.-.-.-X-,-X-.-.-.-.-.-.-.-.-.-.-.-.-.-.-.-.-.-.-.-X-------------
----------------------------------------------------------------------------------------------------------------,-X~.~,~.-B-.-.-,-.~.~.~.~.~.~.~.~.~.~.~.~.~.~.~.~X~X~,~.-.-.-.-.-X-,-X-.-.-.-.-.-.-.-.-.-.-.-.-.-.-.-.-.-.-,-X-------------
----------------------------------------------------------------------------------------------------------------,-X~.~,~.-.-.-B-,-.~.~.~.~.~.~.~.~.~.~.~.~.~.~.~.~X~X~,~,-,-,-E-,-X-,-X-X-X-.-.-.-.-.-.-.-.-.-.-.-.-.-.-.-.-X---------------
----------------------------------------------------------------------------------------------------------------,-X~.~,~.-E-.-.-,-.~.~.~.~.~.~.~.~.~.~.~.~.~.~.~.~X~X~,~.-.-.-.-,-X-X-,-,-,-X-.-.-.-.-.-,-,-,-,-,-,-.-.-.-.-X---------------
----------------------------------------------------------------------------------------------------------------,-X~.~,~,-.-H-,-,-.~.~.~.~.~.~.~.~.~.~.~.~.~.~.~.~X~X~,~.-.-.-.-,-.-X-X-X-X-X-A-.-.-.-.-,-.-.-.-.-,-,-.-.-.-X---------------
----------------------------------------------------------------------------------------------------------------,-X~.~.~,~,-,-,-.~.~.~.~.~.~.~.~.~.~.~.~.~.~.~.~.~X~X~,~,-,-,-E-,-.-,-.-,-L-,-.-.-.-.-.-,-.-.-.-.-,-,-,-.-,-X---------------
------------------------------------------------------------------------------------------,-,-,-,-,-,-,-,-------,-X~.~.~.~.~.~.~.~.~.~.~.~.~.~.~.~.~.~.~,~,~,~,~,~X~X~,~.-.-.-.-.-.-,-.-,-L-,-.-.-E-.-.-,-.-.-.-.-,-,-,-,-X-----------------
------------------------------------------------------------------------------------,-,-,-,-X-X-X-X-X-X-X-X-X-,-,-X~X~.~.~.~.~.~.~.~.~.~.~.~.~.~.~.~.~.~,~.-.-.-,-X~X~,~.-.-E-.-.-.-,-.-,-L-,-.-.-.-.-.-,-.-.-.-.-,-,-.-,-X-----------------
------------------------------------------------------------------------------------,-X-X-X-X-X-X-,-,-,-X-X-X-X-X-,-X~X~X~X~X~X~X~X~X~X~X~X~X~X~X~X~X~.~X~X-.-A-.-X-X~X~X-,-,-,-,-.-X-X-X-X-X-A-.-.-.-.-,-.-.-.-.-,-,-.-.-X-----------------
--------------------------------------------------------------------------------------,-X-.-.-.-.-.-.-.-.-.-A-X-X-X-X-X-X-X-X-X-X-X-X-X-X-X-X-X-H-X-X~.~X~X-.-.-.-X---,-X-.-.-.-,-X-X-,-,-,-X-.-.-.-.-.-,-.-.-.-.-,-,-.-.-,-X---------------
----------------------------------------------------------------------------------------,-X-.-.-.-.-.-.-.-.-,-X-X-X-E-X-X-X-E-X-X-X-X-X-X-X-E-X-.-X-X~H~X~X-.-.-.-X---,-X-.-.-.-.-X-,-X-X-X-.-.-.-.-.-.-,-.-.-.-,-,-,-.-.-.-X---------------
----------------------------------------------------------------------------------------,-X-.-.-.-.-.-.-.-,-,-X-X-X-,-X-X-X-.-X-X-X-E-X-X-X-.-X-H-X-X~X~X~X-.-.-.-X---,-X-,-,-,-,-X-,-X-.-.-.-.-.-.-.-.-,-.-.-.-,-.-,-.-.-.-,-X-------------
----------------------------------------------------------------------------------------,-X-.-.-.-.-.-.-.-,-.-X-.-.-.-.-.-.-.-.-X-X-.-X-.-.-.-.-.-X-X-X-X-.-.-A-.-X---,-X-.-.-.-.-X-,-X-.-.-.-.-.-.-.-.-,-,-.-,-,-,-,-.-.-.-.-X-,-----------
----------------------------------------------------------------------------------------,-X-.-.-.-.-.-.-.-,-.-.-.-.-.-.-.-.-.-.-.-.-.-.-.-.-.-.-.-.-.-.-.-.-.-.-.-X-,-,-X-.-.-.-,-X-,-X-.-.-.-.-.-.-.-.-.-,-,-,-.-,-.-.-.-.-,-,-X-----------
--------------------------------------------------------------------------X-----------,-,-X-.-.-.-E-.-.-.-,-,-.-.-.-.-.-.-.-.-.-.-.-.-.-.-.-.-.-.-.-.-A-.-.-.-.-X-,-,-X-,-,-,-.-X-,-,-X-.-.-.-.-B-.-.-.-.-.-,-,-,-,-.-.-.-.-,-.-X-,---------
--------------------------------------------------------------------------X-X-------,-,-X-.-.-.-.-.-.-.-.-,-,-X-.-.-.-.-.-.-.-.-.-.-.-.-.-.-.-.-.-.-.-.-.-.-,-,-X---,-X-.-.-,-,-X-,-X-.-.-.-.-.-.-.-.-.-.-.-.-,-,-.-.-.-.-,-,-.-.-X---------
--------------------------------------------------------------------------X---X-X-X-X-X-.-.-.-.-.-.-.-.-.-,-.-X-X-X-,-X-X-X-,-X-X-X-,-X-X-X-,-X-H-X-X-X-X-X-X-X-----,-X-.-.-.-.-X-,-X-.-.-.-.-.-B-.-B-.-.-.-.-.-,-.-.-,-,-,-.-.-,-X---------
--------------------------------------------------------------------------X-H-E-----,-.-.-.-.-.-.-.-.-.-.-,-.-X-X-X-E-X-X-X-E-X-X-X-E-X-X-X-E-X-.-X-X-X-X-X-X-X-----,-X-,-,-.-X-,-,-X-.-.-.-B-.-H-.-.-.-.-.-.-.-,-,-,-,-.-.-.-,-,-X~--------
--------------------------------------------------------------------------X---X-X-X-X-X-.-.-.-.-.-.-.-.-.-,-,-X-X-X-X-X-X-X-X-X-X-X-X-X-X-X-X-X-H-X-X-<-.-.-H-X---,-,-X-.-,-,-X-,-X-.-.-.-.-.-.-B-.-.-.-.-.-.-.-,-,-.-.-.-.-,-,-.~,~X-------
--------------------------------------------------------------------------X-X---------,-X-.-.-.-.-.-.-.-.-.-,-X-X-,-,-X-X-,-,-X-X-,-,-X-X-,-,-X-X-X-X-.-.-X-X-X-,-X-X-.-.-.-X-,-,-X-.-.-.-.-.-B-.-.-.-.-.-.-.-.-,-.-.-.-.-,-,-.~.~.~X-------
--------------------------------------------------------------------------X-------------,-X-.-.-.-.-.-.-.-.-.-X-X-X-X-X-X-X-X-X-X-X-X-X-X-X-X-X-X-X-X-.-.-X-X-X-X-,-,-,-.-,-X-,-X-.-.-.-.-.-.-.-.-.-.-.-.-.-.-.-,-,-,-,-,-,-.~.~.~.~X~------
----------------------------------------------------------------------------------------,-X-.-.-.-.-.-.-.-.-.-.-.-.-.-.-H-X-.-.-,-.-.-.-.-.-.-.-.-.-.-.-.-,-.-.-.-,-.-,-.-X-,-X-.-.-.-.-.-.-.-.-.-.-.-.-.-.-.-.-,-.~.~.~.~.~.~.~.~.~X~------
----------------------------------------------------------------------------------------,-X-.-.-.-.-.-.-.-E-.-.-.-.-.-.-,-X-.-E-,-.-.-.-.-.-.-.-.-.-.-.-.-,-.-.-.-,-.-,-,-X-X-.-.-.-.-.-.-.-.-.-.-.-.-.-.-.-.-.-,-.~.~.~.~.~.~.~.~.~,~X-----
------------------------------------------------------------------------,-,-------------,-X-.-.-.-.-.-.-.-.-.-.-.-.-.-.-A-X-X-X-X-.-.-.-.-.-.-.-.-.-.-.-.-,-.-.-.-X-X-X-X-X-.-.-.-.-.-.-.-.-.-.-.-.-.-.-.-.-.-.-,-.~.~.~.~.~.~.~.~.~.~X-----
------------------------------------------------------------------------,-X-,---------,-,-X-.-.-.-.-.-.-.-.-.-.-.-.-.-,-,-X-X-X-X-.-.-.-.-,-,-X-X-X-X-X-X-X-X-X-X-X-,-X-X-X-.-.-.-.-.-.-.-.-.-.-.-.-.-.-.-.-.-,-,-.~.~.~.~.~.~.~.~.~.~X~----
------------------------------------------------------------------------,-X-X-,-,-,-,-,-X-.-.-.-.-.-.-.-.-.-.-.-.-.-,-,-.-.-.-.-.-.-.-,-,-X-X-,-,-,-,-,-,-,-,-,-,-,-,-,---,-X-X-X-.-.-.-.-.-.-.-.-.-.-.-.-.-.-,-.-.~.~.~.~.~.~.~.~.~.~X~----
------------------------------------------------------------------------,-X-.-X-X-X-X-X-.-.-.-.-.-.-.-.-.-.-.-.-.-,-,-.-.-.-.-.-.-,-,-X-X-,-,-X-X-X-X-X-X-X-X-X-X-,-X-,-,-,-----,-X-X-.-.-.-.-.-.-.-.-.-.-.-,-,-.~.~.~.~.~.~.~.~.~.~.~,~X---
------------------------------------------------------------------------,-X-H-E-.-.-.-.-.-.-.-.-.-.-.-.-.-.-.-.-,-,-.-.-.-.-.-,-,-X-X-,-,-X-X-.-X-X-.-,-,-,-,-.-X-X-X-X-X-,-,-,-----,-X-.-.-.-.-.-.-.-.-.-.-,-.-.~.~.~.~.~.~.~.~.~.~.~.~X---
------------------------------------------------------------------------,-X-,-X-X-X-X-X-.-.-.-.-.-.-.-.-.-.-.-,-,-.-.-.-.-.-,-X-X-,-,-X-X-.-.-.-.-.-,-,-.-.-,-,-.-.-.-.-.-X-X-,-,-,---,-X-.-.-.-.-.-.-.-.-,-,-.~.~.~.~.~.~.~.~.~.~.~.~.~X~--
------------------------------------------------------------------------,-X-X---------,-X-.-.-.-.-.-.-.-.-.-,-,-.-.-.-.-.-,-X-,-,-X-X-.-.-.-.-.-.-.-,-.-<-.-K-,-.-.-.-.-.-.-.-X-X-,-,---,-X-.-.-.-.-.-.-.-,-.-.~.~.~.~.~.~.~.~.~.~.~.~.~X~--
------------------------------------------------------------------------,-X-------------,-X-.-.-.-.-.-E-.-.-,-.-.-.-.-.-.-X-,-,-X-.-.-.-.-.-.-.-.-.-,-,-.-.-,-,-.-.-.-.-.-.-.-.-.-X-X-,---,-X-.-.-.-.-.-,-,-.~.~.~.~.~.~.~.~.~.~.~.~.~.~,~X-
--------:-:-:---------------------------------------------------------------------------,-X-.-.-.-.-.-.-.-,-,-.-.-.-.-.-X-,-,-X-.-.-.-.-.-.-.-.-.-.-.-,-,-,-,-.-.-.-.-.-.-.-.-.-.-.-X-X---,-X-.-.-.-.-.-,-.-.~.~.~.~.~.~.~.~.~.~.~.~.~.~.~X-
------:-----:---------------------------------------------------------------------------,-X-.-.-.-.-.-.-,-,-.-.-.-.-.-.-X-,-.-X-.-.-.-.-.-.-.-,-,-,-,-,-,-,-,-,-,-,-,-,-.-.-.-.-.-.-.-,-X---,-X-.-.-.-.-,-,~.~.~.~.~.~.~.~.~.~.~.~.~.~.~.~X~
----:-:-:-:-:---------------------------------------------------------------------------,-X-.-.-.-.-.-.-,-.-.-.-.-.-.-X-,-,-X-.-.-.-.-.-.-,-,-,-.~.~.~.~.~.~.~.~.~.~.~,-,-,-.-.-.-.-.-.-X---,-X-.-.-.-.-.-,-.~.~.~.~.~.~.~.~.~.~.~.~.~.~.~X~
--------:-:-:-------------------------------------------------------------------------,-,-X-.-.-.-.-.-,-,-.-.-.-.-.-.-X-,-.-X-.-.-.-.-E-,-,-.~.~,~,~,~,~,~,~,~,~,~.~.~.~.~,-,-.-.-.-.-.-,-X---,-X-.-.-.-.-,-,~.~.~.~.~.~.~.~.~.~.~.~.~.~.~X~
----------------------------------,-,-,-,-,-,-,-------------------------------------,-,-X-.-.-.-.-.-.-,-.-.-.-.-.-.-X-,-,-X-.-.-.-.-,-,-.~.~,~,~,~.~.~.~.~.~.~.~,~,~,~.~.~.~,~.-.-.-.-.-.-X---,-X-.-.-.-.-.-,-.~.~.~.~.~.~.~.~.~.~.~.~.~.~X~
------------------------------,-,-,-X-X-X-X-X-X-,-----------------------------------,-X-X-X-.-.-.-W-,-,-.-.-.-.-.-.-X-,-.-X-.-.-.-.-,-.-.~,~,~.~.~.~,~,~,~,~,~.~.~.~,~,~,~.~,~,-.-.-.-.-.-,-X-,-X-.-.-.-.-.-,-,~.~.~.~.~.~.~.~.~.~.~.~.~.~X~
----------------------------,-,-X-X-.-W-.-H-.-.-X-,-------------------------------------,-X-.-.-:-.-,-.-.-.-,-,-,-X-,-,-X-.-.-.-.-,-,-.~.~,~.~.~,~,~,~.~.~.~,~,~,~.~.~.~,~,~.~,~.-.-.-.-.-.-X---,-X-.-.-.-.-.-,-.~.~.~.~.~.~.~.~.~.~.~.~.~X~
----------------------------,-X-.-.-.-.-.-.-.-.-.-X-------------------------------------,-X-.-.-.-.-,-.-.-,-,-,-,-X-,-.-X-.-.-.-.-,-.-.~,~,~.~,~,~.~.~.~.~.~.~.~,~,~,~.~.~,~.~E~,-.-.-.-.-.-,-X-,-X-.-.-.-.-.-,-,~.~.~.~.~.~.~.~.~.~.~.~.~X~
----------------X-X---------,-X-A-.-A-.-W-.-H-.-H-X-,-,-,-,-,-,-,-,-,-,-,-,-,-,-,-,-----,-X-.-.-.-.-,-.-A-X-X-L-X-X-,-X-X-.-.-.-.-,-.~.~,~.~.~,~.~.~.~.~.~.~.~.~.~.~,~,~.~,~,~.~,~.-.-.-.-.-X-X-,-X-.-.-.-.-.-.-,-.~.~.~.~.~.~.~.~.~.~.~.~X~
------------X-X-----X-X-----,-X-.-.-.-.-.-.-.-.-.-X-X-X-X-X-X-X-X-X-X-X-X-X-X-X-X-X-----,-X-X-.-.-.-X-X-.-X-X-L-X-X-X-X-X-.-.-.-.-,-.~,~,~.~,~,~.~.~.~,~,~,~,~.~.~.~.~,~.~.~,~.~,~.-.-.-.-.-X-X-,-X-.-.-.-.-.-.-,-.~.~.~.~.~.~.~.~.~.~.~.~X~
X-X-X-X-X-X-,-,-,-,-,-,-X-X-X-X-,-,-,-,-,-,-,-,-,-,-,-,-,-,-,-,-,-,-,-,-,-,-,-,-,-X-----,-,-X-+-+-+-X-X-.-X-X-.-.-,-X-X-.-.-.-.-.-,-.~,~.~.~,~.~.~.~,~,~+~+~+~,~.~.~.~,~,~.~,~.~,~.-.-.-.-.-.-X-,-X-.-.-.-.-.-.-,-.~.~.~.~.~.~.~.~.~.~.~.~X~
X-.~.~.~.~.~.~.~.~.~.~.~.~.~.~.~.~.~.~.~.~.~.~.~.~.~.~.~.~.~.~.~.~.~.~.~.~.~.~.~,~X-----,-X-X-.-.-.-X-X-.-X-X-W-.-,-X-X-.-.-.-.-.-,-.~,~.~,~,~.~.~,~,~+~,~,~,~+~,~.~.~.~,~.~,~.~,~.-.-.-.-.-.-X-,-X-.-.-.-.-.-.-,-.~.~.~.~.~.~.~.~.~.~.~.~X~
X-.~.~.~.~.~.~.~.~.~.~.~.~.~.~.~.~.~.~.~.~.~.~.~.~.~.~.~.~.~.~.~.~.~.~.~.~.~.~.~,~X-----,-X-.-.-.-.-,-.-A-X-X-.-.-+S.-,-.-.-.-.-.-,-.~,~.~,~.~.~.~,~+~,~.~.~,~,~+~.~.~.~,~.~,~.~,~.-.-.-.-.-.-X-,-X-.-.-.-.-.-.-,-.~.~.~.~.~.~.~.~.~.~.~.~X~
X-.~.~.~.~.~.~.~.~.~.~.~.~.~.~.~.~.~.~.~.~.~.~.~.~.~.~.~.~.~.~.~.~.~.~.~.~.~.~.~,~X-----,-X-.-.-.-E-,-.-.-X-X-.-.-+S.-,-.-.-.-.-.-,-.~,~.~,~.~.~.~,~+~,~.~,~,~,~+~.~.~.~,~.~,~.~,~.-.-.-.-.-.-X-,-X-.-.-.-.-.-.-,-.~.~.~.~.~.~.~.~.~.~.~.~X~
X-.~.~.~.~.~.~.~.~.~.~.~.~.~.~.~.~.~.~.~.~.~.~.~.~.~.~.~.~.~.~.~.~.~.~.~.~.~.~.~,~X-----,-X-.-.-.-.-,-.-.-X-X-.-.-,-.-,-.-.-.-.-.-,-.~,~.~,~.~.~.~,~+~,~,~,~,~,~+~.~.~,~,~.~,~.~,~.-.-.-.-.-.-X-,-X-.-.-.-.-.-.-,-.~.~.~.~.~.~.~.~.~.~.~X~,-
X-.~.~.~.~.~.~.~.~.~.~.~.~.~.~.~.~.~.~.~.~.~.~.~.~.~.~.~.~.~.~.~.~.~.~.~.~.~.~.~,~X-----,-X-.-.-.-.-,-.-.-X-X-A-.-,-X-X-.-.-.-.-.-E-.~,~.~,~,~.~.~.~,~+~,~,~,~+~.~.~.~,~.~.~,~.~,~.-.-.-.-.-.-X-,-X-.-.-.-.-.-.-,-.~.~.~.~.~.~.~.~.~.~.~X~--
X-.~.~.~.~.~.~.~.~.~.~.~.~.~.~.~.~.~.~.~.~.~.~.~.~.~.~.~.~.~.~.~.~.~.~.~.~.~.~.~,~X-----,-X-.-.-.-.-,-.-A-X-X-H-.-H-X-X-X-.-.-.-.-,-.~,~.~.~,~.~.~.~.~,~+~+~+~.~.~.~,~,~.~,~,~.~,~.-.-.-.-.-X-X-,-X-.-.-.-.-.-.-,-.~.~.~.~.~.~.~.~.~.~X~,---
X-.~.~.~.~.~.~.~.~.~.~.~.~.~.~.~.~.~.~.~.~.~.~.~.~.~.~.~.~.~.~,~,~,~,~,~,~,~,~,~,~X-----,-X-.-.-.-.-,-,-.-X-X-X-X-X-X-,-X-.-.-.-.-,-.~,~,~.~,~,~.~.~.~.~.~.~.~.~.~.~,~E~.~,~.~.~,~.-.-.-.-.-X-,-,-X-.-.-.-.-.-,-,-.~.~.~.~.~.~.~.~.~.~X~----
X-,~,~,~,~.~.~.~.~.~.~.~.~.~.~.~.~.~.~.~.~.~.~.~.~.~.~.~.~.~.~,~,---X-X-X-X-X-X-X-X-----,-X-.-.-A-.-.-,-.-.-.-.-.-X-,-X-X-.-.-.-.-,-,~.~,~.~.~,~,~,~.~.~.~.~.~.~.~,~,~.~,~,~.~.~,~.-.-.-.-.-X-X-,-X-.-.-.-.-.-,-.-.~.~.~.~.~.~.~.~.~X~,-----
X-.-.-.-,-.~.~.~.~.~.~.~.~.~.~.~.~.~.~.~.~.~.~.~.~.~.~.~.~.~.~,~--X---------------------,-X-.-.-.-.-.-,-.-A-.-.-.-X-,-X-.-.-.-.-.-.-,-.~,~,~.~.~.~,~,~,~.~.~.~,~,~,~.~.~,~.~.~,~,-.-.-.-.-.-X-,-,-X-.-.-.-.-,-,-.~.~.~.~.~.~.~.~.~.~X~------
X-.-.-.-,-.~.~.~.~.~.~.~.~.~.~.~.~.~.~.~.~.~.~.~.~.~.~.~.~.~.~,~X-----------------------,-X-.-.-.-.-.-,-,-.-.-.-.-.-X-,-X-.-.-.-.-.-,-,~.~,~,~,~.~.~.~,~,~,~,~,~.~.~.~,~,~.~.~,~.-.-.-.-.-.-X---,-X-.-.-.-.-,-.-.~.~.~.~.~.~.~.~.~X~,-------
X-.-.-.-,-.~.~.~.~.~.~.~.~.~.~.~.~.~.~.~.~.~.~.~.~.~.~.~.~.~.~,~X-----------------------,-X-.-.-.-.-.-.-,-.-.-E-.-.-X-,-X-.-.-.-.-.-.-,-.~.~.~,~,~,~.~.~.~.~.~.~.~,~,~,~.~.~,~,-.-.-.-.-.-X-,-,-,-X-.-.-.-.-,-.~.~.~.~.~.~.~.~.~.~X~--------
X-.-.-.-,-.~.~.~.~.~.~.~.~.~.~.~.~.~.~.~.~.~.~.~.~.~.~.~.~.~.~,~X-----------------------,-X-.-.-.-.-.-.-,-,-.-.-.-.-.-X-,-X-.-.-.-.-.-,-,~.~.~.~.~,~,~,~,~,~,~,~,~,~.~.~,~,~,~.-.-.-.-.-.-X---,-X-.-.-.-.-.-,-,-.~.~.~.~.~.~.~.~.~,~X-------
X-.-.-.-,-.~.~.~.~.~.~.~.~.~.~.~.~.~.~.~.~.~,~,~,~,~,~,~,~,~,~,~X-,-,-,-,-,-,-,-,-,-,-,-,-X-,-.-.-.-.-.-.-,-.-.-A-.-.-X-,-X-.-.-.-.-.-.-,-,-,~.~.~.~.~.~.~E~.~.~.~.~,~,~,~.-.-.-.-.-.-.-X-,---,-X-.-.-.-.-.-.-,-.~.~.~.~.~.~.~.~.~.~X~------
X-.-.-.-,-.~.~.~.~.~.~.~.~.~.~.~.~.~.~.~.~,~,~.-.-.-.-.-.-.-.-,-XQXQX-X-X-X-X-X-X-X-X-X-XPX-,-.-.-.-.-.-.-,-,-.-.-.-.-.-X-,-X-.-.-.-.-.-.-.-,-,-,~,~,~,~,~,~,~,~,~,~,~.-.-.-.-.-.-.-.-.-X---,-,-X-.-.-.-.-.-.-,-.~.~.~.~.~.~.~.~.~.~,~X-----
X-.-.-.-,-.~.~.~.~.~.~.~.~.~.~.~.~.~.~.~.~,~.-.-.-.-.-.-.-.-.-,-+Q+Q.-.-.-.-.-.-.-.-.-.-.0,-,-.-.-.-.-.-.-.-,-.-.-.-.-.-X-,-X-X-.-.-.-.-.-.-.-.-.-.-.-.-.-.-.-.-.-.-.-.-.-.-.-.-.-,-X-X-,---,-X-.-.-.-.-.-.-.-,-.~.~.~.~.~.~.~.~.~.~.~X~----
X-.-.-.-,-.~.~.~.~.~.~.~.~.~,~,~,~,~,~,~,~,~.-.-.-.-.-.-.-.-.-,-XQXQX-X-X-X-X-X-X-X-X-X-XPX-,-.-.-.-.-.-.-.-,-,-.-.-.-.-.-X-,-X-X-.-.-.-.-.-.-.-.-.-.-.-.-.-.-.-.-.-.-.-.-.-.-.-.-X---X---,-,-X-.-.-.-.-.-.-.-,-,-.~.~.~.~.~.~.~.~.~.~,~X---
X-.-.-.-,-.~.~.~.~.~.~.~.~.~,~H-----------,-.-.-.-B-B-.-.-.-.-.-X-----,-,-,-------------,-X-.-.-.-.-.-.-.-.-.-,-.-.-A-E-.-X-,-,-X-X-.-.-.-.-.-.-.-.-.-.-.-.-.-.-.-.-.-.-.-.-.-.-,-X-X---,-,-X-.-.-.-.-.-.-.-.-.-,-.~.~.~.~.~.~.~.~.~.~.~X~--
X-.-.-.-,-.~.~.~.~.~.~.~.~.~,~--E---------,-.-.-.-B-B-.-.-.-.-.-X---,-,-X/X/,-,---------,-X-H-.-.-.-.-.-.-.-.-,-,-.-.-.-.-.-X-,-,-,-X-X-.-.-.-.-.-.-.-.-.-.-.-.-.-.-.-.-.-.-,-X-X-----,-,-X-.-.-.-.-.-.-.-.-.-.-,-.~.~.~.~.~.~.~.~.~.~.~,~X-
X-.-.-.-,-.~.~.~.~.~.~.~.~.~,~,-,-,-,-,-,-,-.-.-.-.-.-.-.-.-.-.-X---,-X-X-X-X-X---------,-X-.-.-.-.-.-.-.-.-.-.-,-,-.-.-.-.-.-X-,-,-,-,-X-X-.-.-.-.-.-.-.-.-.-.-.-.-.-X-,-X-X-----,-,-,-X-.-.-.-.-.-.-.-.-:-.-.-,-.~.~.~.~.~.~.~.~.~.~.~.~X~
X-.-.-.-,-,~.~.~.~.~.~.~.~.~.~.~.~.~,~.-,-,-.-.-.-.-.-.-.-.-.-.-X---,-X-.-E-H-X---------,-X-.-.-,-,-,-,-.-.-.-.-.-,-,-.-.-A-.-.-X-X-,-,-,-,-X-X-X-X-.-.-.-.-.-.-.-.-X-X-X-----,-,-,-X-X-.-.-.-.-.-.-.-.-.-.-.-.-,-.~.~.~.~.~.~.~.~.~.~.~.~X~
X-.-.-.-.-,-,~,~,~,~,~,~,~,~,~,~,~,~,~,-,-,-,-,-.-.-.-.-.-.-.-.-X---,-X-.-.-.-X---------,-X-.-.-,-.-.-,-.-.-.-.-.-.-,-,-.-.-.-.-.-.-X-X-,-,-,-,-X-X-X-X-X-X-X-+~+~+~X~----,-,-,-X-X-.-.-.-.-.-.-.-.-.-.-.-.-.-.-,-.~.~.~.~.~.~.~.~.~.~.~.~X~
X-.-.-.-.-,-.-.-.-.-.-.-.-.-.-.-.-.-.-.-.-.-.-,-.-.-.-.-.-.-.-X-X-,-,-X-.-.-.-X-,-,-,-,-,-X-.-.-,-.-.-,-A-.-.-.-.-.-.-,-,-.-.-.-.-A-.-.-X-X-,-,-,-,-,-,-,-,-X~+~+~+~X~--,-,-X-X-.-.-.-.-.-.-.-.-.-.-.-.-.-.-.-.-,-.~.~.~.~.~.~.~.~.~.~.~.~X~
X-.-.-.-,-,-.-<-.-.-.-.-.-.-.-.-.-.-.-.-.-.-.-,-.-.-.-.-.-.-.-X-X-X-X.X....-.-X-X-X-X-XOXOX-.-.-,-,-,-,-.-.-.-.-.-.-.-.-,-,-,-.-.-.-.-E-.-.-X-X-X-X-X-X-X-X-X~+~+~+~X~--,-X-.-.-.-.-.-.-.-.-.-.-.-.-.-.-.-H-.-,-,-.~.~.~.~.~.~.~.~.~.~.~.~X~
X-.-.-.-,-.-.-.-.-.-.-.-.-.-.-.-.-.-.-.-.-.-.-,-.-.-.-.-.-.-.-.-+-,-.......-.-.-.-.-,-+O+O,-.-.-.-.-A-.-,-,-,-,-.-.-.-.-.-.-,-,-,-.-.-.-.-A-.-.-.-.-.-H-,2X-X~+~+~+~X~----,-X-.-.-.-.-.-.-.-.-.-.-.-.-.-.-.-,-,-.~.~.~.~.~.~.~.~.~.~.~.~.~X~
X-.-.-.-,-.-.-<-.-.-.-.-.-.-.-.-.-.-.-.-.-.-.-,-.-.-.-.-.-.-.-.-+-,-.......-.-.-.-.-,-+O+O,-.-.-.-.-.-.-,-.-.-,-.-.-.-.-.-.-.-.-,-,-,-.-.-.-.-.-.-A-.-,-,2.-,-+~+~+~X~------,-X-.-.-.-.-.-.-.-.-.-.-.-.-.-,-,-.~.~.~.~.~.~.~.~.~.~.~.~.~.~X~
X-.-.-.-,-,-.-<-.-<-.-.-.-.-.-.-.-.-.-.-.-.-.-,-.-.-.-.-.-.-.-.-+-,-.......-.-.-.-.-,-+O+O,-.-.-.-.-.-.-,-.-.-,-A-.-.-.-.-.-.-.-.-.-,-,-,-.-.-.-.-.-.-H-,-X-X-.~.~.~X~--------,-X-.-.-.-.-.-.-.-,-,-,-,-,-,-.~.~.~.~.~.~.~.~.~.~.~.~.~.~.~X~
X-.-.-.-.-,-,-,-,-,-,-,-,-,-,-,-,-,-,-,-,-,-,-,-.-.-.-.-.-.-.-X-X-X-X.X....-.-X-X-X-X-XOXOX-.-.-.-.-.-.-,-,-,-,-.-.-.-.-.-:-.-.-.-.-.-.-,-,-,-,-,-,-,-,-,-X-X~.~.~.~X~----------,-X-.-.-.-.-.-.-,-X~.~.~.~.~.~.~.~.~.~.~.~.~.~.~.~.~.~,~,~X~
X-.-.-.-.-,---------------------------,-.-,-.-.-.-.-.-.-.-.-.-X-X---,-X-.-.-.-X---------,-X-.-.-.-.-.-.-.-.-.-.-.-.-.-.-.-.-A-.-.-.-.-.-.-.-.-.-.-.-.-.-H-X-X~.~.~.~X~------------,-X-.-.-.-,-X-X-X-.~.~.~.~.~.~.~.~.~.~.~.~.~.~.~,~,~X~X---
X-.-.-.-,-,-----------------,-,-,-,-,-,-,-,-,-.-,-,-,-,-.-.-.-.-X---,-X-.-.-.-X---------,-X-.-.-.-.-.-.-.-.-.-.-.-.-.-.-.-.-.-.-.-.-.-.-.-.-.-.-.-E-.-.-,-X-X-.~.~.~X~--------------,-X-X-X-X---,-,-X~.~.~.~.~.~.~.~.~.~.~.~.~.~.~X~X-------
X-.-.-.-,-----------------,-,-.-.-.-.-.-.-.-,-,-,-.-.-,-,-.-.-.-X---,-X-,-E-A-X---------,-X-,-,-,-,-,-.-.-.-.-.-.-.-.-.-.-.-.-.-.-.-.-.-.-.-,-,-,-,-,-.-,-X-,-.~.~.~X~------------------------,-,-X~.~.~.~.~.~.~.~.~.~.~.~.~.~.~X~,---------
X-.-.-.-,-----------------,-.-.-.-.-.-.-.-.-,-,-.-B-B-.-,-.-.-.-X---,-X-X.X.X-X---------,-X-,-.-.-.-,-,-.-.-.-.-.-.-.-.-.-.-.-.-.-.-.-.-.-.-,-.-.-.-,-,-A-X-X-.~.~.~X~----------------------,-,-X~.~.~.~.~.~.~.~.~.~.~.~.~.~.~.~X~----------
X-.-.-.-,-----------------,-.-.-E-.-.-.-.-.-,-,-.-B-B-.-,-.-.-.-X-----------------------,-X-,-.-.-+R+R,-.-.-.-.-.-.-.-.-.-.-.-.-.-.-.-.-.-.-,-.-.-+R+R,-X-X-X~.~A~.~X~--------,-,-,-,-,-,-,-,-X~.~.~.~.~.~.~.~.~.~.~.~.~.~.~.~X~,-----------
X-.-.-.-,-----------------,-.-.-.-.-.-.-.-.-,-,-,-.-.-,-,-.-.-.-X-----------------------,-X-X-X-.-H-.-X-X-X-.-.-.-.-.-.-.-.-.-.-.-.-.-.-.-X-X-X-.-H-.-X-X-,-X~.~.~.~X~--------,-X~X~X~X~X~X~X~.~.~.~.~.~.~.~.~.~.~.~.~.~.~.~.~X~------------
X-.-.-.-,-----------------,-,-,-,-,-,-,-,-,-,-.-,-,-,-,-.-.-.-.-X-----------------------,-,-,-X-X-X-X-X-,-X-,-,-,-,-,-,-,-,-,-,-,-,-,-,-,-X-,-X-X-X-X-X---,-X~.~.~.~X~,-------,-X~.~.~.~.~.~.~.~.~.~.~.~.~.~.~.~.~.~.~.~.~.~X~,-------------
X-.-.-.-,---------------------------------,-,-.-.-.-.-.-.-.-.-,-X-----------------------,-X-X-X-X-X-X-X-X-X-,-,-,-,-,-,-,-,-,-,-,-,-,-,-,-X-X-X-X-X-X-X-X-X-X~.~.~.~.~X~,-,-,-,-X~X~X~.~.~.~.~.~.~.~.~.~.~.~.~.~.~.~.~.~.~.~X~--------------
X-.-.-.-,-----------------------------------,-,-,-,-,-,-,-,-,-,-X~----------------------,-X-.-.-.-.-.-.-.-.-.-.-.-.-.-.-.-.-.-.-.-.-.-.-.-,---------------X-X~.~.~.~.~.~X~X~X~X~X~X~X~.~.~.~.~.~.~.~.~.~.~.~.~.~.~.~.~.~.~X~,---------------
X-.-.-.-,-----------------------------------------------------,-X~----------------------,-X-.-.-.-.-.-.-.-.-.-.-.-.-.-.-.-.-.-.-.-.-.-.-.-,---------------X-X~.~.~.~.~:~.~.~.~.~.~.~.~.~.~.~.~.~.~.~.~.~.~.~.~.~.~.~.~,~,~X~----------------
X-.-.-.-,-----------------------------------------------------,-X~----------------------,-X-,-,-,-,-,-,-,-,-,-,-,-,-,-,-,-,-,-,-,-,-,-,-,-,---------------X-X~.~.~.~.~.~.~A~.~.~.~.~.~.~.~.~.~.~.~.~.~.~.~.~.~.~.~,~,~X~X-------------------
X-.-.-.-,---------------------------------------------------,-,-X~------------------------X-X-X-X-X-X-X-X-X-X-X-X-X-X-X-X-X-X-X-X-X-X-X-X-X-X-X-X-X-X-X-X-X-X~.~.~H~.~.~.~.~.~.~.~.~.~.~.~.~.~.~.~.~.~.~.~.~.~,~,~X~X-----------------------
X-.-.-.-,---------------------------------------------------,-.-X~,---------------------------------------------------------------------------------------,-X~.~.~.~.~,~X~X~X~X~X~X~X~.~.~.~.~.~.~.~.~.~.~,~,~X~X---------------------------
X~,-,-,-,---------------------------------------------------,-.-.~X~,-,-,-,-,-,-,-,-,-,-,-,-,-,-,-,-,-,---------------------------------------------------,-X~.~.~.~,~X~------,-X~X~X~.~.~.~.~.~.~.~.~,~,~X~X-------------------------------
X~----------------------------------------------------------,-.-.~.~X~X~X~X~X~X~X~X~X~X~X~X~X~X~X~X~X~X~------------------------------------------------,-,-X~.~.~.~X~--------,-X~.~.~.~.~.~.~.~.~,~,~X~X-----------------------------------
X~----------------------------------------------------------,-,~,-,-,-,-,-,-------------,-.~.~.~.~X~X~X~,-,-,-,-,-,-,-,-,-,-,-,-,-,-,-,-,-,-,-,-,-,-,-,-,-X~.~.~.~.~X~--------,-X~.~.~.~.~.~.~,~,~X~X---------------------------------------
X~,-------------------------------------------------------------------------------------,-.~.~.~.~X~X~X~X~X~X~X~X~X~X~X~X~X~X~X~X~X~X~X~X~X~X~X~X~X~X~X~X~.~.~.~.~,~X~----------,-X~.~.~.~,~,~X~X-------------------------------------------
X~,-----------------------------------------------------------------------------------,-,-.~.~.~.~.~.~.~.~.~.~.~.~.~.~.~.~.~.~.~.~.~.~.~.~.~.~.~.~.~.~.~.~.~.~E~,~X~--------------,-X~X~X~X~X-----------------------------------------------
X~,-----------------------------------------------------------------------------------,-.-.~.~.~.~.~.~.~.~.~.~.~.~.~.~.~.~H~.~.~.~.~.~.~.~.~.~.~.~.~.~.~.~.~.~,~X~--------------------------------------------------------------------------
X~,-----------------------------------------------------------------------------------,-.-.~.~.~.~.~.~.~.~.~.~.~.~.~.~.~.~.~.~.~.~.~.~.~.~.~.~.~.~.~.~.~.~.~,~X~----------------------------------------------------------------------------
X~,-,-,-,-,-,-,-,-,-,-,-,-,-,-,-,-,-,-,-,-,-,-,-,-,-,-,-,-,-,-,-,-,-,-,-,-,-,-,-,-,-,-,-.-.~.~.~.~X~X~X~X~X~X~X~X~X~X~X~X~X~X~X~X~X~X~X~X~X~X~X~X~X~X~X~X~X~X~------------------------------------------------------------------------------
X~.~.~.~.~.~.~.~.~.~.~.~.~.~.~.~.~.~.~.~.~.~.~.~.~.~.~.~.~.~.~.~.~.~.~.~.~.~.~.~.~.~.~.~.~.~.~.~.~X~X~X~------------------------------------------------------------------------------------------------------------------------------------
X~X~X~X~X~X~X~X~.~.~.~.~.~,~X~X~X~X~X~X~X~X~X~.~.~.~.~.~.~.~.~,~X~X~X~X~X~X~X~X~X~X~X~X~X~X~X~X~X~X~X~X~------------------------------------------------------------------------------------------------------------------------------------
--------------,-X~X~.~,~X~X-----------------,-X~X~.~.~,~X~X~X-X-----------------------------------------------------------------------------------------------------------------------------------------------------------------------------
------------------,-X~X-------------------------,-X~X-X-------------------------------------------------------------------------------------------------------------------------------------------------------------------------------------
