------------------------------,-,-,-X-X-X-X-,-----------------------------------------------------------------------------------------------------------------------------------------------------------
----------------------,-,-,-,-,-X-X-X-,-,-X-X-X-X-X-X-X-X-X-X-X-X-X-X-X---------------------------------------------------------------------------------------------------------------------------------
----------------------,-X-X-X-,-X-.-.-.-.-.-,-----,-,-,-,-,-,---------X---------------------------------------------------------------------------------------------------------------------------------
----------------------,-X-.-X-,-X-.-.-.-.-.-,---,-,-,-.-.-.-,-,-------X---------------------------------------------------------------------------------------------------------------------------------
----------------------,-X-.-X-,-X-.-.-.-.-.-,-E-,-.-.-.-.-.-.-,-------X---------------------------------------------------------------------------------------------------------------------------------
----------------------,-X-.-X-,-X-.-<-.-.-.-,-,-.-.-.-.-.-.-.-,-,---,-X-,-,-,-,-,-----------------------------------------------------------------------------------------------------------------------
----------------------,-X-.-X-X-X-.-.-.-.-.-,-,-.-.-.-.-.-.-.-.-,---,-X-X-X-X-X-X-----------------------------------------------------------------------------------------------------------------------
----------------------,-X-.-.-.-.-.-<-.-.-.-,-,-.-.-.-.-.-.-.-.-,---,-.-.-.-.-.-,-X---------------------------------------------------------------------------------------------------------------------
------------------------,-X-X-X-X-.-.-.-.-.-,-,-,-.-.-.-.-.-.-.-,---,-X-X-X-X-X-.-X-,-------------------------------------------------------------------------------------------------------------------
------------------------------,-X-.-<-.-.-.-,---,-.-.-.-.-.-.-,-,-----X-----,-X-.-.-X-------------------------,-,-,-,-,---------------------------------------------------------------------------------
------------------------------,-X-.-.-.-.-.-,-E-,-,-.-.-.-,-,-,-------X-------,-X-.-X-------------------------,-X-X~X~X---------------------------------------------------------------------------------
------------------------------,-X-.-<-.-.-.-,-----,-,-,-,-,-----------X-------,-X-.-X-------------------------,-X~.~.~X~------------,-,-,-,-,-,-,-,-----------------------------------------------------
------------------------------,-X-,-,-,-,-,-,-----------------------X-X-------,-X-E-X-------------------------,-X~.~K~X~------------,-X~X~X~X~X~X~X~X-X-------------------------------------------------
--,-,-,-,-,-,-,-,-,-,-,-,-,-,-,-X-X-X-.-.-X-X-X-X-X-X-X-X-X-X-X-X-X-X-,-,-,-,-,-X-.-X-,-,-,-,-,-,-,-----------,-X~.~.~X~----,-,-,-,-,-X~.~.~.~.~.~,~,-X-,-,-,-,-,-,-------------------------------------
,-,-X-X-X-X-X-X-X-X-X~X~X~X~X~X~,-,-X-X-X-X-X-X-,---------------,-X-X-X-X-X-X-X-X-,-X-X-X-X-X-X-X-X-,-,-,-,-,-,-X~.~.~X~,-,-,-X-X-X-X~X~.~.~.~.~.~,~,~X~X~X-X-X-X-X-------------------------------------
,-X-.-H-.-.-.-.-.-,-.~.~.~.~.~.~X~X0X-X/X/X/A-.-X-,-------------,-X-.-.-.-.-.-.-.-.-.-.-.-.-.-.-.-X-X-X-X-X-X-X-X-,~,~X-X-X-X-X-H-,-.~.~.~.~.~.~,~,~.-,-,~.-.-B-H-X-------------------------------------
,-X-.-.-.-.-.-.-.-,-.~.~.~.~.~.~,~,0W-././,/.-.-H-X-,-,-,-,-,-,-,-X-.-.-.-.-.-.-.-.-.-.-.-.-:-H-.-X-X-.-.-E-.-X-X~.~.~X~X-.-X-X-.-,-.~.~.~.~.~.~,~.-.-.-,-.-.-.-.-X-------------------------------------
,-X-.-.-.-.-.-.-.-,-.~.~.~.~.~.~,~X0X-X/X/X/.-<-.-X-X-X-X-X-X-X-X-XT.-W-.-.-A-.-.-.-.-.-.-.-.-.-,-X-X-.-.-.-.-X-X~,~,~X~X-,-X-X-.-,-.~.~.~.~.~.~,~.-.-.-,-.-.-.-B-X-------------------------------------
,-X-.-.-:-.-.-,-,-,-,~,~,~,~,~,~,~X~X-X-X-X-.-.-.-.-.-E-X-X-.-E-.-+T,-,-,-,-,-.-.-.-.-.-.-.-.-.-,-X-X-.-.-.-.-,-,-.-,-,-.-,-X-X-.-,-.~.~.~.~.~.~,~.-A-.-,-.-.-.-.-X-------------------------------------
,-X-.-.-.-.-.-,-.-.-.-.-.-.-.-.-.-.-,7.-.-.-.-.-.-.-.-.-X-X-.-.-.-+T,-.-.-.-,-.-.-.-.-.-.-.-.-.-,-L-L-.-.-.-.-,-.-.-,-,-.-E-.-,-.-,-.~.~.~.~.~.~,~.-E-.-,-.-.-.-.-X-------------------------------------
,-X-.-.-.-.-.-,-,-,-,-,-,-,-,-E-,-,-,7.-.-.-.-.-.-.-.-H-X-X-.-.-.-+T,-,-:-,-,-.-.-.-.-.-.-.-.-.-,-L-L-.-.-.-.-,-,-T-,-,-.-,-X-X-.-,-.~.~.~.~.~.~,~.-.-.-,-.-.-.-.-X-------------------------------------
,-X-.-.-.-.-.-,-.-,-,-,-,-,-,-,-,-,-,7.-.-.-.-.-.-.-.-E-X-X-,-E-.-+T.-,-,-,-.-.-.-.-.-.-.-.-.-.-,-L-L-.-.-.-.-,-,-,-,-,-.-.-X-X-.-,-.~.~.~.~.~.~,~.-.-.-,-.-.-.-.-X-------------------------------------
,-X-.-.-.-.-.-,-,-,-.~.~.~.~.~.~.~X~X-X-.-.-.-.-.-X-X-X-X-X;t;t;.-+T.-H-.-.-.-.-.-.-.-.-.-.-.-.-,-X-X-.-.-.-.-,-.-.-.-,-.-.-X-X-.-,-.~.~.~.~.~.~,~.-.-,-,-.-.-.-.-X-------------------------------------
.-X-.-.-.-.-.-.-.-,-.~.~.~.~.~.~.~X~,-,-X-.-.-.-X-X-----,-X-.-t;.-+T.-.-.-.-.-.-.-.-.-.-.-.-.-.-.-X-X-.-.-.-.-,-,-,-,-,-.-.-,-.-.-,-.~.~.~.~.~.~,~,-,-,-,~.-.-.-.-X-------------------------------------
X-,-A-.-.-.-.-.-.-,-.~.~.~.~.~.~.~X~,-,-X-,-,-,-X-,-,-,-,-X-X-X;X-XT.-.-.-.-.-.-.-.-.-.-.-.-.-.-.-X-X-.-.-.-.-.-.-.-.-.-.-.-X-X-.-,-.~.~.~.~.~.~.~.~.~.~,~.-.-.-B-X-------------------------------------
X-,-.-.-.-.-.-.-.-,-.~.~.~.~.~.~.~X~X-X-X-.-.-.-X-X-X-,-,-------,-X-,-,-,-,-,-,-,-,-,-,-,-,-,-,-,-X-X-,-.-.-.-.-.-.-.-.-.-.-X-X-.-,-.~.~.~.~.~.~.~.~.~.~,~.-.-.-.-X-------------------------------------
,-X-.-.-.-.-.-.-.-,-.~.~.~.~.~.~.~,~,-,-,-E-,-,-,-,-,-X-X-,-----,-X-,-,-,-,-,-,-,-,-,-,-,-,-,-,-,-X-X-,6.-.-.-.-.-.-.-.-.-.-X-X-.-,-.~.~.~.~.~.~.~.~.~.~,~.-.-.-B-X-------------------------------------
,-X-.-.-.-.-.-.-.-,-.~.~.~.~.~.~.~X~X-,-.-.-.-.-.-.-.-,-.-X-----,-X-,-,-,-,-,-,-,-,-,-,-,-,-,-,-,-X-X-,6.-.-.-.-.-.-.-.-.-.-X-X-.-,-.~.~.~.~.~.~.~.~.~.~,~.-.-.-.-X-------------------------------------
,-X-.-.-.-.-.-.-.-,-.~.~.~.~.~.~.~X~X-X-X-X-X-X-X-X-X-,-,-,-X---,-X-,-,-,-,-,-,-,-,-,-,-,-,-,-,-,-X-X-,6.-.-.-.-.-.-.-.-.-.-X-X-.-,-.~.~.~.~.~.~.~.~.~.~,~.-.-.-.-X-------------------------------------
,-X-.-.-:-.-.-.-.-,-.~.~.~.~.~.~.~X~----------------,-X-,-.-X---,-X-.-.-.-.-.-.-.-.-.-.-.-.-.-.-.-X-X-,-.-.-.-.-.-,-,-,-,-.-X-X-.-,-.~.~.~.~.~.~.~.~.~.~,~.-.-.-.-X-------------------------------------
,-X-.-.-.-.-.-.-.-,-.~.~.~.~.~.~.~X~,---------------,-X-,-E-X---,-X-.-.-.-.-.-.-.-.-.-.-.-.-.-.-.-X-X-,-,-,-.-.-.-,-.6.6:6A-X-X-.-,-.~.~.~.~.~.~.~.~.~.~,~.-.-E-.-X-------------,-,-,-------------------
,-X-.-.-.-.-.-.-.-,-.~.~.~.~.~.~.~.~X---------------,-X-,-.-X---,-X-.-.-.-.-.-.-.-.-.-.-.-.-.-.-,-X-X-X-.-X-X-X-X-X-X-X-X-X-X-X-.-,-.~.~.~.~.~.~.~.~.~.~,~.-.-.-.-X-------------,-X-X-,-----------------
,-X-.-.-.-.-.-.-.-,-.~.~.~.~.~.~.~.~X~,-----------,-,-X-,-.-X-,-,-X-.-.-.-.-.-.-.-.-.-.-.-.-.-.-,-X-X-X-,-X-X-X-X-X-X-X-X-X-X-X-.-,-.~.~.~.~.~.~.~.~.~.~,~.-B-.-.-X-------------,-X-X-XT,-,-------------
,-X-.-.-.-.-.-.-.-,-.~.~.~.~.~.~.~.~.~X---------,-,-X-X-,-,-X-X~X~X-.-.-.-.-.-.-.-.-.-.-.-.-.-.-,-,-.-.-E-,-.-.-.-.-.-.-.-.-E-.-,-,-.~.~.~.~.~.~.~.~.~.~,~.-.-.-.-X-----------X-X-XT+TXTX-X-------------
,-X-.-.-.-.-.-.-.-,-.~.~.~.~.~.~.~.~.~X~,-,-,-,-,-X~,-,-.~.~.~.~X~X-.-.-.-.-.-.-.-E-.-.-.-.-.-.-,-X-.-.-.-,-,-.-,-,-,-,-,-,-,-,-,-.~.~.~.~.~.~.~X~X~X~.~,~.-.-.-X-X-----X-X-X-X-X-X:t:X:X-X-X-X-X-------
X-.-A-.-.-.-.-.-.-,-.~.~.~.~.~.~.~.~.~.~X~X~X~X~X~.~.~.~.~.~.~.~X~X-.-:-.-.-.-.-.-.-.-.-.-.-.-.-,-X-X1.-.-.-,-.-,-.-,-.-,-,-.-.-,-.~.~.~.~.~.~.~X~,-X~.~,~.-.-.-X-,---X---------------------------X-X---
X-.-.-.-.-.-.-.-.-,-.~.~.~.~.~.~.~.~.~.~.~.~.~.~.~.~.~.~.~.~.~.~X~X-.-.-.-.-.-.-.-.-.-.-.-.-.-:-,-X-X1.-.-.-,-.-,-.-,-.-,-,-.-.-,-.~.~.~.~.~.~.~X~X~X~.~,~.-.-.-X-X---X-E-------------------------E---X-
,-X-.-.-.-.-.-.-.-,-.~.~.~.~.~.~.~.~.~.~.~.~.~.~.~.~.~.~.~.~.~.~X~X-:-.-,-,-,-,-,-,-,-,-,-.-.-.-,-X-.-.-.-.-,-.-,-.-,-.-,-,-.-.-,-.~.~.~.~.~.~.~.~.~.~.~,~.-.-.-.-X-X---------------------------------X-
,-X-.-.-.-.-.-.-.-,-.~.~.~.~.~.~.~.~.~.~.~.~.~.~.~.~.~.~.~.~.~.~X~X-X-X-X-X-X-X-X-,-X-,-X-X-X-X-X-X-X-.-X-X-X-X-X-X-X-X-X-X-X-X-X-X~X~.~.~.~.~.~.~.~.~.~,~.-B-.-.-X-X---------------------------------X-
,-X-.-.-.-.-.-.-.-,-.~.~.~.~.~.~.~.~.~.~.~.~.~.~.~.~.~.~.~.~.~.~X~X~X~X~X~X~.~.~.~.~.~.~X~X~X~X~X~X1X2,2X2X1X~X~X~X~X~X~X~X~X~X~X~X~X~.~.~.~.~.~.~.~.~.~,~.-.-.-.-X-X---------------------------------X-
,-X-.-.-:-.-.-.-.-,-.~.~.~.~.~.~.~.~.~.~.~.~.~.~.~.~.~.~.~.~.~.~.~.~.~.~.~.~.~.~.~.~.~.~.~.~.~.~X~X1.1.1.1X1X~.~.~.~.~.~.~.~.~.~.~.~.~.~.~.~.~.~.~.~.~.~,~.-.-.-.-X-X---------------------------------X-
,-X-.-.-.-.-.-.-.-,-.~.~.~.~.~.~.~.~.~.~.~.~.~.~.~.~.~.~.~.~.~.~.~.~.~.~.~.~.~.~.~.~.~.~.~.~.~.~,~.1.1.1.1,1.~.~.~.~.~.~.~.~.~.~.~.~.~.~.~.~.~.~.~.~.~.~,~.-.-.-.-X-X-,-,-,-,-,-,-,-,-,-,-,-,-,-,-,-,-X-
,-X-.-.-.-.-.-.-.-,-.~.~.~.~.~.~.~.~.~.~.~.~.~.~.~.~.~.~.~.~.~.~.~.~.~.~.~.~.~.~.~.~.~.~.~.~.~.~,~.1.1.1.1,1.~.~.~.~.~.~.~.~.~.~.~.~.~.~.~.~.~.~.~.~.~.~,~.-.-E-.-X-X-.-.-.-.-.-.-.-.-.-.-.-.-.-.-,-.-X-
,-X-.-.-.-.-.-.-.-,-.~.~.~.~.~.~.~.~.~.~.~.~.~.~.~.~.~.~.~.~.~.~.~.~.~.~.~.~.~.~.~.~.~.~.~.~.~.~,~.1.1.1.1,1.~.~.~.~.~.~.~.~.~.~.~.~.~.~.~.~.~.~.~.~.~.~,~.-.-.-,-X-X-.-B-.-.-.-.-.-.-.-.-.-.-.-A-,-.-X-
,-X-.-.-.-.-.-.-.-,-.~.~.~.~.~.~.~.~,~,~,~,~,~,~,~.~.~.~.~.~.~.~.~.~.~.~.~.~.~.~.~.~.~.~.~.~.~.~,~.1.1.1.1,1.~.~.~.~.~.~.~.~.~.~.~.~.~.~.~.~.~.~X~X~X~.~,~.-.-.-,-X]X].-B-.-.-.-.-.-.-.-.-.-.-.-.-,-.-X-
,-X-.-.-.-.-.-.-.-,-.~.~.~.~.~.~.~,~,~X-X-.-.-.-X-X~,~.~.~.~.~.~.~.~.~.~.~.~.~.~.~.~.~.~.~.~.~.~,~.1.1.1.1,1.~.~.~.~.~.~.~.~.~.~.~.~.~.~.~.~.~.~X~,-X~.~,~.-.-.-,-+]+].-B-.-.-<-.-.-.-.-E-.-.-.-.-W-.-X-
,-X-.-.-.-.-.-.-.-,-.~.~.~.~.~.~,~,~X-.-.-.-.-.-,-X-X-,~.~.~.~.~.~.~.~.~.~.~.~.~.~.~.~.~.~.~.~.~,~.1.1.1.1,1.~.~.~.~.~.~.~.~.~.~.~.~.~.~.~.~.~.~X~X~X~.~,~.-.-.-,-X]X].-B-.-.-.-.-.-.-.-.-.-.-.-.-,-.-X-
,-X-.-.-.-.-.-.-.-,-,~.~.~.~.~.~,~.-.-.-:-:-:-:-.-,-.-,-.~.~.~.~.~.~.~.~.~.~.~.~.~.~.~.~.~.~.~.~,~.1.1.1.1,1.~.~.~.~.~.~.~.~.~.~.~.~.~.~.~.~.~.~.~.~.~.~,~.-.-.-.-X-X-,-B-,-,-,-,-,-,-,-,-,-,-,-A-,-.-X-
,-X-.-.-.-.-.-.-.-.-,-.~.~.~.~.~,~.-.-.-:-.-.-:-.-,-.-,-.~.~.~.~.~.~.~.~.~.~.~.~.~.~.~.~.~.~.~.~,~.1.1.1.1,1.~.~.~.~.~.~.~.~.~.~.~.~.~.~.~.~.~.~.~.~.~.~,~.-.-E-.-X-X-.-.-.-.-.-.-.-.-.-.-.-.-.-.-.-.-X-
--X-.-.-.-.-.-.-.-.-,-,~,~.~.~.~,~X-.-.-:-.-t;:-.-,-X-X-.~.~.~.~.~.~.~.~.~.~.~.~.~.~.~.~.~.~.~.~,~.1.1.1.1,1.~.~.~.~.~.~.~.~.~.~.~.~.~.~.~.~.~.~.~.~.~.~,~.-.-.-.-X-X-.-.-.-.-.-.-.-.-.-.-.-.-.-.-.-.-X-
--,-X-.-.-.-.-.-.-.-.-.-,~,~,~.~,~X-.-.-:-:-:-:-.-.-X-X~.~.~.~.~.~.~.~.~.~.~.~.~.~.~.~.~.~.~.~.~,~.1.1.1.1,1.~.~.~.~.~.~.~,~,~,~.~.~.~.~.~.~.~.~.~.~.~,~,~,-.-.-.-X-X-.-.-.-.-.-.-.-.-.-.-.-.-.-.-.-.-X-
----X-.-.-.-.-.-.-.-.-.-.-.-,~,~,~X-.-.-.-.-.-.-.-.-X-X~,~,~,~,~,~,~,~,~,~,~,~,~,~,~,~,~,~,~,~,~X~X1,1,1,1X1X~.~.~.~.~.~.~,~.-,-,~,~,~,~,~,~,~,~,~,~,~,~.-,-B-.-.-X-X-.-.-.-.-.-.-.-.-.-.-.-.-.-.-.-.-X-
----,-X-.-.-.-.-.-.-.-.-.-.-.-.-A-X-.-.-.-.-.-.-.-.-X-X-.-.-.-.-.-.-.-.-.-.-.-.-.-.-.-.-.-.-,-X-X~X-.-.-X-X1X~X~.~.~.~.~.~,~,-,-.-.-.-.-.-.-.-.-.-.-.-,-,-,-.-.-.-X-X-.-.-.-.-.-.-.-.-.-.-.-.-.-.-.-.-X-
------,-X-.-.-.-.-.-.-E-.-.-.-.-,-X-.-.-.-.-.-.-.-.-X-X-.-.-.-.-.-.-.-.-.-.-.-.-.-.-.-.-.-.-,-X-X-X-.-.-X-X-,-X~.~.~.~.~.~.~,~.-B-.-.-B-.-.-.-.-.-.-.-.-B-.-.-.-.-X-X-.-.-.-.-.-.-.-.-.-.-.-.-.-.-.-.-X-
--------,-X-X-.-.-.-.-.-.-.-.-E-,-.-.-.-.-.-.-.-.-.-,-.-.-.-.-E-.-.-.-.-.-E-.-.-.-.-.-E-.-.-,-.-.-.-.-.-.-X-,-X~.~.~.~.~.~.~,~.-.-.-.-.-.-.-.-.-X-X-X-.-.-.-.-.-.-X-X-.-E-.-.-.-.-.-.-.-.-.-.-.-.-E-X-,-
----------,-,-X-X-.-.-.-.-.-.-.-A-X-.-.-.-.-.-.-.-.-X-X-,-,-,-.-.-.-.-.-.-.-.-.-.-.-.-.-.-.-,-X-X-X-.-.-.-X-,-X~.~.~.~.~.~.~,~.-,-,-,-,-,-,-.-.-X-,-X-.-.-.-.-.-H-X-,-X-X-.-.-.-,-,-,-,-,-.-.-.-,-,-X---
--------------,-,-X-X-X-X-X-X-X-X-X-X-XU+U.5.5.5,5X-X-X-X-.-X-X-X-,-X-X-X-,-X-X-X-,-X-X-X-,-X-X-,-XR,2,2,2XR,-X~X~X~X~X~X~X~X~X-X-X-.-.-.-X-X-X-X-,-X-X-X-X-X-X-X-X---,-,-X-X-X-X-X4X4X-X-X-X-X-X-X-----
----------------------------------,-XXXU+U.5.5.5,5XX--,-X-,-X-X-X-.-X-X-X-.-X-X-X-.-X-X-X-.-X-X-,-X-E-.-E-X-,-,-,-,-,-,-,-,-,-,-,-X-.-.-.-X-----------------------------------X-X---,-X-X---------------
----------------------------------,-XXX-.-.-.-.-,-XX--,-X-A-.-.-.-.-.-.-.-.-.-.-.-.-.-.-.-.-H-X-,-X-.-.-,-.-X-X-X-X-X-X-X-X-X-X-X-.-.-E-.-X-------------------------------------------------------------
------------------------,-,-,-,-,---,-X-A-.-.-.-A-X---,-X-.-.-.-.-.-.-.-.-.-.-.-,-,-,-,-,-,-.-X-X-X-E-.-E-.-.-,-.-,-.-,-.-,-.-,-.-.-.-.-.-X-------------------------------------------------------------
------------------------,-X-X-X-X---,-XX+X+X+X+X+XXX--,-X-.-.-.-.-E-.-.-.-.-.-E-,-.9.9.9.9,9.-.-<-,-.-.-,-.-.-,-.-,-.-,-.-,-.-,-.-.-.-.-X-,-------------------------------------------------------------
------------------------,-X-.-.-X-,-,-XX+X+X+X+X+XXX--,-X-.-.-.-.-.-.-.-.-.-.-.-,-.9.9.9.9,9.-.-.-,-.-.-,-.-.-,-.-,-.-,-.-,-.-,-.-.-,-,-X---------------------------------------------------------------
------------------------,-X-.-.-X-,-XXX-.-.-.-.-,-XX--,-X-A-,-,-,-,-,-,-,-,-,-,-,-.9.9.9.9,9,-X-X-X-X-X-X-X-X-X-X-X-X-X-X-X-X-X-X-X-X-X-----------------------------------------------------------------
------------------------,-X-.-.-X-,-XXX-.-E-.-E-,-XX--,-X-.-.-.-.-.-.-.-.-.-.-.-,-.9.9.9.9,9.-X---,-,-,-,-,-,-,-,-,-,-,---------------------------------------------------------------------------------
------------------------,-X-.-.-X---,-X-,-,-,-,-,-X---,-X-A-.-A-.-A-.-.-.-.-.-.-,-,9,9,9,9,9.-X---,-X-X-X-X-X-X-X-X-X-X---------------------------------------------------------------------------------
------------------------,-X-.-.-X---,-X-.-.-.-.-.-X---,-X-.-E-.-.-E-.-.-.-.-.-.-.-.-.-.-.-.-.-X---,-X-.-.-.-.-.-.-.-.-X---------------------------------------------------------------------------------
------------------------,-X-.-.-X-,-,-X-.-.-.-.-.-X-,-,-X-.-.-.-.-.-.-.-.-.-.-.-.-.-.-.-.-.-.-X-,-,-X-.-.-.-.-.-.-H-.-X---------------------------------------------------------------------------------
------------------------,-X-.-.-.-X-X-.-.-.-.-.-.-,-X-X-.-.-.-.-.-.-.-.-.-.-.-.-.-.-.-.-.-.-.-,-X-X-.-.-.-.-.-.-.-.-.-X---------------------------------------------------------------------------------
------------------------,-X-.-.-.-.-,-,-,-,-,-,-,-,-.-,-.-.-.-.-.-.-.-.-.-.-.-.-.-.-.-.-.-.-.-,-.-X-X-.-.-.-.-.-.-E-.-X---------------------------------------------------------------------------------
------------------------,-X-X-X-X-,-,-.-.-.-.-.-.-,-,-,-.-.-.-.-.-.-.-.-.-.-.-.-.-.-.-.-.-.-.-,-.-X-X-.-.-.-.-.-.-.-.-X---------------------------------------------------------------------------------
--------------------------------,-X-,-,-,-,-,-,-,-,-,-,-.-.-.-.-.-.-.-.-.-.-.-.-.-.-.-.-.-.-.-,-.-.-.-.-.-.-.-E-.-A-.-X---------------------------------------------------------------------------------
--------------------------------,-X-,-.-.-.-.-.-.-,-.-,-.-.-.-.-.-.-.-.-.-.-.-.-.-.-.-.-.-.-.-,-.-.-.-.-.-.-.-.-.-.-.-X---------------------------------------------------------------------------------
--------------------------------,-X-,-,-,-,-,-,-,-,-.-,-.-.-.-.-.-.-.-.-.-.-.-.-.-.-.-.-.-.-.-,-.-.-.-.-.-.-.-.-.-E-.-X---------------------------------------------------------------------------------
--------------------------------,-X-,-.-.-.-.-.-.-,-,-,-.-.-.-.-.-.-.-.-.-.-.-.-.-.-.-.-.-.-.-,-.-X-X-.-.-.-.-.-.-.-.-X---------------------------------------------------------------------------------
--------------------------------,-X-,-,-,-,-,-,-,-,-,-.-.-.-.-.-.-.-.-.-.-.-.-.-.-.-.-.-.-E-.-,-.-X-X-.-.-.-.-E-.-A-.-X---------------------------------------------------------------------------------
--------------------------------,-X-,-.-.-.-.-.-.-.-,-.-.-.-.-.-.-.-.-.-.-.-.-.-.-.-.-.-.-.-.-,-.-.-.-.-.-.-.-.-.-.-.-X---------------------------------------------------------------------------------
--------------------------------,-X-,-,-,-,-,-,-,-,-,-.-.-.-.-.-.-.-.-A-.-W-.-A-.-.-.-.-.-.-.-,-.-.-.-.-.-.-.-.-.-E-.-X---------------------------------------------------------------------------------
--------------------------------,-X-,-.-.-.-.-.-.-.-.-.-.-.-.-.-.-.-.-.-.-.-.-.-.-.-.-.-.-.-.-,-.-.-.-.-.-.-.-.-.-.-.-X---------------------------------------------------------------------------------
--------------------------------,-X-.-.-.-.-.-.-.-.-.-.-.-.-.-.-.-.-.-.-.-.-.-.-.-.-.-.-.-.-.-,-.-X-X-.-.-.-.-E-.-A-.-X---------------------------------------------------------------------------------
--------------------------------,-X-.-.-.-.-.-.-.-.-.-.-.-.-.-.-.-.-.-.-.-.-.-.-.-.-.-.-.-.-.-,-.-X-X-.-.-.-.-.-.-.-.-X---------------------------------------------------------------------------------
--------------------------------,-X-.-.-.-.-.-.-.-.-.-.-.-.-.-.-.-.-.-.-.-.-.-.-.-.-.-.-.-.-.-,-.-.-.-.-.-.-.-.-.-E-.-X---------------------------------------------------------------------------------
--------------------------------,-X-.-.-.-.-.-.-.-.-.-.-.-.-.-.-.-.-.-.-.-.-.-.-.-.-.-.-.-.-.-,-.-.-.-.-.-.-.-.-.-.-.-X---------------------------------------------------------------------------------
--------------------------------,-X-.-.-.-.-.-.-.-.-.-.-.-.-.-.-.-.-.-.-.-.-.-.-.-.-.-.-.-.-.-,-.-.-.-.-.-.-.-.-.-H-.-X---------------------------------------------------------------------------------
--------------------------------,-X-.-.-.-.-.-.-.-.-.-.-.-.-.-.-.-.-.-.-.-.-.-.-.-.-.-.-.-.-.-,-,-X-X-.-.-X-X-.-.-.-.-X---------------------------------------------------------------------------------
--------------------------------,-X-.-.-.-.-.-.-.-.-.-.-.-.-.-.-.-.-.-.-.-.-.-.-.-.-.-.-.-.-.-.-,-X-X-.-.-X-X-.-.-.-.-X---------------------------------------------------------------------------------
--------------------------------,-X-.-.-.-.-.-.-.-.-.-.-.-.-.-.-.-.-.-.-.-.-.-.-.-.-.-.-.-.-.-.-.-,-,-,-,-,-,-,-,-,-,-X---------------------------------------------------------------------------------
--------------------------------,-X-.-.-.-.-.-.-.-.-.-.-.-.-.-.-.-.-.-.-.-.-.-.-.-.-.-.-.-.-.-.-.-.-.-.-.-.-.-,-------X---------------------------------------------------------------------------------
--------------------------------,-X-.-.-.-.-.-.-.-.-.-.-.-.-.-.-.-.-.-.-.-.-.-.-.-.-.-.-.-.-.-.-.-.-.-.-.-.-.-,-------X---------------------------------------------------------------------------------
--------------------------------,-X-.-.-.-.-.-.-.-.-.-.-,-X-X-,-.-.-.-.-.-.-.-X-X-X-.-.-.-.-.-.-.-.-.-.-.-.-.-,-------X---------------------------------------------------------------------------------
--------------------------------,-X-,-,-,-,-,-,-,-,-,-,-X---X-,-.-.-.-.-.-.-.-X-,-X-.-.-.-.-.-.-.-.-.-.-.-.-.-,-------X---------------------------------------------------------------------------------
--------------------------------,-X-.-.-.-.-.-.-.-.-.-.-X---X-,-.-.-.-.-.-.-.-X---,-X-,-,-,-,-,-,-,-,-,-,-,-,-,-------X---------------------------------------------------------------------------------
------------------------:-:-:-:-,-X-.-.-.-.-.-.-.-.-.-.-X-,-X-,-.-.-.-.-.-.-.-X-----X-----------------------------------X-------------------------------------------------------------------------------
----------------------:---:-:-:-,-X-.-.-.-.-.-.-.-.-.-.-X-,-X-,-.-,-,-,-,-,-.-X-----X-----------------------------------X-------------------------------------------------------------------------------
------------------------:-----:-,-X-.-.-.-.-.-.-.-.-.-.-X-,->->->->->->->->->->-----X-----------------------------------X-------------------------------------------------------------------------------
--------------------------:-:-:-,-X-.-.-.-.-.-.-.-.-.-.-X---X-,-.-.-.-.-.-.-.-X-----X-----------------------------------X-------------------------------------------------------------------------------
--------------------------------,-X-.-.-.-.-.-.-.-.-.-.-X---X-,-.-.-.-.-.-.-.-X-----X-----------------------------------X-------------------------------------------------------------------------------
--------------------------------,-X-.-.-.-.-.-.-.-.-.-.-X---X-,-.-E-.-.-.-E-.-X-----X-----------------------------------X-------------------------------------------------------------------------------
--------------------------------,-X-.-.-.-.-.-.-.-.-.-.-X---X-,-.-.-.-.-.-.-.-X-----X-----------------------------------X-------------------------------------------------------------------------------
--------------------------------,-X-.-.-.-.-.-.-.-.-.-.-X---X-,-.-.-.-.-.-.-.-X-----X-----------------------------------X-------------------------------------------------------------------------------
--------------------------------,-X-.-.-.-.-.-.-.-.-.-.-X---X-,-.-.-.-.-.-.-.-X-----X-----------------------------------X-------------------------------------------------------------------------------
--------------------------------,-X-.-.-.-.-.-.-.-.-.-.-X---X-,-.-.-.-.-.-.-.-X-----X-----------------------------------X-------------------------------------------------------------------------------
--------------------------------,-X-.-.-.-.-.-.-.-.-.-.-X---X-,-.-.-.-.-.-.-.-X-----X-------------------------------------X-----------------------------------------------------------------------------
--------------------------------,-X-.-.-.-.-.-.-.-.-.-.-X---X-X-X-X-X-X-X-X-X-X-----X-------------------------------------X-----------------------------------------------------------------------------
--------------------------------,-X-.-.-.-.-.-.-.-.-.-.-X---------------------------X-------------------------------------X-----------------------------------------------------------------------------
--------------------------------,-X-X-.-.-.-.-.-.-.-,-X-X---------------------------X-X-X-X-X-----------------------------X-----------------------------------------------------------------------------
------------------------------------,-X-X-X-.-.-,-X-X-----------------------------------------X-X-X-X-X-X-X-X-X-X---------X-----------------------------------------------------------------------------
------------------------------------------,-X-X-X-----------------------------------------------------------------X-X-X-X-X-----------------------------------------------------------------------------
