----------------------------------------------------------------,-X->->->-X-------------------------------------------------------------------
----------------------------------------------------------------,-X-,-,-,-X-------------------------------------------------------------------
----------------------------------------------------------------,-X-,-,-X-X-------------------------------------------------------------------
----------------------------------------------------------------,-X-,-,-X-X-------------------------------------------------------------------
----------------------------------------------------------------,-X-,-E-,-X-------------------------------------------------------------------
----------------------------------------------------------------,-X-,-,-.-X-------------------------------------------------------------------
----------------------------------------------------------------,-X-,-,-,-X-------------------------------------------------------------------
----------------------------------------------------------------,-X-,-E-,-X-------------------------------------------------------------------
----------------------------------------------------------------,-X-,-,-,-X-------------------------------------------------------------------
----------------------------------------------------------------,-X-,-E-,-X-------------------------------------------------------------------
----------------------------------------------------------------,-X-,-,-.-X-------------------------------------------------------------------
----------------------------------------------------------------,-X-,-,-,-X-------------------------------------------------------------------
----------------------------------------------------------------,-X-,-E-,-X-------------------------------------------------------------------
--------------------------------------------------------------,-,-X-.-.-.-X-------------------------------------------------------------------
------------------------------------------------------------,-,-X-X-,-,-,-X-,-,---------------------------------------------------------------
----------------------------------------------------------,-,-X-.-.-,-,-.-.-X-X-,-------------------------------------------------------------
----------------------------------------------------------,-X-,-,-,-,-,-.-,-,-.-X-,-----------------------------------------------------------
--------------------------------------------------------,-,-X-,-,-.-.-,-,-,-,-.-.-X-----------------------------------------------------------
--------------------------------------------------------,-X-.-H-,-.-.-.-.-.-,-H-.-X-----------------------------------------------------------
--------------------------------------------------------,-X-,-,-,-.-.-.-.-.-,-,-.-X-----------------------------------------------------------
--------------------------------------------------------,-X-,-,-<-<-.-<-<-,-,-,-.-X-----------------------------------------------------------
--------------------------------------------------------,-X-.-,-.-.-.-.-.-,-.-.-.-X-----------------------------------------------------------
--------------------------------------------------------,-X-.-A-,-,-,-.-.-,-,-A-,-X-----------------------------------------------------------
----------------------------------------------------X-X-X-X-.-,-,-.-,-,-,-,-,-.-X---X-X-X-----------------------------------------------------
--------------------------------------------------X-------X-X-.-.-.-,-,-.-.-.-,-X---X-----X---------------------------------------------------
------------------------------------------------X---------X-,-X-X-,-,-,-,-.-,-X---X---------X-------------------------------------------------
----------------------------------------------X-------------X---,-X-.-.-X-X-X-X-X-------------X-----------------------------------------------
--------------------------------------------X-----------------X-X-X-,-,-X-X-X-------------------X---------------------------------------------
------------------------------------------X-------------------------------------------------------X-------------------------------------------
------------------------------X-X-X-X-X-X-----------------------------------------------------------X-X-X-X-X---------------------------------
--------------------------X-X---------------------------------------------------------------------------------X-X-----------------------------
----------------------X-X---------------------------------------,-,-,-,-,-,---------------------------------------X-X-------------------------
------------------X-X-------,-,-,-,-,-,-,-,-,-,-,-,-,-,-,-,-,-,-,-.-.-.-.-,-,-,-,-,-,-,-,-,-,-,-,-,-,-,-,-,-,---------X-X---------------------
----------------X-------,-,-,-.-.-.-.-.-.-.-.-.-.-.-.-.-.-.-.-.-,-.-.-.-.-,-.-.-.-.-.-.-.-.-.-.-.-.-.-.-.-.-,-,-,---------X-X-----------------
--------------X-----,-,-,-.-.-.-.-.-.-.-.-.-.-.-.-.-.-.-.-.-.-.-,-.-.-W-.-,-.-.-.-.-.-.-.-.-.-.-.-.-.-.-.-.-.-.-,-,-,---------X---------------
------------X---,-,-,-.-.-.-.-.-.-.-.-.-.-.-.-.-.-.-.-.-.-.-.-.-,-.-.-.-.-,-.-.-.-.-.-.-.-.-.-.-.-.-.-.-.-.-.-.-.-.-,-,-,-------X-------------
----------X---,-,-.-.-.-.-.-.-.-.-.-.-.-.-.-.-.-.-.-.-.-.-.-.-.-,-.-.-A-.-,-.-.-.-.-.-.-.-.-.-.-.-.-.-.-.-.-.-.-.-.-.-.-,-,-,-----X-----------
--------X-----,-.-.-.-.-.-.-.-.-.-.-.-.-.-.-.-.-.-.-.-.-.-.-.-.-,-.-.-.-.-,-.-.-.-.-.-.-.-.-.-.-.-.-.-.-.-.-.-.-.-.-.-.-.-.-,-,-----X---------
--------X---,-,-.-.-.-.=.-.-.-.-.-.-.-.-.-.-.-.-.-.-.-.-.-.-.-.-,-,-,-,-,-,-.-.-.-.-.-.-.-.-.-.-.-.-.-.-.-.-.-.-.-.-.-.:.-.-.-,-------X-------
------X-----,-.-.-.-E-.=.-.-.-.-.-.-.-.-.-.-.-.-.-.-.-.-.-.-.-,-,-,-,-.-.-.-.-.-.-.-.-.-.-.-.-.-.-.-.-.-.-.-.-.-.-.-.-.:E-.-.-,-,-----X-------
------X---,-,-.-.-.=.=.=.-.-.-.-.-.-.-.-.-.-.-.-.-.-.-.-.-.-.-,-.-.-,-.-.-.-.-.-.-.-.-.-.-.-.-.-.-.-.-.-.-.-.-.-.-.-.-.:.:.:.-.-,-------X-----
----X-----,-.-.-.-.-.-.-.-.-.-.-.-.-.-.-.-.-.-.-.-.-.-.-.-.-X-X-,-,-,-.-.-.-.-X-X-.-.-.-.-,-,-,-,-,-,-,-.-.-.-.-.-.-.-.-.-.-.-.-,-,-----X-----
----X---,-,-.-.-.-.-.-.-.-.-.-.-.-.-.-.-X-X-X-.-X-X-X-X-X-X-.-X-X-X-.-.-.-X-X-.-X-X-X-X-X-X-X-,-X-X-X-,-,-,-.-.-.-.-.-.-.-.-.-.-.-,-------X---
--X-----,-.-.-.-.-.-.-.-.-.-.-.-.-.-.-.-X-.-.-.-.-X-X-.-.-X-X-X-.-.-.-.-.-.-X-X-X-.-.-X-X-X-.-.-.-X-X-.-.-,-,-.-.-.-.-.-.-.-.-.-.-,-,-----X---
--X---,-,-.-.-.-.-.-.-.-.-.-.-.-.-.-.-.-X-.-.-.-.-X-X-.-.-.-.-.-.-.-.-.-.-.-.-.-.-.-.-.-X-.-.-.-.-X-X-.-.-.-,-,-.-.-.-.-.-.-.-.-.-.-,-------X-
X-----,-.-.-.-.-.-.-.-.-.-.-.-.-.-.-E-.-X9.-.-.-.-.-.-.-.-E-.-.-.-.-.-.-.-.-.-.-.-E-.-.-.-.-.-.-.-X-X8.-E-.-.-,-,-.-.-.-.-.-.-.-.-.-,-------X-
X-----,-.-.-.-.-.-.-.-.-.-.-.-.-.-.-.-.-.9.-.-.-.-X-X-.-.-.-.-.-.-.-.-<-.-.-.-.-.-.-.-.-X-.-.-.-.-,-.8.-.-.-.-.-,-.-.-.-.-.-.-.-.-.-,-------X-
X-----,-.-.-.-.-.-.-.-.-.-.-.-.-E-.-E-.-X9.-.-.-.-X-X-.-.-.-.-.-.-.-.1.1.1.-.-.-.-.-.-.-X-.-.-.-.-X-X8.-E-.-E-.-,-,-.-.-.-.-.-.-.-.-,-------X-
X-----,-.-.-.-.-.-.-.-.-.-.-.-.-.-.-.-.-X-.-.-.-.-X-X-.-.-.-.-.-.-.-.-.-.-.-.-.-.-.-.-.-X-.-.-.-.-X-X-.-.-.-.-.-.-,-.-.-.-.-.-.-.-.-,-------X-
X-----,-.-.-.-.-.-.-.-.-.-.-.-.-E-.-.-.-X-.-.-.-X-.-X-.-.-.-.-.-.-.-.-.-.-.-.-.-.-.-.-.-X-X-.-.-.-X-X-.-.-.-.-.-E-,-,-.-.-.-.-.-.-.-,-------X-
X-----,-.-.-.-.-.-.-.-.-.-.-,-,-,-X-X-X-X-.-.-.-X-.-X-.-.-.-.-.-.-.-.-E-.-.-.-.-.-.-.-.-X-.-X-.-.-X-X-X-X-,-,-,-,-.-,-.-.-.-.-.-.-.-,-------X-
X-----,-.-.-.-.-.-.-.-X-X-X-X-X-,-X-X-X-X-.-.-.-X-.-X-.-.-.-.-.-.-.-.-.-.-.-.-.-.-.-.-.-X-.-X-.-.-X-X-X-X-X-,-,-X-X-X-.-.-.-.-.-.-.-,-------X-
X-----,-.-.-.-.-.-.-.-X-X-E-.-.-.-.-.-.-X-.-.-.-X-.-X-.-.-.-.-.-.-.-.-.-.-.-.-.-.-.-.-.-X-.-X-.-.-X-X-.-.-.-.-.-.-A-X-.-.-.-.-.-.-.-,-------X-
X-----,-.-.-.-.-.-.-.-X-X-.-.-.-.-.-.-.-X5.-.-.-X-.-X-.-.-.-.-.-.-.-.-.-.-.-.-.-.-.-.-X-.-.-X-.-.-X/X/.-.-.-.-.-.-.-X-.-.-.-.-.-.-.-,-------X-
X-----,-.-.-.-.-.-.-.-X-X-.-.-.-.-.-.-.-.5.-.-.-X-.-.-X-.-.-.-.-.-.-.-.-.-.-.-.-.-.-.-X-.-.-X-.-.-././.-.-.-.-.-.-.-X-.-.-.-.-.-.-.-,-------X-
X-----,-.-.-.-.-.-.-.-.-.-.-.-.-.-.-.-.-X5.-.-.-X-.-.-.-X-.-.-.-.-.-.-.-.-.-.-.-.-.-X-.-.-.-X-.-.-X/X/.-.-.-.-.-.-:-X-.-.-.-.-.-.-.-,-------X-
X-----,-.-.-.-.-.-.-.-X-X-.-.-.-.-.-.-.-X-.-.-.-X-.-.-X-X-X-X-.-.-.-.-.-.-.-.-.-.-X-X-X-.-.-X-.-.-X-X-.-.-.-.-.-.-.-X-.-.-.-.-.-.-.-,-------X-
X-----,-.-.-.-.-.-.-.-X-X-.-.-.-.-.-.-.-X-.-.-.-X-.-X-.-.-X-.-X-X-X-.-.-.-X-X-X-X-X-.-.-X-.-X-.-.-X-X-.-.-.-.-.-.-.-X-.-.-.-.-.-.-.-,-------X-
X-----,-.-.-.-.-.-.-.-X-X-.-.-.-.-X-.-.-X-.-X-X-.-X-X-E-.-X-X-X-.-X.......X..-X-X-X-E-.-X-X-.-X-.-X-X-.-X-X-.-.-.-X-X-.-.-.-.-.-.-.-,-------X-
X-----,-.-.-.-.-.-.-.-X-X-.-.-.-.-.-.-.-X-.-X-.-X-X-.-.-.-.-.-X-X-X-.-.-.-X-X-X-.-.-.-.-.-X-X-X-.-X-X-.-.-.-.-.-.-.-X-.-.-.-.-.-.-.-,-------X-
X-----,-.-.-.-.-.-.-.-X-X-.-.-.-.-.-.-.-X-.-X-X4X-.-.-.-.-.-.-.-.-.-.-.-.-.-.-.-.-.-.-.-.-.-X0X0.-X-X-.-.-.-.-.-.-.-X-.-.-.-.-.-.-.-,-------X-
X-----,-.-.-.-.-.-.-.-X-X-.-.-.-.-.-.-.-X-.-.-.4.-.-.-.-.-.-.-.-.-.-.-.-.-.-.-.-.-.-.-.-.-.-.0.0.-X-X-.-.-.-.-.-.-.-X-.-.-.-.-.-.-.-,-------X-
X-----,-.-.-.-.-.-.-.-X-X-.-.-.-.-X-.-.-X-.-X-X4X-.-.-.-.-.-.-.-.-.-.-.-.-.-.-.-.-.-.-.-.-.-X0X0.-X-X-.-X-X-.-.-.-X-X-.-.-.-.-.-.-.-,-------X-
X-----,-.-.-.-.-.-.-.-X-X-H-.-.-.-X-.-.-X-.-X-,-X-X-X-X-,-X-X-X-X-X-......X-X-X-X-X-.-X-X-X-X-X-.-X-X-E-X-X-.-.-.-X-X-.-.-.-.-.-.-.-,-------X-
X-----,-.-.-.-.-.-.-.-X-X-X-X-X-X-X-.-X-X-.-X-,-X-X-X-X-.-X-X-X-X-X-.-.-.-X-X-X-X-X-.-X-X-X-X-X-.-X-X-.-X-X-X-X-X-X-X-.-.-.-.-.-.-.-,-------X-
X-----,-.-.-.-.-.-.-.-X-X-X-X-X-X-X-.-X-X6.-X-,-X-.-.-E-.-E-.-X-X-.-.-.-.-.-X-,-,-E-,-E-,-.-X-X-.-X3X3.-X-X-X-X-X-X-X-.-.-.-.-.-.-.-,-------X-
X-----,-.-.-.-.-.-.-.-X-X-E-.-<-.-.-.-.-.6.-X-,-X-.-.-.-.-.-.-X-X-.-.-.-.-.-X-,-.-.-.-.-,-.-X-X-.-.3.3.-.-.-.-E-.-.-X-.-.-.-.-.-.-.-,-------X-
X-----,-.-.-.-.-.-.-.-X-X-A-.-.-.-.-.-.-X6.-X-,-X-.-:-A-.-:-.-X-X-.-.-E-.-.-X-,-.-:-W-:-,-.-X-X-.-X3X3.-.-.-.-.-.-.-X-.-.-.-.-.-.-.-,-------X-
X-----,-.-.-.-.-.-.-.-X-X-.-.-.-.-.-.-.-X-.-X-,-X-.-.-.-.-.-.-X-X-.-.-.-.-.-X-,-,-,-,-,-,-.-X-X-.-X-X-,-,-,-,-,-,-,-X-.-.-.-.-.-.-.-,-------X-
X-----,-.-.-.-.-.-.-.-X-X-.-.-.-.-.-.-.-X-.-X-,-X-H-.-.-E-.-.-X-X-.-.-.-.-.-X-.-.-.-E-.-.-H-X-X-.-X-X-,-.-.-.-.-.-,-X-.-.-.-.-.-.-.-,-------X-
X-----,-.-.-.-.-.-.-.-X-X-.-.-.-.-.-.-.-X-.-X-,-X-X-X-,-,-,-X-X-X-.-.-.-.-.-X-X-X-.-.-.-X-X-X-X-.-X-X-,-.-.-.-.-.-,-X-.-.-.-.-.-.-.-,-------X-
X-----,-.-.-.-.-.-.-.-X-X-.-.-.-.-.-.-H-X-.-X-.-X-.-.-.-.-.-.-.-.-.-.-.-.-.-.-.-.-.-.-.-.-.-X-X-.-X-X-,-.-.-.-.-.-,-X-.-.-.-.-.-.-.-,-------X-
X-----,-.-.-.-.-.-.-.-X-X-X-X-X-X-X-X-X-X-.-X-.-X-.-E-.-.-.-.-.-.-.-.-.-.-.-.-.-.-.-.-.-E-.-X-X-.-X-X-X-X-X-X-X-X-X-X-.-.-.-.-.-.-.-,-------X-
X-----,-.-.-.-.-.-.-.-X-X-X-X-X-X-X-X-X-X-.-X-.-X-.-.-.-.-.-.-.-.-.-.-.-.-.-.-.-.-.-.-.-.-.-X-X-.-X-X~X~X~X~X~X~X~X~X~.-.-.-.-.-.-.-,-------X-
X-----,-.-.-.-.-.-.-.-X-X-E-.-.-.-X-X-,-X>.-X-.-X-.-.-.-.-.-.-.-X-.-.-.-.-X-X-.-.-.-.-.-.-.-X-X-,-X-X~.~.~.~.~.~.~.~X~.-.-.-.-.-.-.-,-------X-
X-----,-.-.-.-.-.-.-,-X-X-.-.-.-.-X-X-,-,>.-X-.-X-.-.-.-.-.-.-.-X-.-.-.-.-X-X-.-.-.-.-.-.-.-X-X-,-X@X@.~.~,~,~,~,~.~X~.-.-.-.-.-.-.-,-------X-
X-----,-.-.-.-.-.-.-,-X-X-.-.-.-.-X-X-,-X>.-X-.-X-.-.-.-.-.-.-.-.-.-.-.-.-.-.-.-.-.-.-.-.-.-X-X-,-.@,@:~.~,~././,/.~X~.-.-.-.-.-.-.-,-------X-
X-----,-.-.-E-.-.-.-,-.-,-.-.-.-.-X-X-.-X-.-X-.-X-.-.-.-.-.-.-.-.-.-.-.-.-.-.-.-.-.-.-.-.-.-X-X-,-X@X@.~.~,~././,/.~X~.-.-.-.-.-.-.-,-------X-
X-----,-.-.-.-.-.-.-,-X-X-.-X-X-.-.-.-.-X-.-X-.-X-.-.-.-.-.-.-.-.-:-H-:-.-:-.-.-.-.-.-.-.-.-X-X-.-X-X~.~.~,~,/,/,/.~X~.-.-.-.-.-.-.-,-------X-
X-----,-.-.-.-.-.-.-.-X-X-,-X-X-,-.-.-.-X-.-X-.-X-.-.-.-.-.-.-.-.-.-.-.-.-.-.-.-.-.-.-.-.-.-X-X-.-X-X~.~.~.~.~.~.~.~X~.-.-.-.-.-E-.-,-------X-
X-----,-.-.-.-.-.-.-.-X-X-,-X-X-,-,-.-.-X-.-X-.-X-.-.-.-.-.-.-.-.-.-.-.-.-.-.-.-.-.-.-.-.-.-X-X-.-X-X~.~.~.~.~.~.~.~X~.-.-.-.-.-.-.-,-------X-
X-----,-.-.-.-.-.-.-.-X-X-.-X-X-E-,-,-,-X-.-X-.-X-.-.-.-.-.-.-.-.-.-.-.-.-.-.-.-.-.-.-.-.-.-X-X-,-X-X~.~.~.~.~.~.~.~X~.-.-.-.-.-.-.-,-------X-
X-----,-.-.-.-.-.-.-.-X-X-.-X-X-X-X-X-X-X?.-X-.-X-.-E-.-.-.-.-.-.-.-.-.-.-.-.-.-.-.-.-.-.-.-X-X-,-XAXAX~X~X~X~X~X~X~X~.-.-.-.-.-.-.-,-------X-
X-----,-.-.-.-.-.-.-.-.-.-.-.-E-X-X-X-,-,?E-X-.-X-.-.-.-.-.-.-.-.-.-.-.-.-.-.-.-.-.-.-.-.-.-X-X-E-.A,A.-.-X-X-X-E-.-.-.-.-.-.-.-.-.-,-------X-
X-----,-.-.-.-.-.-.-.-.-.-.-.-.-.-.-.-,-X?X-X-.-X-X-X-X-X-.-.-.-.-.-.-<-.-.-.-.-.-X-X-X-X-X-X-X-X-XAXA.-E-.-.-.-.-.-.-.-.-.-.-.-.-.-,-------X-
X-----,-.-.-.-.-.-.-.-.-.-.-.-.-E-.-E-,-X-X-XfX-X-X-X-X-X-.-.-.-.-.-.-.-.-.-.-.-.-X-X-X-X-X-X-XgXgX-X-.-.-.-E-.-.-.-.-.-.-.-.-.-.-.-,-------X-
X-----,-.-.-.-.-.-.-.-.-.-.-.-.-.-.-.-,-X-H-,F.-E-.-E-.-X-.-.-.-.-.-.-.-.-.-.-.-.-X-X-.-E-.-E-+g+gX-X-.-.-.-.-.-.-.-.-.-.-.-.-.-.-.-,-------X-
X-----,-.-.-.-.-.-.-.-.-.-.-.-.-.-.-E-,-X-H-,F.-.-.-.-.-X-.-.-.-.-.-.-.-.-.-.-.-.-X-X-.-.-.-,-+g+gX-X-.-E-.-.-.-.-.-.-.-.-.-.-.-.-.-,-------X-
X-----,-.-.-.-.-.-.-.-.-.-.-.-.-.-.-.-,-X-X-Xf.-W-.-.-.-.-.-.-.-.-.-.-.-.-.-.-.-.-.-.-.-.-W-,-XgXgX-X-.-.-.-.-.-.-.-.-.-.-.-.-.-.-.-,-------X-
X-----,-.-.-.-.-.-.-.-.-.-.-.-.-.-.-.-.-X-X-X-.-E-.-.-.-X-.-.-.-.-.-.-.-.-.-.-.-.-X-X-.-.-.-E-X-X-X-X-.-.-.-.-.-.-.-.-.-.-.-.-.-.-,-,-------X-
X-----,-,-.-.-.-.-.-.-.-.-.-.-.-.-.-.-.-X-.-.-.-.-.-.-H-X-.-.-.-.-.-.-.-.-.-.-.-.-X-X-H-.-.-.-.-.-X-X-.-.-.-.-.-.-.-.-.-.-.-.-.-.-,-------X---
--X-----,-.-.-.-.-.-.-.-.-.-.-.-.-.-.-.-X-X-X-X-.-X-X-X-X-X-X-X-X-.-.-.-.-X-X-X-X-X-X-X-X-X-.-X-X-X-X-.-.-.-.-.-.-.-.-.-.-.-.-.-,-,-------X---
--X-----,-,-.-.-.-.-.-.-.-.-.-.-.-.-.-.-.-.-.-.-.-.-.-X-.-.-.-.-X7.7.7.7.7.7X7.-.-.-.-X-.-.-.-.-.-.-.-.-.-.-.-.-.-.-.-.-.-.-.-.-,-------X-----
----X-----,-.-.-.-.-.-.-.-.-.-.-.-.-.-.-.-.-.-.-.-.-.-.-X-X-X-X-X-.-.-.-.-X-X-X-X-X-X-.-.-.-.-.-.-.-.-.-.-.-.-.-.-.-.-.-.-.-.-,-,-------X-----
----X-----,-,-.-.-.<.<.<.-.-.-.-.-.-.-.-.-.-.-.-.-.-.-.-.-.-.-.-.-.-.-.-.-.-.-.-.-.-.-.-.-.-.-.-.-.-.-.-.-.-.-.-.-.-.-.;.;.;.-,-------X-------
------X-----,-.-.-.-E-.<.-.-.-.-.-.-.-.-.-.-.-.-.-.-.-.-.-.-.-.-.-.-.-.-.-.-.-.-.-.-.-.-.-.-.-.-.-.-.-.-.-.-.-.-.-.-.-.;E-.-,-,-------X-------
------X-----,-,-.-.-.-.<.-.-.-.-.-.-.-.-.-.-.-.-.-.-.-.-.-.-.-.-.-.-.-.-.-.-.-.-.-.-.-.-.-.-.-.-.-.-.-.-.-.-.-.-.-.-.-.;.-.-,-------X---------
--------X-----,-,-,-.-.-.-.-.-.-.-.-.-.-.-.-.-.-.-.-.-.-.-.-.-.-.-.-.-.-.-.-.-.-.-.-.-.-.-.-.-.-.-.-.-.-.-.-.-.-.-.-.-.-.-,-,-------X---------
----------X-------,-,-,-.-.-.-.-.-.-.-.-.-.-.-.-.-.-.-.-.-.-.-.-.-.-.-.-.-.-.-.-.-.-.-.-.-.-.-.-.-.-.-.-.-.-.-.-.-.-.-,-,-,-------X-----------
------------X---------,-,-,-.-.-.-.-.-.-.-.-.-.-.-.-.-.-.-.-.-.-.-.-E-.-.-.-.-.-.-.-.-.-.-.-.-.-.-.-.-.-.-.-.-.-.-,-,-,---------X-------------
--------------X-----------,-,-,-.-.-.-.-.-.-.-.-.-.-.-.-.-.-.-.-.-.-.-.-.-.-.-.-.-.-.-.-.-.-.-.-.-.-.-.-.-.-.-,-,-,-----------X---------------
----------------X-X-----------,-,-,-,-,-,-,-,-,-,-,-,-,-,-,-,-,-,-,-,-,-,-,-,-,-,-,-,-,-,-,-,-,-,-,-,-,-,-,-,-,-------------X-----------------
--------------------X-X-------------------------------------------------------------------------------------------------X-X-------------------
------------------------X-X-----------------------------------------------------------------------------------------X-X-----------------------
----------------------------X-X---------------------------------------------------------------------------------X-X---------------------------
--------------------------------X-X-X-X-X-X-X-X-X-X-X-X-X-X-X-X-X-X-X-X-X-X-X-X-X-X-X-X-X-X-X-X-X-X-X-X-X-X-X-X-------------------------------
