----------------------------------------------------------------------------------------------------------------------,-X-X-X-X-X-X-X-------------------------------------------------------------------------------------------------
----------------------------------------------------------------------------------------------------------------------,-X-.-.-.-.-.-X-------------------------------------------------------------------------------------------------
----------------------------------------------------------------------------------------------------------------------,-X-.-X-X-X-X-X-------------------------------------------------------------------------------------------------
----------------------------------------------------------------------------------------------------------------------,-X-.-X---------------------------------------------------------------------------------------------------------
----------------------------------------------------------------------------------------------------------------------,->->->---------------------------------------------------------------------------------------------------------
----------------------------------------------------------------------------------------------------------------------,-X-.-X---------------------------------------------------------------------------------------------------------
----------------------------------------------------------------------------------------------------------------------,-X-.-X---------------------------------------------------------------------------------------------------------
----------------------------------------------------------------------------------------------------------------------,-X-.-X-------------------------------------,-,-,-,-,-,---------------------------------------------------------
----------------------------------------------------------------------,-,-,-,-,-,-,-,---------------------------------,-XY+YX-------------------------------------,-X-X-X-X-X---------------------------------------------------------
----------------------------------------------------------------------,-X-X-X-X-X-X-X-------------------------,-,-,-,-,-XY+YX-,-,-------------,-,-,-,-,-,-,-,-,-,-,-X-.-.-.-X-,-,-,-,-,-,-,-,-,-,-------------------------------------
----------------------------------------------------------------------,-X-.-.-.-.-H-X-------------------------,-X-X-X-X-X-,-X-X-X-------------,-X-X-X-X-X-X-X-X-X-X-X5,5,5,5X5X-X-X-X-X-X-X-X-X-X-------------------------------------
----------------------------------------------------------------------,-X-.-.-.-.-.-X-------------------------,-X-.-.-.-.-.-.-.-X-,-,-,-,-,-,-,-X-E-.-.-.-.-.-.-E-.-.-.-.-.-,-E-.-.-.-.-.-.-.-,-X-,-----------------------------------
----------------------------------------------------------------------,-X-A-.-.-.-A-X-------------------------,-X-.-<-.-.-.-.-.-X-X-X-X-X-X-X-X-X-.-.-.-.-.-X-X-X-.-.-.-.-,-,-,5,-,-.-.-.-E-.-,-X5X-----------------------------------
----------------------------------------------------------------------,-X-X-X-+-X-X-X-------------------------,-X-.-.-.-.-.-.-.-.-.-,-,-,-.-.-.-.-.-.-.-.-.-X-.-X-.-.-.-,-,-.5.5.5,5,-.-.-.-.-,-.5X-----------------------------------
--------------------------------------------------------------------------,-X-+-X-----------------------------,-X-.-.-.-.-.-.-.-.-.-,-,-,-.-.-.-.-.-X-X-X-.-X-X-X-.-.-.-,-.5.5.5X5.5,5.-.-.-.-,-.5X-----------------------------------
------------------------------,-,-,-,-,-,---------------------------------,-X-E-X-----------------------------,-X-.-.-.-.-.-.-.-E-.-.-.-,-.-.-.-.-.-X-.-X-.-.-.-.-.-.-.-,-.5.5X5X5.5,5.-.-.-.-,-.5X-----------------------------------
------------------------------,-X-X-X-X-X---------------------------------,-X-.-X-----------------,-,-,-,-,-,-,-X-.-.-.-.-.-.-.-.-.-.-.-,-.-X-X-X-.-X-X-X-.-.-.-X-X-X-.-,-,5.5.5.5,5,5.-.-.-.-,-.5X-----------------------------------
----------------------------,-,-X-.-.-.-X-,---,-,-,-,-,-,-,-,-,-,-,-,-,-,-,-X-.-X-,-,-,-,-,-,-,-,-,-X-X-X-X-X-X-X-.-.-.-.-.-.-.-,-,-.-.-,-.-X-.-X-.-.-E-.-.-.-.-X-.-X-.-.-,-,5,5,5,5.-.-.-.-.-,-.5X-----------------------------------
------------------,-,-,-,-,-,-X-X;,;,;,;X;X-,-,-X-X-X-X-X-X-X-X-X-X-X-X-X-X-X-.-X-X-X-X-X-X-X-X-X-X-X-.-,-,-,-.-,-.-.-.-.-.-E-,-,-,-.-.-,-.-X-X-X-.-X-X-X-.-.-.-X-X-X-.-.-.-,-,5.-.-.-.-.-.-.-,-.5X-----------------------------------
----------------,-,-X-X-X-X-X-X-.-.-.-.-.-X-X-X-X-.-.-.-.-.-.-.-.-.-.-.-.-.-.-.-.-.-.-.-.-.-.-.-.-.-.-.-,-,-,-.-,-.-.-.-.-.-.-,-,-H-.-.-,-.-.-H-.-.-X-.-X-.-.-.-.-.-.-.-.-.-.-,-.-.-.-.-.-.-E-,-.5X-----------------------------------
--------------,-,-X-.-.-.-.-.-E-.-.-.-E-.-.-E-,-.-.-.-.-.-.-.-.-.-.-.-.-X-X-X-X-X-X-X-.-.-.-X-X-X-X-X-.-,-,-,-.-,-.-.-.-.-.-.-.-.-.-.-.-,-.-.-.-.-.-X-X-X-.-X-X-X-.-.-.-.-.-,-,-.-.-.-.-.-.-.-,-X5X-----------------------------------
------------,-,-X-.-.-.-.-.-.-.-.-.-.-.-.-.-.-,-X-.-.-.-.-.-.-.-.-.-.-.-X---------,-X-.-.-.-X-----,-X-X-X-X-X-X-X-,-,-,-,-,-,-,-,-.-.-.-,-.-.-.-.-.-.-.-.-.-X-.-X-,-,-,-,-,-,-.-.-.-,-,-,-,-,-.-X-------------------------------------
----------,-,-X-.-.-,-X-X-,-,-,-,-,-,-,-,-,-,-,-X-X-X-X-X-X-X-X-X-.-.-.-X---------,-X-.-.-.-X-----------------,-X-X-X-.-.-.-.-.-X-X-X-X-X-.-.-.-.-.-.-.-.-.-X-X-X-,-.-.-.-.-.-.-.-X-X-X-.-.-X-X-X-------------------------------------
--------,-,-X-.-.-,-X-X---,-,-,-,-,-,-,-,-,-,-----X-----------,-X-.-.-.-X---------,-X-E-.-H-X---------------------,-X-.-.-.-.-.-X-X-X-,-X-.-.-.-.-.-.-.-.-.-.-,-,-,-.-.-.-,-,-,-,-X-X-X-,-,-X-X-X-------------------------------------
------,-,-X-.-.-,-X-X---,-,-.-.-.-.-.-.-.-.-,-,-----X---------,-X-.-.-.-X---------,-X-X-X-X-X-,-,-,---------------,-X-.-.-.-.-E-.-.-X9,-X-X-X-X-.-.-.-X-X-X-X-X-X-X-X-.-X-X-X-.-X-X-X-.-.-.-E-.-X-------------------------------------
----,-,-X-.-.-,-X-X---,-,-.-.-.-.-.-.-.-.-.-.-,-,-----X-------,-X-.-.-.-X-----------,-X-X-X-X-X-X-X---------------,-X-.-.-.-.-.-.-.-X9----,-,-X-L-L-L-X-,-----,-X-A-.-.-X-,-X-X-X-X8X-.-.-.-.-.-X-------------------------------------
--,-,-X-.-.-,-X-X---,-,-.-.-.-.-.-.-.-.-.-.-.-.-,-,-----X-----,-X-.-.-.-X-----------,-X-.-.-,-X-X-----------------,-X-.-E-.-E-.-E-.-X9----,-X-X-,-,-,-X-X-----,-X-.-.-.-X-------,-X8,-,-E-,-,-.-X-------------------------------------
,-,-X-.-.-,-X-X---,-,-.-.-.-.-.-.-.-.-.-.-.-.-.-.-,-,-----X---,-X-H-.-E-X-----,-,---,-X-.-X-X---------------------,-X-X-X-X-X-X-X-X-X-,-,-,-X-.-.-.-.-.-X-,-,-,-X-.-.-.-X-----,-,-XRX8X8,-,-X8X-X-X-----------------------------------
,-X-.-.-.-X-X---,-,-.-.-.-E-.-.-.-.-.-.-.-.-.-.-.-.-,-,-----X-,-X-X-X-X-X-----,-X-X-X-X-,-X-X-X-X-----------------,-,-,-,-,-,-,-,-----,-X-X-X-,-,-,-,-,-X-X-X-,-X-.-.-.-X---,-,-X~,~.-.-.-.-.-.-,---X---------------------------------
,-X;H;.;.;X;X-,-,-.-.-.-.-.-.-.-.-.-.-.-.-.-.-.-.-.-.-,-,---X-----------------,-X-<---<---<---<-X---------------,-,-X-X-X-X-X-X-X-----,-X-.-.-.-.-.-.-.-.-,-X-,-X-.-.-.-X-,-,-X~,~,~.-.-,-,-.-.-,-----X-------------------------------
,-X;.;.;.;X;X-,-.-.-.-.-.-.-.-.-.-.-.-.-.-.-.-.-.-.-.-.-,---X-----------------,-X---------------X-------------,-,-X-.-.-.-.-.-.-X-,-,-,-X-.-.-.-.-.-.-.-.-,-X-,-X-.-.-.-X-,-X~.~,~,~.-,-,-,2.-.-,-----X-------------------------------
,-X;,;,;,;X;X-,-.-.-.-.-.-.-.-.-.-.-.-.-.-.-.-.-.-.-.-.-,-,-X-,-,-,-----------,-X-,-,-,-,-,-,-,-X-------------,-X-.-.-.-.-.-.-.-X-X-X-X-X-.-.-.-.-.-.-.-.-,-.-X-X-.-.-.-X-X~.~.~,~,~.-,-,2K2.-.-,-------X-----------------------------
X-X-.-.-.-X-X-,-.-.-.-.-.-.-.-.-.-.-.-.-.-.-.-.-.-.-.-.-,-,-X-X-X-X-,---------,-X-.-.-.-.-.-.-.-X-------------,-X-.-,-,-,-,-,-,-,-,-,-,-,-,-,-,-,-,-.-.-.-,-.-,-X-,-,-,-X-.~.~E~,~,~.-.-.-.-.-.-,-----E---X---------------------------
X-.-.-.-.-.-,-,-.-.-.-.-.-.-.-.-.-.-.-.-.-.-.-.-.-.-.-.-,-,-.-.-.-.-X---------,-X-.-.-.-W-.-.-.-X-------------,-X-.-,-.-.-.-.-.-.-.-.-,-,-,-,-,-,-,-.-.-.-,-.-E-X-----,-X~H~.~.~,~,~.-.-.-.-.-.-,---------X-X1------------------------
X-.-.-.-.-.-,-,-.-.-.-.-.-.-.-.-.-.-.-.-.-.-.-.-.-.-.-.-,-,-.-.-E-.-X---------,-X-.-.-.-.-.-.-.-X-------------,-X-.-,-.-,-,-,-,-,-,-,-,-.-.-.-.-,-,-.-.-.-,-.-.-X-----,-X~.~.~.~,~,~.-.-.-.-.-.-,---------H-X1------------------------
X-,-,-E-,-.-,-,-.-.-.-.-.-.-.-.-.-.-.-.-.-.-.-.-.-.-.-.-,-,-.-.-.-.-X---------,-X-.-.-.-.-.-.-.-X-------------,-X-.-,-.-,-------X-X-X-X-X-.-.-.-,-,-.-.-.-,-.-.-,---E-,-X~.~.~E~,~,~.-.-.-.-.-.-,-----E---X-X1------------------------
X-X-X;.;X;X-,-,-.-.-.-.-.-.-.-.-.-.-.-.-.-.-.-.-.-.-.-.-,-,-.-.-E-.-X---------,-X-.-,-,-.-.-.-.-X-------------,-X-.-,-.-,-------X-----,-X-.-.-.-,-,-.-.-.-,-.-.-,-----,-X~.~.~.~,~,1.1.1.1.1.1.1,1--------X-X-,-----------------------
X-X-X-X-X-X-X-,-.-.-.-.-.-.-.-.-.-.-.-.-.-.-.-.-.-.-.-.-,-,-.-.-.-.-X---------,-X-,-,-H-,-.-.-.-X-------------,-X-.-,-.-,-------X-----,-X-.-.-.-,-,-.-.-.-,-.-,-,-,-,-,-X~.~.~.~,~,~.-.-.-.-.-.-,---------X-X-X-,---------------------
------------X-,-,-.-.-.-.-.-.-.-.-.-.-.-.-.-.-.-.-.-.-,-,-,-X-X-X-.-X---------,-X-X-X-.-X-X-X-X-X-------------,-X-.-,-.-,-------X-----,-X-.-.-.-,-,-.-.-.-,-.-,-X-.-.-.-X-.~.~E~,~,~.-.-.-.-.-.-,-----E---X-X-.-X-,-------------------
------------X---,-,-.-.-.-.-.-.-.-.-.-.-.-.-.-.-.-.-,-,-----X-,-X-.-X-------------,-X-.-X---------------------,-X-.-,-.-,---------X---,-X-.-.-.-,-,-.-.-.-,-.-,-X-.-.-.-X-.~.~.~,~,~.-.-.-.-.-.-,---------X-X-H-,-X-,-----------------
------------X-----,-,-.-.-.-.-.-.-.-.-.-.-.-.-E-.-,-,-------X-X-.-.-X-------------,-X-.-X---------------------,-X-.-,-.-,-----------X-,-X-.-.-.-,-,-.-.-.-,-.-,-X-,-,-,-X-.~.~.~,~,~.-.-.-.-.-.-,---------X-X-.-,-.-X-----------------
--------------X-----,-,-.-.-.-.-.-.-.-.-.-.-.-.-,-,-------X-,-X-,-,-X-------------,-X-.-X-------------,-,-,-,-,-X-.-,-.-,-----------X-,-X-.-.-.-,-,-.-.-.-,-.-.-,-----,-X~H~.~E~,~,~.-.-.-.-.-.-,-----E---X-X-.-,-.-,-X-,-------------
----------------X-----,-,-.-.-.-.-.-.-.-.-.-.-,-,-------X---,-X-,-,-X-,-----------,-X-.-X-----------,-,-X-X-X-X-X-.-,-.-,-----------X-,-X-.-.-.-,-,-.-.-.-,-.-.-,-----,-X~.~.~.~,~,~.-.-.-.-.-.-,-------,-X-X-.-,-.-,-,-X-,-----------
------------------X-----,-,-.-.-.-.-.-.-.-.-,-,-------X-------,-X-,-,-X-----------,-X-.-X---------,-,-X-.-.-.-.-.-.-,-.-,-,-,-,-,-H-X-,-X-.-.-.-,-,-.-.-.-,-.-E-,-----E-,-X-.~.~,~,~.-.-.-H-.-.-,-----,-X-X-.-.-,-.-,-,-.-X-,---------
--------------------X-----,-,-,-,-,-,-,-,-,-,-------X---------,-X-,-,-X-----------,-X-.-X---------,-X-.-.-.-.-.-.-.-,-.-,-,-X-X-X-X-X-X-X-X-X-X-,-,-.-.-.-,-.-.-X---------,-X-X~,~,~.-.-.-.-.-.-,---,-X-X-.-.-.-,-X-X-,-.-.-X-,-------
----------------------X-------------,-,-,---------X-----------,-X-,-,-X-----------,-X-.-X-,-,-,-,-,-X-.-.-.-.-.-.-.-,-.-,-,-X-.-.-.-.-.-.-.-X-X-,-,-.-.-.-,-.-,-X-,-,-,-,-----X-X~,~.-A-.-.-.-A-,-,-X-X-.-.-.-.-.-X-X-,-.-,-,-X-,-----
------------------------X-X---------,-,:,:,-,-X-X-----------,-,-X-,-,-X-----------,-X-.-X-X-X-X-X-X-X-,-,-,-,-,-,-,-,-.-,-,-.-.-H-.-E-.-.-.-X0X-,-,-.-.-.-,-,-,-X-X-X-X-X-,-----X-XRX-X-.-.-.-X-X-X-X-.-.-,-X-X-X-X-X-,-.-,-.-.-X-----
--------------------------X-----------,-,-.-.-X-----------,-,-X-.-,-X-------------,-X-.-.-.-.-A-+-.-.-.-.-.-.-.-.-.-.-.-,-,-.-.-.-.-,-,-.-.-.0.-,-,-.-.-.-,-,-X-.-.-,-,-.-X-------X-,-X1.1.1.1X1,-X-.-.-,-X-----------X-.-,-.-H-X-----
------------------------,-X-,---------,-.-.-.-X-----------,-X-X-+-X---------------,-X-X-X-X-X-X-X-X-X-,-,-,-,-,-,-,-,-,-,-,-.-.-.-,-,-,-.-.-X0X-,-,-.-.-.-.-X-.-E-,-E-,-H-X-X-----,-X-X-.-.-.-X-X-.-.-.-X---H---E-----X-X-,-,-,-X-----
------------------------,-X-,-,-,-,-,-,-.-.-,-X---------,-,-,-X-.-X-,-,-----------------------------X---------------------,-.-.-E-,-,-W-.-.-X-X-,-,-.-.-.-.-X-.-.-,-,-W-.-X-X-----E-,-.-.-.-.-.-.-.-E-.-X-----W-----E-X-X-.-.-.-X-----
--------------------------,-X-X-X-.-.-.-X-X-X-----------,-X-X-X-.-X-X-X-------------------------------X-------------------,-X-.-.-.-.-.-.-A-X-X-,-,-.-.-.-.-X-.-.-.-E-.-E-X-X-------,-,-.-<-.-.-.-.-.-.-X---E---------X-X-.-.-.-X-----
------------------------------,-X-.-.-.-X---------------,-X-.-.-.-.-.-X-,-,-,-,-,-,-,-,-,-------------X-----,-,-,-,-------,-X-X-X-X-X-X-X-X-X-X-,-,-.-.-.-.-X-.-.-.-.-.-.-X-X-X-X-,-,-,-X-X-X-,-,-,-X-X-X---------E-,-X-X-.-.-.-X-----
------------------------------,-X-.-.-.-X---------------,-X-.-E-.-.-E-X-X-X-X-X-X-X-X-X-X---------------X-X-X-X-.-X-X-X-X-X-X---------,-X-X-X-X-,-,-.-.-.-.-X-.-.-.-.-E-,-X-X-X-X-.-.-.-X-X-X-.-.-.-X-X-X-X---E---,-,-X-X-.-.-.-X-----
------------------------------,-X-.-.-.-X---------------,-X-.-.-.-.-.-X-X-.-.-.-.-.-.-.-X-------------------,-X-.-X-------------------,-X-.-.-.-,-,-.-.-.-.-.-.-X-.-.-X-X-X-.-.-.-.-E-.-.-.-.-.-.-.-E-.-.-X-X-,-,-X-X-.-.-.-.-.-X-----
------------------------------,-X-.-.-.-X---------------,-X-.-.-.-.-.-X-X-.-.-.-.-.-.-.-X-------------------,-X-.-X-------------------,-X-.-.-.-,-,-.-.-.-.-.-.-X-.-.-X-X-,-,-,-,-,-,-,-,-,-,-,-,-,-,-,-,-,-X-.-.-X-X-.-.-.-.-.-X-----
------------------------------,-X-.-.-.-X---------,-,-,-,-X-X-,-,-,-X-X-X-.-.-.-.-.-.-,-X-,-,-,-,-----------,-X-.-X-------------------,-X-.-.-.-,-,-.-.-.-.-.-.-.-.-.-.-.-.-.-.-.-.-.-.-.-.-.-.-.-.-.-.-.-.-.-.-.-.-.-.-.-.-.-.-X-----
------------------------------,-X-.-.-.-X---------,-X-X-X-X-X-.-.-.-X-X-X-.-.-.-.-.-.-,-X-X-X-X-X-,---------,-X-.-X-------------------,-X-.-.-.-,-,-.-.-.-.-.-.-.-.-.-.-.-.-.-.-.-.-.-.-.-.-.-.-.-.-.-.-E-.-.-.-.-.-.-.-.-.-.-.-X-,---
------------------------------,-X-.-.-.-X---------,-X-.-.-.-.-.-.-.-.-.-,-.-.-.-.-.-.-,-.-.-.-.-.-X-,-------,-X-,-X-------------------,-X-.-.-.-,-,-.-.-.-.-.-.-.-.-.-.-.-.-.-.-.-.-.-.-.-.-.-.-.-.-.-.-,-,-,-,-.-.-.-.-.-.-.-.-.-X---
------------------------------,-X-.-.-.-X---------,-X-.-.-.-.-.-.-.-.-.-,-.-.-.-.-.-.-,-.-.-.-.-.-.-X-,-----,-X-L-X-------------------,-X-.-.-.-,-,-,-,-,-,-,-,-,-,-,-,-,-,-,-,-,-,-,-,-,-,-,-,-,-,-,-,-,-.-.-,-.-.-.-.-.-.-.-.-.-X-,-
------------------------------,-X-.-.-.-X---------,-X-.-.-.-.-E-.-.-.-.-,-.-.-.-.-.-.-,-.-.-.-.-.-.-.-X-,-,-,-X-L-X-------------------,-X-.-.-.-,-,-,-,-,-,-,-,-,-,-,-,-,-,-,-,-,-,-,-,-,-,-,-,-,-,-,-,-,-.-.-,-.-.-.-.-.-.-.-.-.-.-X-
------------------------------,-X-.-.-.-X---------,-X-,-.-.-.-.-.-.-.-.-,-.-.-.-.-.-.-,-.-.-.-.-.-.-.-.-X-X-X-X-,-X-,-,---------------,-X-.-.-.-.-.-.-.-.-.-.-.-.-.-.-.-.-.-.-.-.-.-.-.-.-.-.-.-.-.-,-,-,-,-,-,-.-.-.-.-.-.-.-.-.-,-X-
------------------------------,-X-.-.-.-X-,-,-,-,-,-X-,-,-.-.-.-.-,-,-,-,-,-,-,-,-,-,-,-,-,-,-.-.-.-.-.-.-.-.-.-.-.-X-X-,-------------,-X-.-.-.-.-.-.-.-.-.-.-.-.-.-.-.-.-.-.-.-.-.-.-.-.-.-.-.-.-.-,-,-.-.-.-.-.-.-,-,-,-,-,-,-,-X---
------------------------------,-X-.-.-.-X-X-X-X-X-X-X-.-,-.-.-.-.-,-.-.-.-.-.-.-.-.-.-.-.-.-,-.-.-.-.-.-.-.-.-.-.-.-.-.-X-------------,-X-.-.-.-.-.-.-.-.-.-.-.-.-.-.-.-.-.-.-.-.-.-.-.-.-.-.-.-.-.-,-,-.-.-.-.-.-,-X-X-.3.3.3X-X-----
------------------------------,-X-.-.-.-,-.-.-.-.-.-,-.-,-.-.-.-.-,-.-.-.-.-.-.-.-.-.-.-.-.-,-.-.-.-.-.-.-.-.-.-.-.-.-.-X-------------,-X-.-.-.-X-X-,-,-.-.-.-X-X-.-.-.-.-.-X-X-.-.-.-.-.-X-X-.-.-.-,-,-.-.-.-.-.-,-X-.3.3.3.3X3------
------------------------------,-X-.-.-.-,-.-.-.-.-.-,-.-,-.-.-.-.-,-.-.-.-.-.-.-:-.-.-.-.-.-,-.-.-.-.-.-.-.-.-.-.-.-.-.-X-------------,-X-.-.-.-X-,-X-,-,-,-,-X-,-X-,-,-,-,-X-,-X-,-,-,-,-X-,-X-.-.-,-,-.-.-.-.-E-,-X-.3.3.3E3X3------
------------------------------,-X-.-.-.-,-E-.-.-.-.-,-.-,-.-.-.-.-,-.-.-.-.-.-.-.-.-.-.-.-.-,-.-.-.-,-,-.-.-.-.-.-.-.-.-X-------------,-X-.-.-.-X-,-X-K-,-E---X---X-,-,-E---X---X-E-,-E---X-,-X-.-.-,-,-.-.-.-.-.-,-X3.3E3.3.3X3------
------------------------------,-X-.-.-.-,-.-.-.-.-.-,-.-E-.-.-.-.-,-.-.-.-.-.-.-.-.-.-.-.-.-,-.-.-,-,-,-.-.-.-.-.-.-.-.-X-------------,-X-.-.-.-X---X-,-.-,---X---X-,-.~,~--X---X-,-.~,~--X-,-X-.-.-,-,-.-.-.-.-.-,-X-.3.3.3E3X3------
------------------------------,-X-A-.-.-,-.-.-.-.-,-,-.-,-.-.-.-.-,-.-.-.-.-.-.-.-.-.-.-.-.-,-.-.-,-,-W-.-.-.-.-.-.-.-.-X-,-,-,-,-----,-X-.-.-.-X---X-.-.-,---X---X-.~.~,~--X---X-.~.~,~--X-,-X-.-,-,-,-,-.-.-.-.-,-X-.3E3.3.3X3------
------------------------------,-X-X-X-X-X-X-X-X-X-X-X-,-,-.-.-.-.-,-,-,-,-,-,-,-,-,-,-,-,-,-,-.-.-.-.-.-.-.-.-.-.-.-.-.-X-,-X-X-X-X-X-,-X-,-,-.-X---X-,-,-,---X---X-,~,~,~--X---X-,~,~,~--X-,-X-X-X-X-.-X-X-X-.-.-,-X-.3.3.3.3X3------
--------------------------------------------------,-X-,-.-.-.-.-.-.-.-.-,-------------,-.-.-.-.-.-.-.-.-.-.-.-.-.-.-.-.-X-,-X-.-.-,-,-X-X6.6,6.-X---X---------X---X---------X---X---------X-------,-X-.-X---,-X-.-,-X3,3E3,3E3X3------
--------------------------------------------------,-X-.-.-.-.-.-.-.-.-.-,-------------,-.-.-.-.-.-.-.-.-.-.-.-.-.-.-,-,-X-,-X-.-<-.-.-.-,6.6,6,-X-,-X-,-,-,-,-X-,-X-,-,-,-,-X-,-X-,-,-,-,-X-,-,-,-,-X-,-X-,-,-,-X-X-X-X3X3.3X3X3------
--------------------------------------------------,-X-.-.-.-.-.-.-.-.-.-,-------------,-.-.-.-.-.-.-.-.-.-.-.-.-,-,-X-X---,-X-,-,-,-.-.-X6,6,6,-X-X-X-X-,-X-X-X-X-X-X-.-X-X-X-X-X-X-.-X-X-X-X-X-X-X-X-X-X-X-X-X-X-X-X-X-X-.-X---------
--------------------------:-:-:-------------------,-X-.-.-.-.-.-.-.-.-.-,-------------,-.-.-.-.-E-.-.-.-X-.-.-.-X-X-------,-X-.-.-,-X-X-X-E-.-,-X-A-E-,-,-,-,-,-,-,-,-,-.-.-.-.-.-.-.-.-.-.-.-.-.-.-.-.-.-.-.-.-.-.-.-.-.-.-X---------
------------------------:-----:-------------------,-X-.-.-.-.-.-.-.-.-.-,-------------,-.-.-.-.-.-.-,-X-X-.-.-.-X-,-,-,-,-,-X-.-.-,-X-,-X-.-.-,-X-A-.-.-.-.-.-.-.-.-.-X-X-X-X-X-X-X-X-X-X-X-.-X-X-X-X-X-X-X-X-X-X-X-X-X-X-X-X---------
----------------------:-:-:-:-:-------------------,-X-X-X-X-X-X-X-X-X-X-X-------------,-X-X-X-X-X-X-X---,-X-.-.-X-X-X-X-X-X-.-.-.-X---,-X-.-.-,-X-.-.-.-.-.-.-.-H-.-.-X-----------------,-X-.-X---------------------------------------
--------------------------:-:-:-----------------------------------------X---------------X---------------,-X-.-.-,-L-L-.-.-.-.-.-.-X---,-X-.-.-,-.-.-.-.-.-.-.-.-,-,-H-X-,-,-,-,-,-,-,---,-X-.-X---------------------------------------
------------------------------------------------------------------------X---------------X-----------------,-X-X-X-X-X-X-X-.-.-.-,-X---,-X-.-.-,-.-.-.-.-.-.-E-.-,-.-.-X-X-X-X-X-X-X-X---,-X-.-X---------------------------------------
------------------------------------------------------------------------X---------------X-----------------------------,-X-.-.-.-X-----,-X-A-.-,-X-.-.-.-.-.-.-.-,-.-.-.-.-.-.-.-.-.-X---,-X-+-X---------------------------------------
------------------------------------------------------------------------X-X-X-X-X-X-X-X-X-----------------------------,-X-,-,-,-X-----,-X-X-X-X-X-X-X-X-X-X-X-X-X-X-X-X-X-X-X-X-X-.-X---,-X-.-X-,-,-,-,-,-,-,-,-----------------------
--------------------------------------------------------------------------------------------------------------------,-,-X-.-.-X-----------------------------------------------,-X-.-X-,-,-X-,-X-X-X-X-X-X-X-X-X-,---------------------
------------------------------------------------------------------------------------------------------------------,-,-X-,-,-,-X-----------------------------------------------,-X-.-X-,-X-.-.-.-.-.-.-.-A-.-A-.-X-,-------------------
------------------------------------------------------------------------------------------------------------------,-.-X-.-.-X-,-----------------------------------------------,-X-.-X-,-X-.-.-.-.-.-.-.-.-.-.-.-.-X-,-----------------
------------------------------------------------------------------------------------------------------------------,-X-,-,-,-X-------------------------------------------------,-X-.-X-,-X-.-.-.-,-,-,-,-,-,-,-,-,-,-X-----------------
--------------------------------------------------------------------------------------------------------------------X-.-.-.-,-X-----------------------------------------------,-X-.-X-,-X-.-.-,-,-.-.-.-.-.-.-.-.-.-X-----------------
--------------------------------------------------------------------------------------------------------------------,-X-,-,-,-X-,---------------------------------------------,-X-.-X-,-X-.-.-,-.-.-.-.-.-.-.-.-.-.-X-----------------
----------------------------------------------------------------------------------------------------------------------X-.-.-.-.-X-,-------------------------------------------,-X-.-X-,-X-.-.-,-.-.-.-.-.-.-.-.-.-.-X-----------------
----------------------------------------------------------------------------------------------------------------------,-X-,-,-,-,-X-------------------------------------------,-X-.-X-X-X-.-.-,-.-.-.-.-.-.-.-.-.-.-X-----------------
------------------------------------------------------------------------------------------------------------------------X-.-,-,-,-X-,-,-,-------------------------------------,-X-E-.-.-.-.-.-,-.-.-.-.-.-.-.-.-.-.-X-----------------
------------------------------------------------------------------------------------------------------------------------,-X-,-,-,7,7X7X-X-,-----------------------------------,-X-X-X-X-X-.-.-,-.-.-.-.-.-.-.-.-.-.-X-----------------
--------------------------------------------------------------------------------------------------------------------------X-,7,7.-.-.-.-.-X-,-----------------------------------------,-X-.-.-,-.-.-.-.-.-.-.-.-.-.-X-----------------
--------------------------------------------------------------------------------------------------------------------------,-X-.-.-.-E-.-.-.-X-,---------------------------------------,-X-.-.-,-.-.-.-.-.-.-.-.-.-.-X-----------------
--------------------------------------------------------------------------------------------------------------------------,-X-.-.-.-.-.-.-.-.-X-,---------------------------------------,-X-X-,-.-.-.-.-.-.-.-.-.-.-X-----------------
--------------------------------------------------------------------------------------------------------------------------,-X-.-.-.-+WXWX-.-.-.-X-,-----------------------------------------,-X-.-.-.-.-.-.-.-.-.-.-X-,---------------
--------------------------------------------------------------------------------------------------------------------------,-X-.-.-.-+W.-X-X-.-.-.-X-,-------------------------,-,-,-,-,-,-,-,-X-.-.-.-,-,-,-,-.-.-.-.-X-,-------------
--------------------------------------------------------------------------------------------------------------------------,-X-.-E-.-+W.-.-X-X-.-.-.-X-,---------------------,-,-X-X-X-X-X-X-X-.-.-.-,-,-,-,-,-,-.-.-.-.-X-------------
--------------------------------------------------------------------------------------------------------------------------,-X-.-.-.-XW.-E-.-X-X-.-.-.-X-,-----------------,-,-X-,-.-.-.-.-.-.-.-.-,-,-,-,-,-.-,-,-.-.-.-X-------------
--------------------------------------------------------------------------------------------------------------------------,-X-.-.-.-X-X-.-.-.-X-X-.-.-.-X-,-------------,-,-X-.-,-.-.-.-.-.-.-.-.-,-.-.-.-.-.-.-,-.-.-.-X-------------
----------------------------------------------------------------------------------------------------------------------------,-X-.-.-.-X-X-.-E-.-X-X-.-.-.-X-,-,-,-,-,-,-,-X-.-.-,-.-.-.-.-.-.-.-.-,-.-.-.-.-.-E-,-,-,-.-X-------------
------------------------------------------------------------------------------------------------------------------------------,-X-.-.-.-X-X-.-.-A-X-X-.-.-.-X-X-X-X-X-X-X-.-E-.-,-.-.-.-.-.-.-,-,-,-.-.-E-.-.-.-,-.-,-.-X-------------
--------------------------------------------------------------------------------------------------------------------------------,-X-.-.-.-X-X-,-,-X-X-.-:-.-.-,-,-,-X-X-.-.-.-.-,-.-.-.-.-.-.-,-,-,-.-.-.-.-.-.-,-.-,-.-X-------------
----------------------------------------------------------------------------------------------------------------------------------,-X-.-.-.-X-X-,-X-X-.-.-.-.-,-.-,-,-,-.-.-.-.-,-,-.-.-.-.-.-,-,-,-,-.-.-.-.-,-,-.-,-.-X-------------
------------------------------------------------------------------------------------------------------------------------------------,-X-.-.-.-X-X-.-X-.-.-.-.-,-,-,-,-,-.-.-.-.-.-,-.-.-.-.-.-,-,-,-,-,-,-,-,-,-,-,-,-.-X-------------
--------------------------------------------------------------------------------------------------------------------------------------,-X-.-.-.-X-X-X-.-.-.-.-.-E-.-X-X-.-.-.-.-.-,-,-.-.-.-.-.-,-,-.-.-,-.-.-,-,-,-.-.-X-------------
----------------------------------------------------------------------------------------------------------------------------------------,-X-.-.-.-.-.-.-.-.-.-.-.-.-X-X-.-.-.-.-.-.-,-.-.-.-.-.-.-,-,-,-,-.-,-,-,-.-.-.-X-------------
------------------------------------------------------------------------------------------------------------------------------------------,-X-X-X-X-X-X-X-X-X-X-X-X-X-X-X-.-.-.-.-.-,-,-.-.-.-.-.-.-.-,-,-,-,-.-.-.-.-.-X-------------
----------------------------------------------------------------------------------------------------------------------------------------------------------------------,-X-.-.-.-.-.-.-,-.-.-.-.-.-.-.-.-.-.-.-.-.-.-.-.-X-------------
------------------------------------------------------------------------------------------------------------------------------------------------------------------------,-X-.-.-.-.-.-,-,-.-.-.-.-.-.-.-.-.-.-.-.-.-.-,-X-------------
------------------------------------------------------------------------------------------------------------------------------------------------------------------------,-X-.-H-.-A-.-.-,-.-.-.-.-.-.-.-.-.-.-.-.-,-X-X---------------
--------------------------------------------------------------------------------------------------------------------------------------------------------------------------,-X-X-X-X-X-X-X-X-X-X-X-X-X-X-X-X-X-X-X-X-------------------
