--------------------------------------------------,-,-,-,-,-,-,-,-,-,-,-,-,-,-,-,-,-,-,-,-,-X-X-X-X-X-X-X-X-X-X-X~X~X~X~X~X~X~X~X~X~X~X~X~X~X~X~X~X~X~X~X~X~X~X~X~X~X~X~X~X~X~X~X~X~X~X~X~X~X~X~X~X~X~X~X~X~X~X~X~X~X~X~X~X~X~X~X~X~X~X~X~X~X~X~X~X~X~X~X~X~X~X~X~X~X~X~X~X~X~X~X~X~X~X~X~X~X~X~X~X~X~X~X~X~X~X~X~X~X~X~X~X~X~X~X~X~X~X~X~X~X~X~X~X~X~X~X~X~X~X~X~X~X~X~X~X~X~X~X~X~X~X~X~X~X~X~X~X~X~X~X~X~X~X~X~X~X~X~X~X~X~X~X~X~X~X~X~X~X~X~X~X~X~X~X~X~X~X~X~X~X~X~X~X~X~X~X~X~X~X~X~X~X~X~X~X~X~X~X~X~X-X-X-X-X-X-X-X-X-X-X-X-X-X-X-X-X-X-X-X-X-X-X-X-X-X-X-X-X-X-X-X-X-X-X-X-X-X-X-X-,-,-,-,-,-,-,-,-,-,-,-,-,-,-,-,-,-,-,-,-,---------------------------------------------------------
----------------------------,-,-,-,-,-,-,-,-,-,-,-,-X-X-X-X-X-X-X-X-X-X-X~X~X~X~X~X~X~X~X~X~.~.~.~.~.~.~.~.~.~.~.~.~.~.~.~.~.~.~.~.~.~.~.~.~.~.~.~.~.~.~.~.~.~.~.~.~.~.~.~.~.~.~.~.~.~.~.~.~,~X-L-X-X~.~.~.~.~.~.~.~.~.~.~.~.~.~.~.~.~.~.~.~.~.~.~.~.~.~.~.~X~X~X~X~X~X~X~X~X~.~.~.~.~.~.~.~.~.~.~.~X~X~X~X~X~X~X~X~X~.~.~.~.~.~.~.~.~.~.~,~X-L-X-X~.~.~.~.~.~.~.~.~.~.~.~.~X~X~X~X~X~X~X~X~X~.~.~.~.~.~.~.~.~.~X~X~X~X~X~X~X~X~X~.~.~.~.~.~.~.~.~.~.~.~.~.~.~.~.~.~.~.~.~.~.~.~.~,~X-L-X-X~.~.~.~.~.~.~.~.~.~.~.~.-.-.-.-.-.-.-.-.-.-.-.-.-.-.-.-.-.-.-.-.-.-.-.-.-.-.-.-.-.-.-.-.-.-.-.-.-X-X-X-X-X-X-X-X-X-X-X-X-X-X-X-X-X-X-X-X-,-,-,-,-,-,-,-,-,-,-,-,-,---------------------------------
--------------------,-,-,-,-X-X-X-X~X~X~X~X~X~X~X~X~.~.~.~.~.~.~.~.~.~.~.~.~.~.~.~.~.~.~.~.~.~.~.~.~.~.~.~.~.~.~.~.~.~.~.~.~.~.~.~.~.~.~.~.~.~.~.~.~.~.~.~.~.~.~.~.~.~.~X~X~X~X~X~X~X~X~X~X~X~X-L-X-X~X~X~X~X~X~.~X~X~.~X~X~X~.~X~X~X~.~X~X~X~X~X~X~X~X~X~X~X~X~X~X~X~X~X~X~X~X~X~X~X~X~X~X~X~X~X~X~X~X~X~X~X~X~X~X~X~X~X~X~X~X~X~X~X~X~X~X~X-L-X-X~X~X~X~X~X~X~X~X~X~X~X~X~X~X~X~X~X~X~X~X~X~X~X~X~X~X~X~X~X~X~X~X~X~X~X~X~X~X~X~X~X~X~X~X~X~X~X~X~X~X~X~X~X~X~X~X~X~X~X~X~X~X~X~X~X-L-X-X~X~X~X~X~X~X~X~.~.~.~.~.~.-.-.-.-.-.-.-.-.-.-.-.-.-.-.-.-.-.-.-.-.-.-.-.-.-.-.-.-.-.-.-.-.-.-.-.-.-.-.-.-.-.-.-.-.-.-.-.-.-.-.-.-.-.-.-.-X-X-X-X-X-X-X-X-X-X-X-X-X-,-,-,-,-------------------------
------------,-,-,-,-X-X-X-X-.-.-.-.~.~.~.~.~.~.~.~.~.~.~.~.~.~.~.~.~.~.~.~.~.~.~.~.~.~.~.~.~.~.~.~.~.~.~.~.~.~.~.~.~.~.~.~.~.~.~.~.~.~.~.~.~.~.~.~.~.~.~.~.~.~.~.~.~.~.~X~.~.~<~X~X~X~X~X~.~.~.~.~.~.~X~X~X~X~.~.~.~.~.~.~.~A~.~.~.~.~.~.~X~X~X~.~X~X~X~X~X~X~X~X~E~X~X~X~X~.~.~.~X~X~X~X~.~.~W~X~X~X~X~.~.~.~.~.~.~.~.~.~.~X~X~X~X~X~X~.~.~.~.~.~.~.~X~.~.~<~.~X~X~X~.~.~.~.~.~B~.~.~.~.~B~.~.~.~X~X~X~X~.~B~.~.~.~X~X~X~E~.~.~.~.~B~.~X~X~X~:~.~E~.~X~.~.~E~.~X~X~.~.~E~H~X~X~X~.~.~.~.~.~.~X~X~.~.~.~X~.~.~.~.~.~.-.-.-.-.-.-.-.-.-.-.-.-.-.-.-.-.-.-.-.-.-.-.-.-.-.-.-.-.-.-.-.-.-.-.-.-.-.-.-.-.-.-.-.-.-.-.-.-.-.-.-.-.-.-.-.-.-.-.-.-.-.-.-.-.-.-.-.-.-X-X-X-X-,-,-,-,-,---------------
----,-,-,-,-X-X-X-X-.-.-.-.-.-.-.-.~.~.~.~.~.~.~.~.~.~.~.~.~.~.~.~.~.~.~.~.~.~.~.~.~.~.~.~.~.~.~.~.~.~.~.~.~.~.~.~.~.~.~.~.~.~.~.~.~.~.~.~.~.~.~.~.~.~.~.~.~.~.~.~.~.~.~.~.~.~.~X~X~.~.~.~.~.~.~.~.~.~.~.~.~.~.~.~.~.~.~.~.~.~.~.~.~.~.~.~X~.~X~.~X~X~E~X~X~E~X~X~.~X~.~X~X~.~.~.~.~.~.~.~.~.~.~X~E~X~X~.~.~.~.~.~.~.~.~.~.~X~.~X~E~:~.~.~.~.~.~E~.~.~X~.~.~.~.~X~.~X~B~.~.~.~.~.~.~.~.~.~.~.~.~B~.~.~.~.~.~.~.~.~.~X~.~X~.~.~B~.~.~.~.~X~.~X~.~.~.~.~X~.~.~.~.~X~X~.~.~.~.~X~.~X~.~.~.~.~.~E~L~L~.~.~.~.~.~.~.~.~.~.~.-.-.-.-.-.-.-.-.-.-.-.-.-.-.-.-.-.-.-.-.-.-.-.-.-.-.-.-.-.-.-.-.-.-.-.-.-.-.-.-.-.-.-.-.-.-.-.-.-.-.-.-.-.-.-.-.-.-.-.-.-.-.-.-.-.-.-.-.-.-.-.-X-X-X-X-X-,-,-,-,-------
,-,-X-X-X-X-.-.-.-.-.-.-.-.-.-.-.-.~.~.~.~.~.~.~.~.~.~.~.~.~.~.~.~.~.~.~.~.~.~.~.~.~.~.~.~.~.~.~.~.~.~.~.~.~.~.~.~.~.~.~.~.~.~.~.~.~.~.~.~.~.~.~.~.~.~.~.~.~.~.~.~.~.~.~.~.~.~.~X~X~X~X~X~.~.~.~.~.~.~X~X~X~X~.~.~.~.~.~.~.~.~.~.~.~.~.~.~X~.~X~.~X~X~.~X~X~.~X~X~.~X~.~X~X~.~.~.~X~X~X~X~.~.~.~X~.~X~X~.~.~.~.~.~.~.~.~.~.~X~.~X~X~X~X~.~.~.~.~.~.~.~X~.~.~.~.~X~.~X~.~.~.~.~.~.~.~.~.~.~.~.~.~.~X~X~X~X~.~.~.~.~.~X~X~X~.~.~X~X~X~X~.~X~.~X~.~.~.~.~X~.~.~.~.~X~X~.~.~.~.~X~.~X~.~.~.~.~.~.~X~X~.~.~:~.~.~.~.~.~.~.~.-.-.-.-.-.-.-.-.-.-.-.-.-.-.-.-.-.-.-.-.-.-.-.-.-.-.-.-.-.-.-.-.-.-.-.-.-.-.-.-.-.-.-.-.-.-.-.-.-.-.-.-.-.-.-.-.-.-.-.-.-.-.-.-.-.-.-.-.-.-.-.-.-.-.-.-.-X-X-X-X-,-,-,-
X-X-X-.-.-.-.-.-.-.-.-.-.-.-.-.-.-.~.~.~.~.~.~.~.~.~.~.~.~.~.~.~.~.~.~.~.~.~.~.~.~.~.~.~.~.~.~.~.~.~.~.~.~.~.~.~.~.~.~.~.~.~.~.~.~.~.~.~.~.~.~.~.~.~.~.~.~.~.~.~.~.~.~.~.~<~.~.~X~X~X~X~X~.~.~.~.~.~.~X~X~.~X~.~.~.~.~.~.~.~.~.~.~.~.~.~.~X~.~X~.~.~.~.~.~.~.~.~.~.~.~.~.~.~.~.~.~X~X~.~X~.~.~.~E~.~.~.~.~:~.~.~.~.~.~T~.~.~X~.~X~X~X~X~.~.~.~.~.~.~.~X~X~X~X~X~X~.~X~.~.~.~.~.~.~.~B~.~.~.~X~X~X~X~X~.~X~.~.~.~.~.~.~.~.~.~.~.~H~X~X~.~X~.~X~X~.~X~X~X~X~X~.~X~X~X~X~.~X~X~X~.~X~.~.~.~.~.~.~X~X~.~.~.~.~>~.~.~.~.~.~.-.-.-.-.-.-.-.-.-.-.-.-.-.-.-.-.-.-.-.-.-.-.-.-.-.-.-.-.-.-.-.-.-.-.-.-.-.-.-.-.-.-.-.-.-.-.-.-.-.-.-.-.-.-.-.-.-.-.-.-.-.-.-.-.-.-.-.-.-.-.-.-.-.-.-.-.-.-.-.-,-X-X-X-
--,-,-X-X-X-X-.-.-.-.-.-.-.-.-.-.-.~.~.~.~.~.~.~.~.~.~.~.~.~.~.~.~.~.~.~.~.~.~.~.~.~.~.~.~.~.~.~.~.~.~.~.~.~.~.~.~.~.~.~.~.~.~.~.~.~.~.~.~.~.~.~.~.~.~.~.~.~.~.~.~.~.~.~.~.~.~<~X~X~.~.~.~.~.~.~.~.~.~.~X~X~X~.~.~.~.~.~.~.~.~.~.~.~.~.~.~X~X~X~X~.~.~.~.~X~.~X~X~.~X~.~X~X~.~X~X~X~X~.~X~.~X~X~.~.~.~.~.~.~.~.~.~.~.~.~.~X~X~X~X~.~.~.~.~.~.~.~.~.~.~X~X~X~X~X~X~X~X~.~.~.~.~A~.~.~.~.~.~.~X~.~X~.~X~.~X~.~X~X~X~.~.~.~.~.~.~X~X~X~X~X~X~X~X~.~.~.~.~.~.~.~.~.~.~.~E~.~.~X~X~X~X~.~.~.~.~.~.~X~X~.~.~.~.~>~.~.~.~.~.~.-.-.-.-.-.-.-.-.-.-.-.-.-.-.-.-.-.-.-.-.-.-.-.-.-.-.-.-.-.-.-.-.-.-.-.-.-.-.-.-.-.-.-.-.-.-.-.-.-.-.-.-.-.-.-.-.-.-.-.-.-.-.-.-.-.-.-.-.-.-.-.-.-.-.-.-,-X-X-X-X-------
----------,-,-X-X-X-X-.-.-.-.-.-.-.~.~.~.~.~.~.~.~.~.~.~.~.~.~.~.~.~.~.~.~.~.~.~.~.~.~.~.~.~.~.~.~.~.~.~.~.~.~.~.~.~.~.~.~.~.~.~.~.~.~.~.~.~.~.~.~.~.~.~.~.~.~.~.~.~.~.~.~.~.~.~+~.~.~.~.~.~.~.~.~.~.~.~X~X~.~.~.~.~.~.~.~.~.~.~.~.~.~.~.~.~.~.~.~.~.~.~.~X~.~X~X~.~X~.~X~X~.~X~X~X~.~.~X~.~X~X~.~A~.~.~.~.~.~.~.~.~.~.~.~.~.~.~.~.~.~.~.~.~.~.~.~.~.~.~.~.~.~.~.~.~.~.~.~.~.~.~.~.~.~.~.~.~X~X~X~.~X~.~X~B~X~.~X~.~.~.~.~.~.~X~X~X~X~.~.~.~.~.~.~.~.~.~.~.~.~.~.~.~.~.~.~.~.~.~.~.~.~.~.~.~.~X~X~.~.~.~.~.~.~.~.~.~.~.-.-.-.-.-.-.-.-.-.-.-.-.-.-.-.-.-.-.-.-.-.-.-.-.-.-.-.-.-.-.-.-.-.-.-.-.-.-.-.-.-.-.-.-.-.-.-.-.-.-.-.-.-.-.-.-.-.-.-.-.-.-.-.-.-.-.-.-.-.-.-,-X-X-X-X-X---------------
------------------,-,-X-X-X-X-.-.-.~.~.~.~.~.~.~.~.~.~.~.~.~.~.~.~.~.~.~.~.~.~.~.~.~.~.~.~.~.~.~.~.~.~.~.~.~.~.~.~.~.~.~.~.~.~.~.~.~.~.~.~.~.~.~.~.~.~.~.~.~.~.~.~.~.~.~.~.~.~<~X~X~.~.~.~.~.~.~.~.~.~.~X~X~X~.~.~.~.~.~.~.~.~.~.~.~.~.~.~X~X~X~X~.~.~.~.~X~E~X~X~E~X~E~X~X~.~.~<~X~.~.~X~.~X~X~.~.~.~.~.~.~.~.~.~.~.~.~.~X~X~X~X~.~.~.~.~.~.~.~.~.~.~.~.~.~.~X~X~X~X~.~.~.~.~.~B~.~.~.~.~E~.~.~.~B~X~.~X~.~X~X~X~.~.~.~.~.~.~B~.~.~.~X~X~X~X~.~.~.~.~.~.~.~.~.~.~E~.~E~.~X~X~X~X~.~.~.~.~.~.~X~X~<~.~.~.~.~.~.~.~.~.-.-.-.-.-.-.-.-.-.-.-.-.-.-.-.-.-.-.-.-.-.-.-.-.-.-.-.-.-.-.-.-.-.-.-.-.-.-.-.-.-.-.-.-.-.-.-.-.-.-.-.-.-.-.-.-.-.-.-.-.-.-.-.-.-.-.-.-,-X-X-X-X-------------------------
--------------------------,-,-X-X-X~X~X~X~X~X~.~.~.~.~.~.~.~.~.~.~.~.~.~.~.~.~.~.~.~.~.~.~.~.~.~.~.~.~.~.~.~.~.~.~.~.~.~.~.~.~.~.~.~.~.~.~.~.~.~.~.~.~.~.~.~.~.~.~.~.~.~X~X~X~X~X~X~X~X~X~X~X~X~,~X~X~X~X~X~X~X~.~X~X~.~X~X~X~.~X~X~X~.~X~X~X~X~X~X~X~X~X~X~X~X~X~.~X~X~X~X~X~X~X~X~X~X~X~X~X~X~X~X~X~.~.~.~.~.~.~.~X~X~X~X~X~X~X~X~X~X~X~X~X~,~X~X~X~X~X~X~X~X~X~X~X~X~X~X~X~.~.~.~.~.~.~.~X~X~X~X~X~X~X~X~X~X~X~.~.~.~.~B~.~.~X~X~X~X~X~X~X~X~X~X~X~.~X~X~X~X~X~X~X~X~X~X~X~X~X~X~X~,~X~X~X~X~X~X~X~X~X~.~.~.~.~.~.-.-.-.-.-.-.-.-.-.-.-.-.-.-.-.-.-.-.-.-.-.-.-.-.-.-.-.-.-.-.-.-.-.-.-.-.-.-.-.-.-.-.-.-.-.-.-.-.-.-.-.-.-.-.-.-.-.-.-,-X-X-X-X-X-X-X-X-X---------------------------------
--------------------------------------------,-X-X-X-X-X-X-X-X~X~X~X~X~X~X~.~.~.~.~.~.~.~.~.~.~.~.~.~.~.~.~.~.~.~.~.~.~.~.~.~.~.~.~.~.~.~.~.~.~.~.~.~.~.~.~.~.~.~.~.~.~.~.~X~X~X~X~X~X~X~X~X~X~X-L~X-X~X~X~X~X~X~.~X~X~.~X~X~X~.~X~X~X~.~X~X~X~X~X~X~X~X~X~X~X~X~X~X~X~X~X~X~X~X~X~X~X~X~X~X~X~X~X~X~X~X~X~X~X~X~X~X~X~X~X~X~X~X~X~X~X~X~X~X~X-L~X-X~X~X~X~X~X~X~X~X~X~X~X~X~X~X~X~X~X~X~X~X~X~X~X~X~X~X~X~X~X~X~X~X~X~X~X~X~X~X~X~X~X~X~X~X~X~X~X~X~X~.~X~X~X~X~X~X~X~X~X~X~X~X~X~X~X-L~X-X~X~X~X~X~X~X~.~.~.~.~.~.-.-.-.-.-.-.-.-.-.-.-.-.-.-.-.-.-.-.-.-.-.-.-.-.-.-.-.-.-.-.-.-.-.-.-.-.-.-.-.-.-.-.-.-.-.-,-,-X-X-X-X-X-X-X-X-X-X-X-X-X---------------------------------------------------
------------------------------------------------------------------------,-X-X-X-X-X-X-X~X~X~X~X~X~X~.~.~.~.~.~.~.~.~.~.~.~.~.~.~.~.~.~.~.~.~.~.~.~.~.~.~.~.~.~.~.~.~.~.~.~.~.~.~.~.~.~.~.~.~.~.~.~.~.~.~.~.~.~.~.~.~.~.~.~.~.~.~.~.~.~.~.~.~.~.~.~.~.~.~.~.~.~.~.~.~.~.~.~.~.~.~.~.~.~.~.~.~.~.~.~.~.~.~.~.~.~.~.~.~.~.~.~.~.~.~.~.~.~.~.~.~.~.~.~.~.~.~.~.~.~.~.~.~.~.~.~.~.~.~.~.~.~.~.~.~.~.~.~.~.~.~.~.~.~.~.~.~.~.~.~.~.~.~.~.~.~.~.~.~.~.~.~.~.~.~.~.~.~.~.~.~.~.~.~.~.~.~.~.~.~K~.~.~.~.~.~.~.~.~.~.~.~.~.-.-.-.-.-.-.-.-.-.-.-.-.-.-.-.-.-.-.-.-.-.-.-.-.-.-.-.-.-.-.-.-.-.-,-X-X-X-X-X-X-X-X-X-X-X-X-X-X-----------------------------------------------------------------------------
--------------------------------------------------------------------------------------------------,-X-X-X-X-X-X-X~X~X~X~X~X~X~X~X~X~X~X~X~X~X~X~X~X~X~X~X~X~X~X~X~X~X~X~X~X~X~X~X~X~X~X~X~X~X~X~X~X~X~X~X~X~X~X~X~X~X~X~X~X~X~X~X~X~X~X~X~X~X~X~X~X~X~X~X~X~X~X~X~X~X~X~X~X~X~X~X~X~X~X~X~X~X~X~X~X~X~X~X~X~X~X~X~X~X~X~X~X~X~X~X~X~X~X~X~X~X~X~X~X~X~X~X~X~X~X~X~X~X~X~X~X~X~X~X~X~X~X~X~X~X~X~X~X~X~X~X~X~X~X~X~X~X~X~X~X~X~X~X~X~X~X~X~X~X~X~X~X~X~X~X~X~X~X~X~X~X~X~X~X~X~X~X~X~X~X~X~X~X~X~X~X~X~X~X~X~X-X-X-X-X-X-X-X-X-X-X-X-X-X-X-X-X-X-X-X-X-X-X-X-X-X-X-X-X-X-X-X-X-X-X-X-X---------------------------------------------------------------------------------------------------------
------------------------------------------------------------------------------------------------------------------------------------------------------------------------------------------------------------------------------------------------------------------------------------------------,-,-X-.-.-X-,---------------------------------------------------------------------------------------------------------------------------------------------------------------------------------------------------------------------------------------------------------------------------------------------------------------------------------------------------------------------------------
----------------------------------------------------------------------------------------------------------------------------------------------------------------------------------------------------------------------------------------------------------------------------------------:-:-:---:-X-,-,-,-,-X---------------------------------------------------------------------------------------------------------------------------------------------------------------------------------------------------------------------------------------------------------------------------------------------------------------------------------------------------------------------------------
----------------------------------------------------------------------------------------------------------------------------------------------------------------------------------------------------------------------------------------------------------------------------------------:---:-:-:-XR+R+R+R+RXR--------------------------------------------------------------------------------------------------------------------------------------------------------------------------------------------------------------------------------------------------------------------------------------------------------------------------------------------------------------------------------
----------------------------------------------------------------------------------------------------------------------------------------------------------------------------------------------------------------------------------------------------------------------------------------:-------:-X/t/t/t/t/X/--------------------------------------------------------------------------------------------------------------------------------------------------------------------------------------------------------------------------------------------------------------------------------------------------------------------------------------------------------------------------------
------------------------------------------------------------------------------------------------------------------------------------------------------------------------------------------------------------------------------------------------------------------------------------------:-:---:-X---E---E-X---------------------------------------------------------------------------------------------------------------------------------------------------------------------------------------------------------------------------------------------------------------------------------------------------------------------------------------------------------------------------------
--------------------------------------------------------------------------------------------------------------------------------------------------------------------------------------------------------------------------------------------------------------------------------------------------X---------X---------------------------------------------------------------------------------------------------------------------------------------------------------------------------------------------------------------------------------------------------------------------------------------------------------------------------------------------------------------------------------
--------------------------------------------------------------------------------------------------------------------------------------------------------------------------------------------------------------------------------------------------------------------------------------------------X---E---E-X---------------------------------------------------------------------------------------------------------------------------------------------------------------------------------------------------------------------------------------------------------------------------------------------------------------------------------------------------------------------------------
--------------------------------------------------------------------------------------------------------------------------------------------------------------------------------------------------------------------------------------------------------------------------------------------------X-X-X-X-X-X---------------------------------------------------------------------------------------------------------------------------------------------------------------------------------------------------------------------------------------------------------------------------------------------------------------------------------------------------------------------------------
