----------------------------------------------------------------------------------------------,-X-X-X-X-X-X-X-X-X-X-X-X-X-X-X-X-X-X-X-X-X-X---------------------------------------------------------------------------
----------------------------------------------------------------------------------------------,-X-E-.-.-.-.-.-.-.-.-.-.-.-.-.-.-.-.-.-.-E-X---------------------------------------------------------------------------
----------------------------------------------------------------------------------------------,-X-.-.-.-.-.-.-.-.-.-.-.-.-.-.-.-.-.-.-.-.-X---------------------------------------------------------------------------
----------------------------------------------------------------------------------------------,-X-.-.-X-X-X-X-X-X-X-X-X-X-X-X-X-X-X-X-.-.-X---------------------------------------------------------------------------
----------------------------------------------------------------------------------------------,-X-.-.-X---------------------------,-X-.-.-X---------------------------------------------------------------------------
------------------------------------------------------------------,-,-,-,-,-,-,-,-,-,---------,-X-.-.-X---------------------------,-X-.-.-X---------------------------------------------------------------------------
--------------------------------------------------------------,-,-X-X~X~X~X~X~X~X~X~X~,-------,-X-.-.-X---------------------------,-X-.-.-X---------------------------------------------------------------------------
----------------------------------------------------------,-,-X-X~.~.~.~.~.~.~.~.~.~.~X~,-----,-X-.-.-X---------,-,-,-,-,-,-,-----,-X-.-.-X---------------------------------------------------------------------------
--------------------------------------------------------,-,-X~.~.~.~.~.~.~.~.~.~.~,~,~,~X~,-,-,-X-.-.-X-----,-,-,-X-X~X~X~X~X~,---,-X-.-.-X---------------------------------------------------------------------------
--------------------------------------------------------,-.-X~.~.~.~.~.~.~.~.~.~.~,~X-X-X-X-X-X-X-.-.-X---,-,-X-X~.~.~.~.~.~.~X~,-,-X-.-.-X---------------------------------------------------------------------------
------------------------------------------------------,-,-X~.~.~.~.~.~.~.~.~.~.~.~,~.-.-.-.-.-.-.-.-.-X---,-X~.~.~.~.~.~H~.~.~,~X~,-X-.-.-X---------------------------------------------------------------------------
----------------------------------------------,-,-,-,-,-.-X~.~.~.~.~.~.~.~.~.~.~.~,~.-.-.-.-.-.-.-.-.-X-,-,-X~.~.~.~.~.~.~.~.~X~--,-X-.-.-X---------------------------------------------------------------------------
--------------------------------------------,-,-X-X-X-X-X~.~.~.~.~.~.~.~.~.~.~.~.~,~X-X-X-X-X-X-X-X-X-X-,-X~.~.~.~.~.~.~E~.~,~X~--,-X-.-.-X-----------------------,-,-,-,-,-,-,-,-,-,---------------------------------
------------------------------------------,-,-X-.-.-.-.-,-,-,~.~.~.~.~.~.~.~.~.~.~.~X~X~X~------------,-,-X~.~.~.~.~.~.~.~.~X~----,-X-.-.-X---------------------,-,-X-X-X-X-X-X-X-X-X-,-------------------------------
----------------------------------------,-,-X-.-.-.-.-.-.-.-,-,-,~.~.~.~.~.~.~.~.~.~.~,~X~------------,-X~.~.~.~.~.~.~.~.~.~X~----,-X-.-.-X---------------------,-X-X-H-.-.-.-A-.-.-X-X-------------------------------
--------------------------------------,-,-X-.-.-.-.-.-.-.-.-.-.-,-,-,~.~.~.~.~.~.~.~,~X~------------,-,-X~.~.~.~.~.~.~,~,~,~X~,-,-,-X-.-.-X-,-,-,-,-,-,-,-,-,-,-,-X-.-.-.-.-.-.-.-.-.-X-------------------------------
--------------------------------------,-X-.-.-.-.-.-.-.-.-.-.-.-.-.-,-,-,~.~.~.~X~X~X~--------------,-X~.~.~.~.~.~.~.~,~X-X-X-X-X-X-X-.-.-X-X-X-X-X-X-X-X-X-X-X-X-X-,-,-.-.-.-.-.-.-.-X-------------------------------
------------------------------------,-,-X-.-.-.-.-.-.-.-.-.-.-.-.-.-.-.-,-,-,~.~X~------------------,-X~.~.~.~.~.~.~.~,~.-.-.-.-.-.-.-.-.-.-.-.-.-.-.-.-.-.-.-.-.-.-.-,-.-.-.-.-.-.-.-X-------------------------------
------------------------------------,-X-.-.-.-.-.-.-.-.-.-.-.-.-.-.-.-.-.-.-,-,-X~,-,---------------,-X~.~.~.~.~.~.~.~,~.-.-.-.-.-.-.-.-E-.-.-.-.-.-.-.-.-.-.-.-E-,-A-,-.-.-E-.-.-.-.-X-------------------------------
----------------------------------,-,-X-.-.-.-.-.-.-.-.-.-.-.-.-.-.-.-.-.-.-.-.-.-X-X-,-,-,-,-,-,-,-,-X~.~.~.~.~.~.~.~,~X-X-X-X-X-X-X-X-X-X-X-X-X-X-X-X-X-X-X-X-X-X-.-.-.-.-.-.-.-.-.-X-------------------------------
----------------------------------,-X-.-.-.-.-.-E-.-.-.-.-.-.-.-.-.-.-.-.-.-.-.-.-,-,-X-X-X-X-X-X-X-X-X~,~,~,~,~.~.~.~.~X~X~X~----------------------------------,-X-.-.-.-.-.-.-.-.-.-X-------------------------------
--------------------------------,-,-X-.-.-.-.-.-.-.-.-.-.-.-.-.-.-.-.-.-.-.-.-,-,-,-.-.-.-.-.-.-.-.-X-X-+P.-.-,-,~.~.~.~.~.~X~----------------------------------,-X-.-.-.-.-.-.-.-.-.-X-------------------------------
--------------------------------,-X-.-.-.-.-.-.-.-.-.-.-.-.-.-.-E-.-.-.-.-.-,-,-.-.-.-.-.-.-.-.-.-H-X-X-+P,-.-.-,-,~.~.~.~,~X~--------------,-,-,-,-,-,---------,-X-X-X-.-.-.-.-.-X-X-X-------------------------------
------------------------------,-,-X-.-.-.-.-.-.-.-.-.-.-.-.-.-.-.-.-.-.-.-,-,-.-.-.-E-.-.-,-X-X-X-X-X~X1,~X1X~X-X-X-X~X~X~X-,-,-,-,-,-,-,-,-,-X-X-,-X-X-,-,-,-,-,-,-,-X-.-.-.-.-.-X-,-,-------------------------------
------------------------------,-X-.-.-.-.-.-.-.-.-.-E-.-.-.-.-.-.-.-.-.-,-,-.-.-.-.-,-,-X-X-X~X~X~X~X~,~,~,~X~X~,-,-X-X-X-X-X-X-X-X-X-X-,-X-X-X-X-X-X-X-X-X-X-X-X-X-X-X-,-,-,-,-,-X-X-X-,-----------------------------
------------------------------,-X-.-.-.-.-.-.-.-.-.-.-.-.-.-.-.-.-.-.-,-,-.-.-,-,-,-X-X-X~.~.~.~.~.~.~.~.~.~.~X~X~X-X-.-.-.-.-.-.-.-H-X-X-X-H-.-.-.-.-.-E-X-X-.-.-.-,-,<,<,<,<,<,<,<.-X-X-----------------------------
------------------------------,-X-.-.-.-.-.-.-.-.-.-.-.-.-.-.-.-.-.-,-,-.-.-,-,-,-X-.-,-,~.~.~.~.~.~.~.~.~.~.~,~X-X-.-.-.-.-.-.-.-.-.-.-X-X-.-,-E-,-<-.-.-.-,-.-.-.-.-.-.-.-:-:-.-.-.-.-X-----------------------------
------------------------------,-X-.-.-.-.-.-.-.-.-.-.-.-.-.-.-.-.-.-,-.-.-,-,-,-,-.-.-.-,~.~.~.~.~.~.~.~.~.~.~,~.-,-.-.-.-.-.-.-.-.-.-.-X-X-A-,-..,..-.-,-X-X-.-.-.-.-.-.-.-.-.-.-.-.-.-X-----------------------------
------------------------------,-X-.-.-.-.-.-.-.-.-.-.-.-.-.-.-.-.-,-,-.-.-,-,-,-.-.-E-,-,-.~.~.~.~.~.~.~.~.~.~,~.-,-.-.-E-.-.-.-E-.-.-.-X-X-X-X-,-,-,-X-X-,-X-.-.-.-.-.-.-.-.-.-.-.-.-.-X-----------------------------
------------------------------,-X-.-.-.-.-.-.-.-.-.-.-.-.-.-.-.-.-,-.-.-,-,-X-.-.-,-,-,~.~.~.~.~.~.~.~.~.~.~.~,~.-,-.-.-.-.-.-.-.-.-.-.-X-X-X-X-,-,-,-X-X-X-.-.-.-.-.-.-.-.-.-.-.-.-.-.-X-----------------------------
--------------------------------,-X-.-.-.-.-.-.-.-.-.-.-.-.-.-.-,-,-.-.-,-X-X-.-.-,-.~.~.~.~.~.~.~.~.~.~.~.~.~,~X-X-.-.-.-.-.-.-.-.-.-.-X-X-.-.-.-.-.-.-.-.-.-.-.-.-.-.-.-.-.-.-.-.-.-.-X-----------------------------
--------------------------------,-X-.-.-.-.-.-.-.-.-.-.-.-.-.-.-,-.-.-E-,-X-.-.-,-,~.~.~.~.~.~.~.~.~.~.~.~.~.~.~X~X-.-,-,-.-.-.-,-,-.-.-X-X-,-,-,-,-,-,-E-,-,-,-,-.-.-.-.-.-.-,-,-.-.-.-X-----------------------------
----------------------------------,-X-.-.-.-.-.-.-.-.-.-.-.-.-,-,-.-.-,-X-X-.-.-,-.~.~.~.~.~+P+P+P+P,~,~,~,~,~,~X~X-.-,---,-,-,-,-,-,-,-X-X-.-,-+N+N.-.-.-.-.-.-X-X-X-X-X-,-,-,-,-.-.-.-X-----------------------------
----------------------------------,-X-.-.-.-.-.-.-.-.-.-.-.-.-,-.-.-,-,-X-.-.-,-,~.~.~.~.~.~+P+P+P+P------------X-X-.-X-X-------X-X-----X-X-.-,-+N+N.-.-.-.-.-.-X-------X-----X-X-.-.-.-X-----------------------------
------------------------------------,-X-.-.-.-.-.-.-.-.-.-.-,-,-.-.-,-X-X-.-.-,-.~.~.~.~.~.~+P+P+P+P------------X-X-.-X-X-------X-X-----X-X-.-,-+N+N.-.-.-.-.-.-X-------X-----X-X-.-.-.-X-----------------------------
------------------------------------,-X-.-.-.-.-.-.-.-.-.-.-,-.-.-.-,-X-.-.-,-,~.~.~.~.~.~.~+P+P+P+P,-,-,-,-,-,-X-X-.-,-----------------X-X-.-,-+N+N.-.-.-.-.-.-X-------X-------,-.-.-.-X-----------------------------
--------------------------------------,-X-.-.-.-.-.-.-.-.-,-,-.-.-.-,-X-.-.-,-.~.~.~.~.~.~.~.~.~.~.~.~.~.~.~.~.~X~X-,-,-----------------X-X-,-,-,-,-,-,-,-,-,-,-X-X-X-X-X-------,-,-,-,-X-----------------------------
--------------------------------------,-X-.-.-.-.-.-.-.-.-,-.-.-.-.-,-X-.-.-,-.~.~.~.~.~.~.~.~.~.~.~.~.~.~.~.~.~X~X---------------------X-X---:-----------------------------------------X-----------------------------
------------------------------------,-,-X-.-.-.-.-.-.-.-.-,-.-.-.-.-,-X-.-.-,-.~.~.~.~.~.~.~.~.~.~.~.~.~.~.~.~.~X~X---------------------X-X-,-,-,---------------------------------------X-----------------------------
------------------------------------,-X-.-.-.-.-.-.-.-.-.-,-.-.-.-.-,-.-.-.-,-.~.~.~.~.~.~.~.~.~.~.~.~.~.~.~.~.~X~X---------------------X-X-,-.-,---------------------------------------X-----------------------------
------------------------------------,-X-.-.-.-.-.-.-.-.-.-,-.-.-E-.-,-.-.-.-,-.~.~.~.~.~.~.~.~.~.~.~.~.~.~.~.~.~X~X---------E-----------X-X-H-.-,-------E-------------------------------X-----------------------------
------------------------------------,-X-.-.-.-.-.-.-.-.-.-,-.-.-.-.-,-.-.-.-,-.~.~.~.~.~.~.~.~.~.~.~.~.~.~.~.~.~X~X---------------------X-X-,-,-,---------------------------------------X-----------------------------
----------------------------------,-,-X-.-.-.-.-.-.-.-.-.-,-.-.-.-.-,-X-.-.-,-.~.~.~.~.~.~.~.~.~.~.~.~.~.~.~.~.~X~X---------------------X-X---:-----------------------------------------X-----------------------------
----------------------------------,-X-.-.-.-.-.-.-.-.-.-.-,-.-.-.-.-,-X-.-.-,-.~.~.~.~.~.~.~.~.~.~.~.~.~.~.~.~.~X~X---------------------X-X---------------------------------------------X-----------------------------
----------------------------------,-X-.-.-.-.-.-.-.-.-.-.-,-.-.-.-.-,-X-.-.-,-.~.~.~.~.~.~.~,~,~,~,~,~,~,~,~,~,~X~X---------------------X-X---------------------X-X-X-X-X---,-,-,-------X-----------------------------
----------------------------------,-X-.-.-.-.-.-.-.-.-.-.-,-.-.-.-.-,-X-.-.-,-.~.~.~.~.~.~.~,~------------------X-X---X-X-------X-X-----X-X---------------------X-------X---,-X-X-------X-----------------------------
--------------------------------,-,-X-.-.-.-.-.-.-.-.-.-.-,-.-.-.-.-,-.-.-.-,-.~.~.~.~.~.~.~,~------------------X-X---X-X-------X-X-----X-X---------------------X-------X---,-X-X-------X-----------------------------
--------------------------------,-X-.-.-.-W-.-.-.-.-.-.-.-,-.-.-.-.-,-.-.-.-,-.~.~.~.~.~.~.~,~,-,-,-,-,-,-,-,-,-X-X---------------------X-X---------------------X-------X---------------X-----------------------------
--------------------------------,-X-.-.-.-.-:-.-.-.-.-.-.-,-.-.-.-.-,-.-.-.-,-.~.~.~.~.~.~.~.~.~.~.~.~.~.~.~.~.~X~X---------------------X-X---------------------X-X-X-X-X---------------X-----------------------------
--------------------------------,-X-.-.-.-.-.-.-.-.-.-.-.-,-.-.-.-.-,-X-.-.-,-.~.~.~.~.~.~.~.~.~.~.~.~.~.~.~.~.~X~X---------------------X-X---:-----------------------------------------X-----------------------------
------------------------------,-,-X-.-.-.-.-.-.-.-.-.-.-.-,-.-.-.-.-,-X-.-.-,-.~.~.~.~.~.~.~.~.~.~.~.~.~.~.~.~.~X~X---------------------X-X---------------------------------------------X-----------------------------
------------------------------,-X-.-.-.-.-.-.-.-.-.-.-.-.-,-.-.-E-.-,-X-.-.-,-.~.~.~.~.~.~.~.~.~.~.~.~.~.~.~.~.~X~X---------------------X-X---------------------------------------------X-----------------------------
------------------------------,-X-.-.-.-.-.-.-.-.-.-.-.-.-,-.-.-.-.-,-X-.-.-,-.~.~.~.~.~.~.~.~.~.~.~.~.~.~.~.~.~X~X-----E---------------X-X-H-----------E-------------------------------X-----------------------------
------------------------------,-X-.-.-.-.-.-.-.-.-.-.-.-.-,-.-.-.-.-,-.-.-.-,-.~.~.~.~.~.~.~.~.~.~.~.~.~.~.~.~.~X~X---------------------X-X---------------------------------------------X-----------------------------
--------------------------------,-X-.-.-.-.-.-.-.-.-.-.-.-,-,-.-.-.-,-X-.-.-,-.~.~.~.~.~.~.~.~.~.~.~.~.~.~.~.~.~X~X---------------------X-X---:-----------------------------------------X-----------------------------
--------------------------------,-X-.-.-.-.-.-.-.-.-.-.-.-.-,-.-.-.-,-X-.-.-,-.~.~.~.~.~.~.~.~.~.~.~.~.~.~.~.~.~X~X---------------------X-X---------------------------------------------X-----------------------------
----------------------------------,-X-.-.-.-.-.-.-.-.-.-.-.-,-,-.-.-,-X-.-.-,-.~.~.~.~.~.~.~.~.~.~.~.~.~.~.~.~.~X~X---------------------X-X---------------------X-X-X-X-X---------------X-----------------------------
----------------------------------,-X-.-.-.-.-.-.-.-.-.-.-.-.-,-.-.-.-X-.-.-,-,~.~.~.~.~.~.~.~.~.~.~.~.~.~.~.~.~X~X---X-X-------X-X-----X-X---------------------X-------X-----X-X-------X-----------------------------
------------------------------------,-X-.-.-.-.-.-.-.-.-.-.-.-,-,-.-.-,-X-.-.-,-.~.~.~.~.~.~.~.~.~.~.~.~.~.~.~.~X~X---X-X-------X-X-----X-X---------------------X-------X-----X-X-------X-----------------------------
------------------------------------,-X-.-.-.-.-.-.-.-.-.-.-.-.-,-.-.-.-X-.-.-,-,~.~.~.~.~.~.~.~.~.~.~.~.~.~.~.~X~X---------------------X-X---------------------X-------X---------------X-----------------------------
--------------------------------------,-X-.-.-.-.-.-.-.-.-.-.-.-,-,-.-.-,-X-.-.-,-.~.~.~.~.~.~.~.~.~.~.~.~.~.~.~X~X-------------------,-X-X-,-,-,-,-,-,-,-,-,-,-X-X-X-X-X---------------X-----------------------------
------------------------------------,-,-X-.-.-.-.-.-.-.-.-.-.-.-.-,-.-.-.-X-.-.-,-,~.~.~.~.~.~.~.~.~.~.~.~.~.~.~X~X-------------------,-X-X0,-.<,-.-,-.-.-,-+N+N------------------------X-----------------------------
------------------------------------,-X-.-.-.-.-.-.-.-.-.-.-.-.-.-,-,-.-.-,-X-.-.-,-,~,~.~.~.~.~.~.~.~.~.~.~.~.~X~X-------------------,-.-.0,-.<,-.-,-.-.-,-----------------------------X-----------------------------
----------------------------------,-,-X-.-.-.-.-.-.-.-.-.-.-.-.-.-.-,-.-.-.-X-.-.-.-.-,~,~.~.~.~.~.~.~.~.~.~.~.~X~X-------------------,-.-.0:-.<,-.-,-.-.-,---------E-------------------X-----------------------------
----------------------------------,-X-.-.-.-.-.-.-.-.-.-.-.-.-.-.-.-,-,-.-.-,-,-.-.-.-.-,-.~.~.~.~.~.~.~.~.~.~.~X~X-----E-------------,-.-.0:-.<,-.-,-.-.-,-----------------------------X-----------------------------
--------------------------------,-,-X-.-.-.-.-.-.-.-.-.-.-.-.-.-.-.-.-,-.-.-.-,-,-X-X-,-,~.~.~.~.~.~.~.~.~.~.~.~X~X-------------------,-X-X0,-,<,-,-,-,-,-,-----------------------------X-----------------------------
--------------------------------,-X-.-.-.-.-.-.-.-.-.-.-.-.-.-.-.-.-.-,-,-.-.-.-.-X-X-X-,~.~.~.~.~.~.~.~.~.~.~.~X~X-X-----------------X-X-X-X-------------------------------,-,-,-,-,-X-X-----------------------------
------------------------------,-,-X-.-.-.-.-.-.-.-.-.-.-.-.-.-.-.-.-.-.-,-,-.-.-.-.-.-X-X-X~,~,~.~,~,~,~,~,~,~X~X~--X-X-X-X-X-X-X-X-X-X-----X-X-X-X-X-X-X-X-X-X-X-X-X-X-X-X-X-X-.-.-X-X-------------------------------
------------------------------,-X-.-.-.-.-.-.-.-.-.-.-.-.-.-.-.-.-.-.-.-.-,-,-.-.-.-.-.-.-X-X-X-X~X~X-X-,-X-X-X~----------------------------------------------------------,-,-X6.6.6X6,-----------------X-------------
------------------------------,-X-.-.-.-.-.-.-.-.-.-.-.-.-.-.-.-.-.-.-.-.-.-,-,-.-.-E-.-.-.-.-X-,-,-X4X4.4X4X4,-----------------------------------------------------------,-X6.6.6.6.6X6--------------X---X-----------
------------------------------,-X-.-.-.-.-.-.-.-.-.-.-.-.-.-.-.-.-.-.-.-.-.-.-,-,-.-.-.-.-.-,-X-,-X4.4.4.4.4.4X4--------------------X-----------X-------------------------,-X6.6E6.6.6X6------------X---H---X---------
----------------------,-,-,-,-,-X-.-.-.-.-.-.-.-.-.-.-.-.-.-.-.-.-.-.-.-.-.-.-.-,-,-,-.-.-.-,-X-X4.4.4.4.4.4.4X4------------------X---X-X-----X---X-X---------------------,-X6.6.6.6.6X6----------X-----------X-------
------------------,-,-X-X-X-X-X-X-.-.-.-.-.-.-.-.-.-.-.-.-.-.-.-.-.-.-.-.-.-.-.-.-.-,-,-.-.-,-,-X4.4.4.4E4.4.4X4----------------X---------X-X---------X-X-----,-,-,-,-,-,-,-X6,6,6,6,6X6--------X---------------X-----
--------------,-,-X-X-.-.-.-.-.-.-.-.-.-.-.-.-.-.-.-.-.-.-.-.-.-.-.-.-.-.-.-.-.-.-.-.-,-.-.-,-,-X4.4.4.4.4.4.4X4--------------X---------------------------X-X-X-X-X-X-X-X-X-,-X6.6.6X6--X-X-X-X---------------X-------
----------,-,-X-X-.-.-.-.-.-.-.-.-.-.-.-.-.-.-.-.-.-.-.-.-.-.-.-.-.-.-.-.-.-.-.-.-.-.-,-.-.-,-.-X-.4.4.4.4.4,4X4------------X---------------------------------,-.-.-.-.-.-.-X-X-,-,-X-X-----------------------X-------
------,-,-X-X-.-.-.-.-.-.-.-.-.-.-.-.-.-.-.-.-.-.-.-.-.-.-.-.-.-.-.-.-.-.-.-.-.-.-.-.-,-.-.-,-X-X-.-.4.4.4.4,4X-----------X-----------------------------------,-.-.-.-.-.-.-,-------------------------------X---------
----,-,-X-.-.-.-.-.-.-.-.-.-.-.-.-.-.-.-.-.-.-.-.-.-.-.-W-.-.-.-A-.-.-.-.-.-.-.-.-.-.-,-.-.-.-X-X-X4.4X4X4X4.4X4--------X-------------------------------------,-.-.-.-.-.-.-,-----------E-------------------X---------
----,-.-X-.-.-.-.-.-.-.-.-.-.-.-.-.-.-.-.-.-.-.-.-.-.-.-.-,-,-,-,-.-.-.-.-.-.-.-.-.-.-,-.-.-.-X-X-.-.-.-H-.-.-X---------X-------------------------------------,-.-.-.-.-.-.-,---------------------------------X-------
--,-,-X-.-.-.-.-.-.-.-.-.-.-.-.-.-.-.-.-.-.-.-.-.-.-.-.-.-,-.-.-,-.-.-.-.-.-.-.-.-.-.-,-.-.-.-X-X-.-.-.-.-.-.-X-----------X-----------------------------------,-.-.-.-.-.-.-,-------------X-X-X---------------X-------
--,-.-X-.-.-.-.-.-.-.-.-.-.-.-.-.-.-.-.-.-.-.-.-.-.-.-.-.-,-.-.-,-.-.-.-.-.-.-.-.-.-.-,-.-.-.-X-X-.-.-.-.-.-.-X-----------X-----------------------------------,-.-.-.-.-.-.-,-------------X---X-----------------X-----
,-,-X-.-.-.-:-.-.-.-.-.-.-.-.-.-.-.-.-.-.-.-.-.-.-.-.-.-A-,-,-,-,-.-.-.-.-.-.-.-.-.-.-,-.-.-.-X-X-.-.-.-.-.-.-X-------------X---------------------------------,-.-.-.-.-.-.-,-------------X-X-X-----------------X-----
,-.-X-.-.-.-.-.-.-.-.-.-.-.-.-.-.-.-.-.-.-.-.-.-.-.-.-.-.-.-.-.-.-.-.-.-.-.-.-.-.-.-.-,-.-.-.-,-,-A-.-.-.-.-.-X-----------X---------------,-,-,-,-,-----------,-.-.-.-.-.-.-,-------------------------------------X---
,-X-.-.-.-H-.-.-.-.-.-.-.-.-.-.-.-.-.-.-.-.-.-.-.-.-.-.-.-.-.-.-.-.-.-.-.-.-.-.-.-.-.-,-.-.-.-X-X-.-.-.-.-.-.-X---------X---------------,-,-.-.-.-,-,-,-------,-.-.-.-.-.-.-,-------------------------------------X---
.-X-.-:-.-.-.-.-.-.-.-.-.-.-.-.-.-.-.-.-.-.-.-.-.-.-.-.-.-.-.-.-.-.-.-.-.-.-.-.-.-.-.-,-.-.-.-X-X-.-.-.-.-.-.-X---------X---------------,-,-,-,-,-,-,-,-,-----,-.-.-.-.-.-.-,---------,-,-,-,-,-,-------------------X-
X-.-.-.-.-.-.-.-.-.-.-,-X-X-X-X-X-X-X-X-X-.-.-.-.-.-.-.-.-.-.-.-.-.-.-.-.-.-.-.-.-.-.-,-.-.-.-X-X-.-.-.-.-.-.-X-X-X-X-X-X-------------,-,-,-t2t2t2t2t2.-,-----,-.-.-.-.-.-.-,---------,-t3t3t3t3t3--------E---------X-
X-.-.-.-.-.-.-.-.-.-,-X---------------,-X-.-.-.-.-.-.-.-.-.-.-.-.-.-.-.-.-.-.-.-.-.-.-,-.-.-.-.-.-A-.-.-.-.-.-,-,-,-E-X-X-------------,-.-,-t2.-.-t3t2.-,-----,-.-.-.-.-.-.-,---------,-t3.-.-.-t3----E-----------X---
X-.-.-.-.-.-.-.-.-,-X-----------------,-X-.-.-.-.-.-.-.-.-.-.-.-E-.-.-.-.-.-E-.-.-.-.-,-.-.-.-X-X-.-.-.-E-.-.-,-,-,-,-X5X5------------,-.-,-t2.-.-.-t2.-,-----,-.-.-.-.-.-.-,---------,-t3.-.-.-t3--------E-----X-----
X-.-.-.-.-.-.-.-,-X-------------------,-X-.-.-.-.-.-.-.-.-.-.-.-.-.-.-.-.-.-.-.-.-.-.-,-.-.-.-X-X-.-.-.-.-.-.-,-----,-.5,5--<---------,-.-,-t2.-.-.-t2,-,-----,-.-.-.-.-.-.-,---------,-t3t2.-.-t3------------X-------
X-.-.-.-.-.-.-.-X---------------------,-X-.-.-.-.-.-.-.-.-.-,-,-,-,-,-,-,-,-,-.-.-.-.-,-.-.-.-X-X-.-.-.-.-.-.-,-----E-X5X5------------,-,-,-t2t2t2t2t2,-------,-.-.-.-.-.-.-,---------,-t3t3t3t3t3------E---X---------
X-.-.-.-.-.-.-.-X---------------------,-X-.-.-.-.-.-.-.-,-,-,-.-.-.-.-.-.-.-,-,-.-.-.-,-.-.-.-,-,-A-.-.-.-.-.-,-,-,-,-X-X---------------,-,-,-.-.-.-,-,-------,-.-.-.-.-.-.-,---------------------------------X-------
X-.-.-.-.-.-.-.-X---------------------,-X-.-.-.-.-.-.-,-,-.-.-.-.-.-.-.-.-.-.-,-.-.-.-,-.-.-.-X-X-.-.-.-.-.-.-X-X-X5X5X-X-------,-,-,-,-----,-.-.-,-,---------,-.-.-.-.-.-.-,---,-,-,-------------------------X-------
X-.-.-.-.-.-.-.-X---------------------,-X-,-,-,-,-,-,-,-.-.-,-,-,-,-,-,-,-,-,-,-,-,-,-,-.-.-.-X-X-.-.-.-.-.-.-X---------X-------,-.-.-,-----,-.-.-,-----------,-.-.-.-.-.-.-,---,-.-,---------------------------X-----
X-.-.-.-.-.-.-.-X-------:-:-:---:-----,-X-.-.-.-.-.-.-,-,-,-,-,-,-,-,-,-,-,-,-.-,-.-.-.-.-.-.-X-X-.-.-.-.-.-.-X---------X-------,-,-,-,-,-,-,-X-X-X-----------,-.-.-.-.-.-.-,---,-,-K---------------E-----------X-----
X-.-.-.-.-.-.-.-X-------:---:-:-:-----,-X-.-.-.-.-.-.-.-,-,-,-,-.-.-.-.-,-,-,-,-,-.-.-.-.-.-.-.-.-A-.-.-.-.-.-X---------X---------,-,-,-,-,-,-X-.-X-----------,-.-.-.-.-.-.-,-----------------------------------X-----
X-<-.-<-.-<-.-<-X-------:-------:-----,-X-.-H-.-H-.-W-.-,-,-,-.-.-.-E-.-.-,-,-,-,-.-.-.-.-E-.-X-X-.-.-.-.-.-.-X---------X---------,-,-,-,-,-,-X-X-X-----------,-.-.-.-.-.-.-,---------------E-------------------X-----
X-.-.-.-.-.-.-.-X---------:-:---:-----,-X-.-.-,-,-,-,-.-,-.-.-.-.-.-.-.-,-,-,-.-,-.-.-.-.-.-.-X-X-H-.-.-,-,-,-X---------X-------------------------------------,-.-.-.-.-.-.-,-----------------------------------X-----
X-X-X-.-.-.-X-X-X---------------------,-X-X-X-X-X;.;X;X-X-X-X-X-X-L-L-L-X-X-X-X-X-X-X-X-X-X-X-X-X-X-X-X-L-X-X-X---------X-------------------------------------,-.-.-.-.-.-.-,-----------------------------------X-----
--,-X-X-X-X-X-------------------------,-,-X-X-X-X;.;X;X-X-X-X-X-X-L-L-L-X-X-X-X-X-X-X-X-X-X-X-X-X-X-X-X-L-X-X-,---------X-------------------------------------,-.-.-.-.-.-.-,---------------------------------X-------
--------------------------------------,-X-X-A-,-.;.;,;.-,-.-.-.-.-.-.-.-.-.-.-.-.-.-.-.-.-.-.-.-,-.-.-.-.-.-X-X-----------X-----------------------------------,-.-.-.-.-.-.-,-------X-X-X-X-X-X-X-X---------X---------
--------------------------------------,-X-.-.-,-,;,;,;.-,-.-.-.-.-.-.-.-.-.-.-.-,-,-,-,-,-,-,-.-,-.-.-.-.-.-.-X-------------X---------------------------------,-.-.-.-.-.-.-,---X-X-----------------X-X---X-----------
--------------------------------------,-X-.-<-.-.-.-.-.-,-.-.-.-.-.-.-.-.-.-.-.-,-.-.-X-X-.-,-.-,-.-.-.-.-.-.-X---------------X-------------------------X-X-X-X-X-X-X-X-X-X-X-X-------------------------X-------------
--------------------------------------,-X-.-.-.-.-.-.-,-,-.-.-.-.-.-.-,-,-,-,-.-,-.-.-X-X-.-,-.-,-,-,-,-,-.-.-X-----------------X-------------------X-X---------------------------------------------------------------
--------------------------------------,-X-.-.-.-E-.-.-,-.-.-.-.-.-.-.-,-.-.-,-.-,-,-,-,-,-,-,-.-,-,-.-.-,-.-.-X-------------------X-X-X-X-X-X-X-X-X-------------------------------------------------------------------
--------------------------------------,-X-.-.-.-.-.-,-,-.-.-.-.-.-.-.-,-.-.-,-H-.-.-.-.-E-.-.-.-,-,-.-.-,-.-.-X-------------------------------------------------------------------------------------------------------
--------------------------------------,-X-.-.-.-.-,-,-.-.-.-.-.-.-.-.-,-,-,-,-.-.-.-.-.-.-.-.-.-,-,-,-,-,-.-.-X-------------------------------------------------------------------------------------------------------
--------------------------------------,-X-.-.-.-,-,-.-.-.-.-.-.-.-.-.-.-.-.-.-.-.-.-.-.-.-.-.-.-,-.-.-.-.-.-.-X-------------------------------------------------------------------------------------------------------
--------------------------------------,-X-.-.-,-,-.-.-.-.-.-.-.-.-.-.-.-.-.-.-.-.-.-.-.-.-.-.-.-,-.-.-.-.-.-.-X-------------------------------------------------------------------------------------------------------
--------------------------------------,-X-.-.-,-.-.-.-.-.-E-.-.-.-.-.-.-.-.-.-,-,-,-,-,-,-,-,-,-,-.-.-.-.-.-.-X-------------------------------------------------------------------------------------------------------
--------------------------------------,-X-.-.-,-.-.-.-.-.-.-.-.-.-.-.-.-.-.-.-,-X-X-,-,-.-,-X-X-X-.-.-.-.-.-.-X-------------------------------------------------------------------------------------------------------
--------------------------------------,-X-.-.-,-.-.-.-.-.-.-.-.-.-.-.-.-.-.-.-,-X-X-,-,-,-,-X-X-X-.-.-.-.-E-.-X-------------------------------------------------------------------------------------------------------
--------------------------------------,-X-.-.-,-,-,-,-,-,-,-,-,-,-,-,-,-,-,-,-,-,-,->->->->->-,-,-.-.-.-.-.-.-X-------------------------------------------------------------------------------------------------------
--------------------------------------,-X-.-.-,-.-,-.-,-.-,-,-.-,-.-,-.-,-.-,-.-,-,->-.-.-.->-,-.-.-.-.-.-.-.-X-------------------------------------------------------------------------------------------------------
--------------------------------------,-X-.-.-,-.-,-.-,-.-,-,-.-,-.-,-.-,-.-,-.-,-,->-.-E-.->-,-.-.-.-.-.-.-.-X-------------------------------------------------------------------------------------------------------
--------------------------------------,-X-E-.-,-.-,-.-,-.-,-,-.-,-.-,-.-,-.-,-,-,-,->-.-.-.->-,-,-.-.-.-.-.-.-X-------------------------------------------------------------------------------------------------------
--------------------------------------,-X-.-.-,-,-,-,-,-,-,-,-,-,-,-,-,-,-,-,-,-X-X->->->->->-X-X-.-.-.-.-.-.-X-------------------------------------------------------------------------------------------------------
--------------------------------------,-X-.-.-.-.-.-.-.-.-.-.-.-.-.-.-.-.-.-.-,-X-X-,-,-,-,-X---X-.-.-E-.-.-.-X-------------------------------------------------------------------------------------------------------
--------------------------------------,-X-.-.-.-.-.-.-.-.-.-.-.-.-.-.-.-.-.-.-,-X-X-,-.-.-,-X-X-X-.-.-.-.-.-.-X-------------------------------------------------------------------------------------------------------
--------------------------------------,-X-.-.-.-.-.-.-.-.-.-.-.-.-.-.-.-.-.-.-.-.-.-.-.-.-.-.-.-.-.-.-.-.-.-.-X-------------------------------------------------------------------------------------------------------
--------------------------------------,-X-.-.-E-.-.-.-.-.-.-.-.-.-.-.-.-.-.-.-.-.-.-.-.-.-.-.-.-.-.-.-.-.-.-.-X-------------------------------------------------------------------------------------------------------
--------------------------------------,-X-.-.-.-.-.-.-.-.-.-.-.-.-E-.-.-.-.-.-.-.-.-.-.-.-.-.-.-.-.-.-.-.-.-.-X-------------------------------------------------------------------------------------------------------
--------------------------------------,-X-X-.-.-.-.-.-.-.-.-.-.-.-.-.-.-.-.-.-.-.-.-.-.-.-.-.-.-.-.-.-.-.-.-X-X-------------------------------------------------------------------------------------------------------
----------------------------------------,-X-X-X-X-X-X-X-X-X-X-X-X-X-X-X-X-X-X-X-X-X-X-X-X-X-X-X-X-X-X-X-X-X-X---------------------------------------------------------------------------------------------------------
