----------------------------------------------------------------------------------------------------------------X-X-X-X-X-X-X-X-X-X-X-X-X-X-------------
--------------------------------------------------------------------------------------------------------------X-----------------------------X-----------
------------------------------------------------------------------------------------X-X-X-X-X-X-X-X-X-X-X-X-X---------------------------------X---------
----------------------------------------------------------------------------------X-------------------------------------------------------------X-------
--------------------------------------------------------------------------------X-------------------------------------------:---:-----------------X-----
------------------------------------------------------------------------------X-------------------------------------------,-,-,-,-----------------X-----
----------------------------------------------------------------------------X-----------:---:---------------------------:-,-t4t4t4--:-------------X-----
----------------------------------------------------------------------------X---------,-,-,-,-----------------------------,-t4t7t4----------------X-----
----------------------------------------------------------------------------X-------:-,-t6t6t6--:-----------------------:-,-t4t4t4--:-------------X-----
----------------------------------------------------------------------------X---------,-t6t4t6------------H---------------------------------------X-----
----------------------------------------------------------------------------X-------:-,-t6t6t6--:---------------------------:---:-----------------X-----
----------------------------------------------------------------------------X-------------------------------------------------------------H-------X-----
----------------------------------------------------------------------------X-----------:---:-----------------------------------------------------X-----
----------------------------------------------------------------------------X---------------------------------------------H-----------------------X-----
----------------------------------------------------------------------------X---------------------------------------------------------------------X-----
----------------------------------------------------------------------------X-----H-----------------------------------------------,-,-,-,-,-,---X-------
----------------------------------------------------------------------------X-----------------------------,-:-,-:-----------------X-X~.~.~.~X~X---------
----------------------------------------------------------------------------X---------------------H-----,-,-.-.-,-,-------------X-,-X~.~.~.~X~----------
----------------------------------------------------------------------------X---------------------------:-.-t7t7t7,-:---------X---,-X~,~,~,~X~,-,-,-,-,-
------------------------------------------------------------------------------X-------------------------,-.-t7t6t7,---------X-----,-X~.~.~.~X-X-X-X-X-X-
--------------------------------------------------------------------------------X-----------------------:-,-t7t7t7,-:-------X-----,-X~.~.~.~.-.-.-.-.-X-
----------------------------------------------------------------------------------X-----------------------,-,-,-,-----------X-,-,-,-X~,~,~,~X-X-X-X-X-X-
------------------------------------------------------------------------------------X-----------------------:---:-----------X-,-X-X-X-.-.-.-X-X-X-------
------------------------------------------------------------------------------------X-------------,-,-,-,-------------,-,-,-X-,-X-.-.-.-.-.-.-.-X-------
------------------------------------------------------------------------------------X-------------,-t7t7t7----------,-,-,-X-X-X-X-.-.-.-.-.-.-.-X-------
------------------------------------------------------------------------------------X-------------,-t7H-t7--------,-,-,-.-,-.-,-,-.-.-.-<-.-.-.-X-------
------------------------------------------------------------------------------------X-------------,-t7t7t7--------,-X-XA.-,-.-,-,-.-,-,-,-,-.-.-X-------
------------------------------------------------------------------------------------X-----------------------------,-X-XA.-E-.-,-,-.-,-.-.-,-.-.-X-------
------------------------------------------------------------------------------------X-----------------------------,-X-XA.-,-.-,-X-X-,-,-,-,-,-X-X-------
--------------------------------------------------------------------------------------X---------------------------,-X-X-X-X-X-X-X-X-,-,-,-,-,-X-,-------
----------------------------------------------------------------------------X-X-X-X-X-X-X-X-X-X-,-,-,-,-,-,-,-X-X-X-X---------,-X-X-.-.-.-.-.-X-X-------
----------------------------------------------------------------------------X-H---------A-X---,-X~.~.~.~.~.~X~----------------,-X-.-.-.-.-.-.-.-X-------
----------------------------------------------------------------------------X-E-,-E-,-E-E-X---,-X~X~.~.~.~X~X~----------------,-X-.-.-.-.-.-.-.-X-,-----
--------------------------------------------------------------------,-,-,-,-X-X-X-.-.-.-X-X-,-,-,-X~L~L~L~X~,-,-,-,-,-,-,-----,-X-.-.-.-E-.-.-.-X-X-----
--------------------------------------------------------------------,-X-X-X-X-X-X-,-,-,-X-X-X-X-X-X~,~,~,~X~X-X-X-X-X-X-X-,-,-,-X-.-.-.-.-.-.-.-.-X-----
------------------------------------------------------------------,-,-X-+-+-+-.-.-.-.-.-.-.-B-,-----------,-,-.-.-K-.-,-X>X>X=X=X=X-X-X-X-X-X-X-A-X-----
----------------------------------------------------------------,-,-X-X-.-,-+-.-.-E-.-.-.-.-.-,-----------,-,-.-.-,-E-,-.>,>.=.=,=A-,-,-,-,-,-.-.-X-----
----------------------------------------------------------------,-X-.-.-<-.-+-+-.-.-.-.-.-.-.-,-----------,-.-.-.-,-+Y+YX>X>X=X=X=X-X-.-.-.-X-X-X-X-,---
----------------------------------------------------------------,-X-:-.-.-:-+-+-.-.-.-.-E-.-.-,-----------,-.-.-.-,-+Y.:X:X:X:X-X~X~X-,-,-,-X-X~X~X~X~,-
----------------------------------------------------------------,-X-.-.-<-.-+-+-.-.-.-.-.-.-.-,-----------,-.-.-.-E-,-.:::,:.:.-.-.-.-.-.-,~,~.~E~.~,~>-
----------------------------------------------------------------,-X-<-.-.-.-+-+-.-.-.-E-.-.-.-,-----------,-.-.-.-.-,-.:.:,:.:.-.-,-,-.-,-,-,-.~.~.~E~>-
----------------------------------------------------------------,-X-.-.-<-.-+-+-.-.-.-.-.-.-.-,-----------,-.-.-.-E-,-.:,:::.:,-,-,-,~,-,-.~.~E~.~.~,~>-
----------------------------------------------------------------,-X-.-:-.-,-+-+-.-E-.-.-.-.-.-,-----------,-.-.-.-.-,-,:X:X:X-X-X~X~X~X~X~X~X~X~X~X~X~--
------------------------------------------------------------------,-X-X-+-+-+-.-.-.-.-.-.-.-.-,-----------,-.-.-E-.-.-,-X-,-,-,-------------------------
--------------------------------------------------------------------,-X-+-+-.-.-,-,-,-,-.-.-A-,-,-,-,-,-,-,-.-.-.-.-.-H-X-X-X-X-------------------------
----------------------------------------------------,-,-,-,-,-,-,-,-,-X-X-X-X-X-X/././,/X/X-X-X-X-X~.~.~X~X-X-X-X-.-.-X-X-X-X-X-------------------------
--------------------------------------------------,-,-X-X-X-X-X-X-X-X-X-X-X-X-X-X-.-.-,-X-X-X-X-X~X~.~.~X~X~X-X-X-.-.-X-X---,-X-------------------------
--------------------------------------------------,-X-X-.-.-.-.-B-.-.-,-,-A-.-.-,-,-,-,-.-.-.-,-.~.~.~.~.~,~.-.-.-.-.-,-X---,-X-------------------------
--------------------------------------------------,-X-.-.-.-.-.-B-.-A-,-,-.-.-.-.-.-.-.-.-.-E-,-.~.~.~.~.~,~.-.-.-.-.-,-X9--,-X-------------------------
----------,-,-,-,-,-,-,-,-,-,-,-,-,-,-,-,-,-,-----,-X-.-.-,-,-,-,-,-,-,-,-.-.-.-.-.-.-.-.-.-.-,-.~.~.~.~.~,~.-.-.-E-.-,-X9--,-X-------------------------
--X-X-X-X-X-X-X-X-X-X-X-X-X-X-X-X-X-X-X-X-X-X-,---,-X-.-.-,-,-,-,-,-,-,-,-.-B-.-E-.-B-.-B-.-.-,-.~,~,~,~,~,~X-.-.-.-.-,-X9--,-X-------------------------
X-X---A---,-.-.-.-.-.-.-.-.-.-.-.-.-.-.-.-.-X-X---,-X-.-.-,-,-.-.-.-.-.-.-.-.-.-.-.-,-,-,-E-.-,-,~,~....,.,~X..-.-.-.-.-X-,-,-X-------------------------
X-----E---,-.-.-.-.-.-.-.-.-.-.-.-.-.-.-.-.-.-X---,-X-.-.-,-,-.-E-.-.-.-.-.-.-.-B-.-E-.-.-,-.-,-,.,-,.,.,.,-...-.-.-.-.-X-X-X-X-------------------------
X-H-------,-.-.-.-.-.-.-.-.-.-.-.-.-.-.-.-.-.-X---,-X-.-.-,-,-.-,-,-,-,-,-,-,-,-,-.-,-.-W-,-.-,-...-......,-X..-.-.-.-.-X-.-A-X-------------------------
X---E---,-,-.-.-.-,-,-,-,-,-,-,-,-.-.-.-.-.-.-X---,-X-.-.-,-,-.-,-,-,-,-.-.-.-.-,-.-,-,-,-.-,-,-.-.-.-.-.-,-.-.-.-.-.-.-X-.-.-X-------------------------
X-----,-,-.-.-.-.-,-.~.~.~.~.~.~,~,~,~,-.-.-.-X---,-X-.-.-,-,-.-,-,-,-,-.-.-.-.-,-,-,-.-,-,-,-.-.-.-.-.-.-,-.-.-.-.-.-.-.-.-E-X-------------------------
X-,-,-,-.-.-.-.-.-,~.~.~.~.~.~.~.~.~.~,~.-.-.-X---,-X-.-.-,-,-.-,-,-,-,-.-.-.-.-.-.-,-,-,-,-,-.-.-.-.-.-.-,-.-.-.-.-.-.-.-.-.-X-------------------------
X-.-.-.-.-.-.-.-,-,~.~.~.~.~,~,~,~,~.~,~.-.-.-X---,-X-.-.-,-,-,-,-,-,-,-.-.-.-.-.-.-.-.-.-.-.-.-.-.-.-.-.-,-X-.-.-H-.-.-.-.-E-X-------------------------
X-.-.-.-.-.-.-.-,-.~.~.~.~,~,~.1.1,1,~,~.-.-.-X---,-X-.-.-.-.-.-.-.-.-.-.-.-.-.-.-.-.-.-.-.-.-.-.-.-.-.-.-,-X-.-.-.-.-.-X-.-H-X-------------------------
X-.-.-.-.-.-.-.-,-.~.~.~.~,~.-.1.1.1,-,~.-.-.-X---,-X-.-.-.-.-.-.-.-.-.-.-.-.-.-.-.-.-.-.-.-.-.-.-.-.-.-.-,-,-.-.-.-.-.-X-X-X-X-------------------------
X-.-.-.-.-.-.-,-,~.~.~.~.~,~.-.1E1.1,-,~.-.-.-X---,-X-.-.-.-.-.-.-.-.-.-.-.-.-.-.-.-.-.-.-.-.-.-E-.-.-.-.-,-,-.-.-.-.-.-X-------------------------------
X-.-.-.-.-,-,-,-.~.~.~.~.~,~,-.-.-,-,-,~.-.-.-X---,-X-H-,-,-,-,-.-.-.-.-.-.-.-.-.-.-.-,-,-,-,-,-,-,-,-,-,-,-,-.-.-.-.-.-X-------------------------------
X-.-.-.-.-,-.~.~.~.~.~.~.~.~,~,-,-,-,~,~.-.-.-X-,-,-X-X-.-.-.-X-X-.-.-.-.-.-E-.-.-,-,-,-.-X-X-.-.-X-X-.-.-,-X-.-.-.-.-.-X-------------------------------
X-.-.-.-,-,~,~,~,~,~.~.~.~.~.~.~.~.~,~.~.-.-.-X-,-X-X-X-,-.-.-X-X-.-.-.-.-.-.-.-,-X-.-.-.-.-.-.-.-.-.-.-.-.-.-.-.-.-.-.-X-------------------------------
X-.-.-.-,-.~,~.2.2,2.~.~.~.~.~.~.~.~,~.~.-.-.-X-,-X-.-.-,-.-.-.-,-.-E-.-.-.-.-.-,-X-.-.-.-.-.-.-.-.-.-.-.-.-.-.-.-.-.-.-X-,-----------------------------
X-.-.-,-,~.~,~.2.2,2.~.~.~.~.~.~.~,~,~.-.-.-.-X-,-X-H-.-,-E-.-.-,-.-.-.-.-.-.-,-,-.-.-.-.-E-.-.-.-.-.-A-.-.-.-.-.-E-.-.-.-X-,-,-,-,---------------------
X-.-.-,-.~.~,~,2E2,2.~.~.~.~.~.~.~,~.~.-.-.-.-X-,-X-.-.-.-,-,-.-,-.-.-.-E-.-.-,-.-.-.-.-.-.-.-.-.-.-.-.-.-.-.-.-.-.-.-.-.-.-X-X-X-X---------------------
X-.-.-,-.~.~.~.~.~.~.~.~.~.~.~.~,~,~.-.-.-,-,-X-,-X-.-.-.-.-,-X-X-.-.-.-.-.-.-,-.-.-.-.-.-.-.-.-.-.-.-.-.-.-.-.-.-.-.-.-.-.-.-:-W-X---------------------
X-.-.-,-.~.~.~.~.~.~.~.~.~.~.~,~,~.-.-.-,-,-.-X-,-X-X-.-.-.-X-X-X-X-X-.-,-X-X-X-X-X-X-X-X-X-X-X-X-X-X-X-X-X-X-X-X-X-.-.-,-,-X-.-.-X---------------------
X-.-.-,-,~,~,~.~.~.~.~.~.~.~.~,~.-.-.-,-,-.-,-X-X-X-X-.-.-,-X-X-X-,-X-.-,-X-------------------------------------,-X-,-,-,-.-X-X-.-X---------------------
X-.-.-.-.-.~,~,~,~.~.~.~.~.~,~,~.-.-,-,-,-,-,-.-,-X-X-.-.-,-X-:-W-X-X-.-,-X---,-,-,-,-,-,-,-,-,-,-,-,-,-,-,-,-,---,-X-.-.-:-X-X-.-X---------------------
X-.-.-.-.-.-.-.-,-.~.~.~.~.~,~.~.-,-,-,-,-.-.-E-,-.-,-.-.-,-X-X-,-X-X-.-,-X---,-X-X-X-X-X-X-X-X-X-X-X-X-X-X-X-X-,-,-X-,-,-,-X-X-,-X---------------------
X-.-.-.-.-.-.-.-,-,~.~.~.~.~,~.~.-,-.-,-.-.-.-.-,-.-,-.-.-.-X-X-,-X<X<.-,-X---,-X-A-.-A-,-.-,-.-.-.-.-.-,-.-,-X-X-X-,-,-:-X-,-X-,-X---------------------
X-.-.-.-.-.-.-A-.-,-.~.~.~.~,~.-.-,-.-,-.-E-.-.-,-.-,-.-.-.-X-X-A-.<,<.-,-X---,-X-.-.-E-,-.-,-.-.-.-.-.-,-.-,-.-,-,-.-.-,-X-,-X-,-X---------------------
X-X-.-.-.-.-.-.-.-,-.~.~.~.~,~.-.-,-.-,-.-.-H-.-A-X-X-.-.-.-X-X-X-X<X<.-,-X-,-,-X-.-.-.-,-.-,-.-.-,-E-,-,-.-<-.-,-,-,-:-X---,-X-,-X---------------------
,-X-X-X-X-X-X-X-X-X-.~.~.~.~X~X-X-X-X-X-X-X-X-X-X-X-X0.0.0.0X0X-X-X-X-.-,-X-X-X-X-.-.-.-,-.-,-.-.-,-.-.-,-.-,-X-X-X-X-X-----,-X-.-X---------------------
------------,-X~.~.~.~.~.~.~.~.~.~.~.~.~.~.~.~.~,~,~.-.-.-.-,-,-.-X-X-.-.-X-X-.-.-B-.-.-,-.-,-,-.-,-.-W-,-,-.-X-------------,-X-H-X---------------------
------------,-X~.~.~,~,~,~,~.~.~.~.~.~.~.~.~.~,~,~.-.-.-.-.-.-,-,-.-.-.-.-.-.-.-.-.-.-.-,-,-.-,-.-,-,-,-.-,-,-X-,-,-,-,-,-,-,-XB.BXB--------------------
----------,-,-X-.~H~,~.-E-,-,~H~.~.~.~.~.~.~.~,~,-.-.-.-.-.-.-,-,-.-.-.-.-.-.-.-B-.-E-.-.-,-,-,-,-.-.-.-.-.-,-X@X@X-X-X-X-X-X-Xb:-Xb--------------------
----------,-X-X-,~,~,-,-A-,-,-,~.~.~.~.~.~.~.~,~,-,-,0.-.-.-,0,-.-.-.-.-.-.-.-.-.-.-.-.-.-.-,-,-,-,-.-.-.-.-,-.@,@.-.-.-A-.-.-.-,-X---------------------
----------,-X-,-,~.-,-.-.-,-.-,-.~.~.~.~.~.~.~,~.-.-,0+P+P+P+P.-A-.-.-.-.-.-.-.-.-.-.-.-.-.-,-,-,-,-,-,-,-,-H-X@X@X-X-X-X-X-X-X-X-----------------------
----------,-X-,-,~.-A-.-W-,-A-,-.~.~.~.~.~.~.~,~.-.-,0+P+P+P+P.-.-.-.-.-.-.-.-.-.-.-.-.-.-.-,-.-.~,~,-,-,~,~,~X-----------------------------------------
----------,-X-,-,~,-,-,-,-.-,-,-.~.~.~.~.~.~.~,~.-.-,0+P+P+P+P.-A-.-.-.-.-.-.-.-.-.-.-.-E-.-,-.~.~.~.~.~.~.~:~X~----------------------------------------
----------,-X-X-.~,~,-.-A-,-,-.~.~.~.~.~.~.~.~,~,-,-,0+P+P+P+P,-.-.-.-.-.-.-,-,-,-,-.-.-.-.-,-.~.~.~.~.~.~.~.~X~----------------------------------------
------------,-X-.~H~,~,-E-,-.~H~.~.~.~.~.~.~.~,~,-,-,-----,-,-,-.-.-.-.-E-,-,-,-,-,-,-.-B-.-,-,~.~.~.~.~E~.~.~X~----------------------------------------
------------,-X~.~.~.~.~.~.~.~.~.~.~.~.~.~.~.~.~.~.~,~----,-.-.-.-.-.-.-.-,-.-,-,-,-,-.-.-.-.-,-.~.~.~.~.~.~.~X~----------------------------------------
------------,-X~X~X~X~X~X~X~X~X~X~X~X~X~X~X~X~X~X~X~X~----,-X-X-X-X-X-X-X-X-X-.-H-,-X-X-X-X-X-X-X~X~X~X~X~.~X~X~----------------------------------------
----------------------------,-,-X-X-,-,-,-,-,-,-,-,-X-------X-----------,-,-,-X-.-X-,-,-,-,-,-,-,-,-,-,-X~.~X~,-,-,-------------------------------------
------------------:-:-:-----,-X-.-.-XCX-X-X-X-X-X-X-X-----,-X-X-X-X-X-X-X-X-X-X-,-X-X-X-X-X-X-X-X-X-X-X-X-,~X~X-X-X-,-----------------------------------
----------------:-----:-----,-X-.-.-tC.-A-.-H-.-H-.-,-----,-X-X---------,-.-,-.-.-,-.-.-.-.-.-.-.-.-.-.-,-,-.-.-.-X-X-----------------------------------
--------------:-:-:-:-:-----,-X-,-:-XCX-X-X-X-X-X-X-X-----,-.-,---------,-.-,-.-<-,-.-.-.-.-E-.-.-.-.-.-,-.-.-.-.-.-X-----------------------------------
------------------:-:-:-------,-X-X---------------,-X-,-,-,-X-X---------,-,-,-,-,-,-.-.-.-.-.-.-.-.-.-,-,-.-.-.-.-.-X-----------------------------------
--------------------------------------------------,-X0.0.0.0X0X-----------,-,-,-,-,-,-,-,-,-,-,-,-,-,-,-,-,-.-.-.-.-X-----------------------------------
--------------------------------------------------,-X-.-.-,-,---------------------------------------------,-.-.-.-.-X-----------------------------------
--------------------------------------------------,-X-.-.-,-----------------------------------------------,-,-.-.-.-X-----------------------------------
--------------------------------------------------,-X-.-.-,---------,-,-,-,-----,-,-,-,-----,-,-,-,---------,-.-.-.-X-----------------------------------
--------------------------------------------------,-X-.-.-,-,-----,-,-.-.-,-,-,-,-.~.~,~,-,-,-.~.~,~,-------,-,-.-.-X-----------------------------------
--------------------------------------------------,-X-.-.-.-,-----,-.-.-.-.-,-.~.~.~.~.~.~.~.~.~.~.~,~--------,-.-.-X-----------------------------------
--------------------------------------------------,-X-.-.-.-,-,---,-.-.-.-.-,-E~,~.~.~,~,~E~,~.~.~.~,~--------,-.-.-X-----------------------------------
--------------------------------------------------,-X-.-.-.-.-,---,-,-,-,-,-,-.-,-,~,~,~.-.-,-,~.~,~,~------,-,-.-.-X-----------------------------------
--------------------------------------------------,-X-.-.-.-.-,-----,-.-.-,-.-.-.-.-.-.-.-.-.-,-.~,~--------,-.-.-.-X-----------------------------------
--------------------------------------------------,-X-.-.-.-,-,-----,-.-.-,-.-.-.-.-.-.-.-.-.-,-.~,~--------,-.-.-.-X-----------------------------------
--------------------------------------------------,-X-.-.-.-,-------,-.-E-,-.-W-.-.-tC.-.-A-.-,-E~,~--------,-.-.-.-X-----------------------------------
--------------------------------------------------,-X-.-.-.-,-------,-.-.-,-.-.-.-.-.-.-.-.-.-,-.~,~--------,-.-.-.-X-----------------------------------
--------------------------------------------------,-X-.-.-.-,-----,-,-,-,-,-.-.-,-,-,-,-.-.-,-,-.~,~,-------,-.-.-.-X-----------------------------------
--------------------------------------------------,-X-.-.-.-,-----,-.~.~.~,~,-,-,-.~.~,~,-,-,-.~.~.~,~------,-.-.-.-X-----------------------------------
--------------------------------------------------,-X-.-.-.-,-----,-.~.~.~.~.~E~.~.~.~.~.~E~.~.~.~.~,~----,-,-.-.-.-X-----------------------------------
--------------------------------------------------,-X-.-.-.-,-----,-,~.~.~,~,~,~,~.~.~,~,~,~,~.~.~,~,~----,-.-.-.-.-X-----------------------------------
--------------------------------------------------,-X-.-.-.-,-------,-,~,~,~----,-,~,~,~----,-,~,~,~------,-.-.-.-.-X-----------------------------------
--------------------------------------------------,-X-.-.-.-,---------------------------------------------,-,-.-.-.-X-----------------------------------
--------------------------------------------------,-X-.-.-.-,-,-,-,-,-,---------------------------,-,-,-----,-.-.-.-X-----------------------------------
--------------------------------------------------,-X-.-.-.-.-,-,-.-.-,-,-,-----,-,-,-,-,-----,-,-,-.-,-,-,-,-.-.-.-X-----------------------------------
--------------------------------------------------,-X-.-.-.-.-.-.-.-.-.-.-,-,-,-,-.-.-.-,-,-,-,-.-.-.-.-,-,-.-.-.-.-X-----------------------------------
--------------------------------------------------,-X-.-.-.-.-.-.-.-.-.-.-.-.-.-.-.-.-.-.-.-.-.-.-.-.-.-.-.-.-.-.-.-X-----------------------------------
--------------------------------------------------,-X-.-.-.-.-.-.-.-.-.-.-.-.-.-.-.-.-.-.-.-.-.-.-.-.-.-.-.-.-.-.-.-X-----------------------------------
--------------------------------------------------,-X-X-.-.-.-.-.-.-.-.-.-.-.-.-.-.-.-.-.-.-.-.-.-.-.-.-.-.-.-.-.-X-X-----------------------------------
----------------------------------------------------,-X-X-X-X-X-X-X-X-X-X-X-X-X-X-X-X-X-X-X-X-X-X-X-X-X-X-X-X-X-X-X-------------------------------------
