------------------------------------------------------------,-,-,-X-X-X-X-X-X-X-X-X-X-X-X-X-X-X-X-X-X-X-X-X-X-----------------------------------------------------------------------------------------------------------------------------
--------------------------------------------------------,-,-,-X-X-.-.-.-.-.-.-.-.-.-.-.-.-.-.-.-.-.-.-.-.-.-X-----------------------------------------------------------------------------------------------------------------------------
----------------------------------------------------,-,-,-X-X-.-.-.-.-.-.-.-.-.-.-.-.-.-.-.-.-.-.-.-.-.-.-.-X-,---------------------------------------------------------------------------------------------------------------------------
--------------------------------------------------,-,-X-X-.-.-.-.-.-.-.-.-.-.-.-.-.-.-.-.-.-.-.-.-.-.-.-.-.-.-X---------------------------------------------------------------------------------------------------------------------------
--------------------------------------------------,-X-.-.-.-.-.-.-.-.-.-.-.-.-.-.-.-.-.-.-.-.-.-.-.-.-.-.-.-.-X-,-------------------------------------------------------------------------------------------------------------------------
------------------------------------------------,-,-X-.-.-.-.-.-.-.-.-.-.-.-.-.-.-.-.-.-.-.-.-.-.-.-.-.-.-.-.-.-X-------------------------------------------------------------------------------------------------------------------------
------------------------------------------------,-X-.-.-.-.-.-.-.-.-.-.-.-.-.-.-.-.-.-.-.-.-.-.-.-.-.-.-.-.-.-.-X-,-----------------------------------------------------------------------------------------------------------------------
----------------------------------------------,-,-X-.-.-.-X-X-X-.-.-.-.-.-.-.-.-.-.-.-.-.-.-.-.-.-X-X-X-.-.-.-.-.-X-,---------------------------------------------------------------------------------------------------------------------
----------------------------------------------,-X-.-.-.-.-X-.-X-.-.-.-.-.-.-.-.-.-.-.-.-.-.-.-.-.-X-.-X-.-.-.-.-.-.-X-,-------------------------------------------------------------------------------------------------------------------
--------------------------------------------,-,-X-.-.-.-.-X-X-X-.-.-.-.-.-.-.-.-.-.-.-.-.-.-.-.-.-X-X-X-.-.-.-.-.-.-.-X-,-----------------------------------------------------------------------------------------------------------------
--------------------------------------------,-X-.-.-.-.-.-.-.-.-.-.-.-.-.-.-.-.-.-.-.-.-.-.-.-.-.-.-.-.-.-.-.-.-.-.-.-.-X-,---------------------------------------------------------------------------------------------------------------
------------------------------------------,-,-X-.-.-.-.-.-.-.-.-.-.-.-.-.-.-.-.-.-.-.-.-.-.-.-.-.-.-.-.-.-.-.-.-.-.-.-,-,-X-,-------------------------------------------------------------------------------------------------------------
------------------------------------------,-X-.-.-.-.-.-.-.-.-.-.-.-.-.-.-.-.-.-.-.-.-.-.-.-.-.-.-.-.-.-.-.-.-.-.-.-,-,-.-.-X-,-----------------------------------------------------------------------------------------------------------
----------------------------------------,-,-X-.-.-.-.-.-.-.-.-.-.-.-.-.-.-.-.-.-.-.-.-.-.-.-.-.-.-.-.-.-.-.-.-.-.-,-,-.-.-.-.-X-,-,-,-,-,-------------------------------------------------------------------------------------------------
----------------------------------------,-X-X-.-.-.-.-.-.-.-.-.-.-.-.-.-E-.-.-.-.-.-.-.-E-.-.-.-.-.-.-.-.-.-.-.-.-,-.-.-.-.-.-.-X-X-X-X-X-,-,---------------------------------------------------------------------------------------------
----------------------------------------,-X-,-.-.-.-.-.-.-.-.-.-.-.-.-.-.-.-.-.-.-.-.-.-.-.-.-.-.-.-.-.-.-.-.-.-.-,-.-.-.-.-.-.-.-.-.-.-.-X-X-,-,-----------------------------------------------------------------------------------------
----------------------------------------,-X-,-.-.-.-.-.-.-.-.-.-.-.-.-.-.-.-.-.-A-.-.-.-.-.-.-.-.-.-.-.-.-.-.-.-.-,-.-.-.-.-.-.-.-.-.-.-.-.-.-X-X-,---------------------------------------------------------------------------------------
----------------------------------------,-X-,-.-.-.-.-.-.-.-.-.-.-.-.-.-.-.-.-.-.-.-.-.-.-.-.-.-.-.-.-.-.-.-.-.-.-,-.-.-.-.-.-.-.-.-.-.-.-.-.-.-.-X-,-------------------------------------------------------------------------------------
----------------------------------------,-X-,-.-.-.-.-.-.-.-.-.-.-.-.-.-.-.-A-.-W-.-A-.-.-.-.-.-.-.-.-.-.-.-.-.-.-,-.-.-.-.-.-.-.-.-.-.-.-.-.-.-.-.-X-,-----------------------------------------------------------------------------------
----------------------------------------,-X-,-.-.-.-.-.-.-.-.-.-.-.-.-.-.-.-.-.-.-.-.-.-.-.-.-.-.-.-.-.-.-.-.-.-.-,-.-.-.-.-.-.-.-.-.-.-.-.-.-.-.-.-.-X-----------------------------------------------------------------------------------
----------------------------------------,-X-,-.-.-.-.-.-.-.-.-.-.-.-.-.-.-.-.-.-A-.-.-.-.-.-.-.-.-.-.-.-.-.-.-.-.-,-.-.-.-.-.-,-X-X-X-.-.-.-.-.-.-.-.-X-,---------------------------------------------------------------------------------
----------------------------------------,-X-,-.-.-.-.-.-.-.-.-.-.-.-.-.-.-.-.-.-.-.-.-.-.-.-.-.-.-.-.-.-.-.-.-.-.-,-.-.-.-.-,-X-----,-X-.-.-.-.-.-.-.-.-X---------------------------------------------------------------------------------
----------------------------------------,-X-X-.-.-.-.-.-.-.-.-.-.-.-.-.-E-.-.-.-.-.-.-.-E-.-.-.-.-.-.-.-.-.-.-.-.-,-,-.-.-,-X---------,-X-.-.-.-.-.-.-.-X---------------------------------------------------------------------------------
------------------------------------------,-X-.-.-.-.-.-.-.-.-.-.-.-.-.-.-.-.-.-.-.-.-.-.-.-.-.-.-.-.-.-.-.-.-.-.-.-,-,-,-X-----------,-X-.-.-.-.-.-.-.-X---------------------------------------------------------------------------------
------------------------------------------,-X-.-.-.-.-.-.-.-.-.-.-.-.-.-.-.-.-.-.-.-.-.-.-.-.-.-.-.-.-.-.-.-.-.-.-.-.-,-X-------------,-X-.-.-.-.-.-.-.-X---------------------------------------------------------------------------------
------------------------------------------,-X-.-.-.-.-.-.-.-.-.-.-.-.-.-.-.-.-.-.-.-.-.-.-.-.-.-.-.-.-.-.-.-.-.-.-.-,-X---------------,-X-.-.-.-.-.-.-.-X---------------------------------------------------------------------------------
--------------------------------------------,-X-.-.-.-.-.-.-.-.-.-.-.-.-.-.-.-.-.-.-.-.-.-.-.-.-,-,-,-,-.-.-.-.-.-,-X---------------,-,-X-.-.-.-.-.-.-.-X---------------------------------------------------------------------------------
--------------------------------------------,-X-.-.-.-.-.-X-X-X-.-.-.-.-.-.-.-.-.-.-.-.-.-.-.-,-,-X-X-X-.-.-.-.-.-X-------------,-,-,-X-.-.-.-.-.-.-.-.-X---------------------------------------------------------------------------------
--------------------------------------------,-X-X-.-.-.-.-X-.-X-.-.-.-.-.-.-.-.-.-.-.-.-.-.-.-,-.-X-.-X-.-.-.-.-,-X---------,-,-,-X-X-.-.-.-.-.-.-.-.-.-X-,-------------------------------------------------------------------------------
----------------------------,-,-,-,-,-,-,-,-,-X-X-.-.-.-.-X-X-X-.-.-.-.-.-.-.-.-.-.-.-.-.-.-.-,-,-X-X-X-.-.-.-.-X---------,-,-X-X-.-.-.-.-.-.-.-.-.-.-.-.-X-,-,-,-,-,-,-------------------------------------------------------------------
------------------------,-,-,-X-X-X-X-X-X-X-X-X-X-X-.-.-.-.-.-.-.-.-.-.-.-.-.-.-.-.-.-.-.-.-.-.-,-,-,-.-.-.-.-,-X-----,-,-X-X-.-.-.-.-.-.-.-E-.-.-.-.-.-.-.-X-X-X-X-X-,-,-,---------------------------------------------------------------
--------------------,-,-,-X-X-.-.-.-.-.-.-.-.-.-.-X-.-.-.-.-.-.-.-.-.-.-.-.-.-.-.-.-.-.-.-.-.-.-.-.-.-.-.-.-.-X---,-,-X-X-.-,-.-.-.-.-.-.-.-.-.-.-.-.-.-.-.-.-,-.-.-.-X-X-,-,-------------------------------------------------------------
----------------,-,-,-X-X-.-.-.-.-.-.-.-.-.-.-.-.-X-X-X-.-.-.-.-.-.-.-.-.-.-.-.-.-.-.-.-.-.-.-.-.-.-.-.-.-.-,-X-,-,-X-.-.-.-,-.-X-X-X-.-.-.-.-.-.-.-.-.-X-X-X-,-.-.-.-.-.-X-X-------------------------------------------------------------
--------------,-,-X-X-.-.-.-.-.-.-.-.-.-.-.-.-.-.-.-X-X-X-X-.-.-.-.-.-.-.-.-.-.-.-.-.-.-.-.-,-,-,-,-,-,-,-,-X---,-.-X-.-.-.-,-.-X-.-X-.-.-.-.-.-.-.-.-.-X-.-X-,-.-.-.-.-.-.-,-X-----------------------------------------------------------
--------------,-X-.-.-.-.-.-.-.-.-.-.-.-.-.-.-.-.-.-.-.-X-X-X-X-.-.-.-.-.-.-.-.-.-.-.-.-.-,-,-.-.-.-.-.-.-.-X-,-,-X-.-.-.-.-,-,-X-X-X-.-.-.-.-.-.-.-.-.-X-X-X-,-.-.-.-.-.-.-.-X-----------------------------------------------------------
------------,-,-X-.-.-.-.-.-.-.-.-.-.-.-.-.-.-.-.-.-.-.-.-.-X-X-X-X-.-,-,-,-,-,-,-,-,-,-,-,-.-.-.-.-.-.-A-.-.-X-.-X-.-.-.-.-.-,-,-,-,-,-,-,-,-,-,-,-,-,-,-,-,-.-.-.-.-.-.-.-.-,-X---------------------------------------------------------
------------,-X-.-.-.-.-.-.-.-.-.-.-.-.-.-.-.-.-.-.-.-.-.-.-.-.-X-X-X-X-X-.-.-.-.-.-.-.-X-X-X-.-.-W-.-.-.-.-.-X-X-.-.-.-.-.-.-.-.-.-.-.-.-.-.-.-.-.-.-.-.-.-.-.-.-.-.-.-.-.-.-.-X---------------------------------------------------------
----------,-,-X-.-.-.-.-.-.-.-.-.-.-.-.-.-.-.-.-.-.-.-.-.-.-.-.-.-.-X-X-X-X-X-X-X-X-X-X-X-X-X-.-A-.-.-.-.-.-.-X-X-.-.-.-.-.-.-.-.-.-.-.-.-.-.-.-.-.-.-.-.-.-.-.-.-.-.-.-.-.-.-.-,-X-------------------------------------------------------
----------,-X-.-.-.-.-.-.-.-.-.-.-.-.-.-.-.-.-.-.-.-.-.-.-.-.-.-.-.-.-.-.-.-.-.-.-.-.-.-.-X-X-.-.-.-.-.-.-.-.-X-X-.-.-.-.-.-.-.-.-.-.-.-.-.-.-.-.-.-.-.-.-.-.-.-.-.-.-.-.-.-.-.-.-X-------------------------------------------------------
--------,-,-X-.-.-.-.-.-.-.-.-.-.-.-.-.-.-.-.-.-.-.-.-.-.-.-.-.-.-.-.-.-.-.-.-.-.-.-.-.-.-X-X-H-.-.-.-.-.-.-.-X-X-.-.-.-.-.-.-.-.-.-.-.-.-.-.-.-.-.-.-.-.-.-.-.-.-.-.-.-.-.-.-.-.-,-X-----------------------------------------------------
--------,-X-.-.-.-.-.-.-.-.-.-.-.-.-.-.-.-.-.-.-.-.-.-.-.-.-.-.-.-.-.-.-.-.-.-.-.-.-.-.-.-X-X-.-.-.-.-.-.-.-.-X-X-,-,-,-,-.-.-.-.-.-.-.-.-.-.-.-.-.-.-.-.-.-.-.-.-.-.-.-.-.-.-.-.-,-X-,---------------------------------------------------
------,-,-X-.-.-.-.-.-.-.-.-.-.-.-.-.-.-.-.-.-.-.-.-.-.-.-.-.-.-.-.-.-.-.-.-.-.-.-.-.-.-.-X-X-H-.-.-.-.-.-.-.-X-X-.-.-.-X-X-X-X-X-X-X-X-X-X-X-X-X-X-X-X-X-X-X-.-.-.-.-.-.-.-.-.-.-,-.-X---------------------------------------------------
------,-X-.-.-.-.-.-.-.-.-.-.-.-.-.-.-.-.-.-.-.-.-.-.-.-.-.-.-.-.-,-,-,-,-,-,-,-,-,-,-,-,-X-,-X-X-X-X-X-X6.6X6X-X-.-.-.-X-X-X-X-X-X-X-X-X-X-XCX-X-X-X-X-X-,-,-X-X-.-.-.-.-.-.-.-.-,-.-X-,-------------------------------------------------
------,-X-.-.-.-.-.-.-.-.-.-.-.-.-.-.-.-.-.-.-.-.-.-.-.-.-.-,-,-,-,-.-.-.-.-.-.-.-.-.-.-.-.-X-,-------,-X6.6X6--,-X-.-.-.-X-X-A-.-.-E-.-E-.-tC.-,-.-.-.-.-X-X-,-,-X-.-.-.-.-.-.-.-,-.-,-X-------------------------------------,-,---------
------,-X-.-.-.-.-.-.-.-.-.-.-.-.-.-.-.-.-.-.-.-.-.-.-.-,-,-,-.-.-.-.-.-.-.-.-.-.-.-.-.-.-.-.-X-,-----,-X6,6X6----X-.-.-,-X-X-,-,-,-,-,-,-,-tC,-,-.-.-.-.-.-.-X-X-,-X-.-.-.-.-.-.-,-.-,-X~,-,-------------------------------,-,-X~,-------
------,-X-.-.-.-.-.-.-.-.-.-.-.-.-.-.-.-.-.-.-.-.-.-,-,-,-.-.-.-.-.-.-.-.-.-.-.-.-.-.-.-.-.-.-.-X-,-----X---X-----,-X-.-,-X-X-.-.-.-.-.-.-.-.-.-.-.-.-.-.-.-.-.-.-X-,-X-.-.-.-.-.-,-.-,-.~X~X~,-,-,-,-,-,-,-,-,-,-,-,-,-,-,-,-X~.~X~,-----
------,-X-.-.-.-.-.-.-.-.-.-.-.-.-.-.-.-.-.-.-.-,-,-,-.-.-.-.-.-.-.-.-.-.-.-.-.-.-.-.-.-.-.-.-.-.-X---,-X-,-X-----,-X-.-,-.-,-.-.-.-.-.-.-.-.-.-.-.-.-.-.-.-.-.-.-.-X-X-.-.-.-.-.-,-.-,-.~.~.~X~X~X~X~X~X~X-X-X-X-X-X~X~X~X~X~.~.~.~X~,---
------,-X-.-.-.-.-.-.-.-.-.-.-.-.-.-.-.-.-.-,-,-,-.-.-.-.-.-.-.-.-.-.-,-,-,-,-,-,-,-,-,-,-,-,-,-,-X---,-Xf,FXf----,-X-.-,-.-,-.-.-.-.-.-.-.-.-.-.-.-.-.-.-.-.-.-.-.-,-X-X-.-.-.-.-,-.-,-.~.~.~.~.~.~.~.~,~.-.-.-.-,-.~.~.~.~.~.~.~.~.~X~,-
------,-X-.-.-.-.-.-.-.-.-.-.-.-.-.-.-.-.-,-,-.-.-.-.-.-.-.-.-.-.-.-.-,-.-.-,---------------------X---,-X-:-X-----,-X-.-,-.-,-.-.-.-.-.-.-.-.-.-.-.-.-.-.-.-E-.-.-.-.-X-X-.-.-.-.-,-.-,-.~.~.~.~.~.~.~.~,~.-.-.-.-,-.~.~.~.~.~.~.~.~.~,~X~
------,-X-.-.-.-.-.-.-.-.-.-.-.-.-.-.-.-,-,-.-.-.-.-.-.-.-.-.-.-.-.-.-,-.-.-,-----------------------X-,-Xe+eXe,-,-,-X-.-,-.-,-.-.-.-.-,-,-,-,-,-,-,-,-,-,-.-.-.-.-.-.-,-X-X-.-.-.-,-.-,-.~.~.~.~.~.~.~.~,~.-.-.-.-,-.~.~.~.~.~.~.~.~.~X~--
------,-X-.-.-.-.-.-.-.-.-.-.-.-.-.-.-.-,-.-.-.-.-.-.-.-.-.-.-.-.-.-.-,-,-,-,-----,-X-X-X-X-X-------X-X-Xe+eXeX-X-X-.-.-,-X-X-.-.-.-.-,-.-.-.-.-.-.-.-.-,-.-.-.-E-.-E-.-X-X-.-.-.-,-.-,-.~.~.~.~.~.~.~.~,~.-.-.-.-,-.~.~.~.~.~.~.~.~,~X~--
----,-,-X-.-.-.-.-.-.-.-.-,-,-,-,-,-,-.-,-.-.-.-.-.-.-.-.-.-.-.-.-.-.-,-----------,-X-X-X-X-X-----------------,-.-.-.-.-.-X-X-.-.-.-.-,-.-.-.-.-.-.-.-.-,-.-.-.-.-.-.-,-X-X-.-.-.-,-.-,-.~.~.~.~.~.~.~.~,~.-.-.-.-,-.~.~.~.~.~.~.~.~X~----
----,-X-.-.-.-.-.-.-.-.-,-,-.-.-.-.-,-,-,-.-.-.-.-.-.-.-.-.-.-.-.-.-.-,-----------,-X-.-E-X-X-----------------,-.-.-.-.-.-X-X-.-E-.-.-,-.-.-.-.-.-.-.-.-,-.-.-.-.-.-.-,-X-X-.-.-.-,-.-,-.~.~.~.~.~.~.~.~,~.-.-.-.-,-.~.~.~.~.~.~.~,~X~----
--,-,-X-.-.-.-.-.-.-.-,-,-.-.-.-.-.-.-,-,-.-.-.-.-.-.-.-.-.-.-.-.-.-.-,-----------,-X-.-.-X-X-----------------,-.-.-.-.-<-X-X-.-.-.-.-,-.-.-.-A-.-A-.-.-,-.-.-.-.-.-.-,-.-,-.-.-.-,-.-,-.~.~.~.~.~.~.~.~,~.-.-.-.-,-.~.~.~.~.~.~.~X~------
--,-X-.-.-.-.-.-.-.-,-,-.-.-.-.-.-.-.-.-,-,-.-.-.-.-.-.-.-.-.-.-.-.-.-,---,-X-X-X-X-X-,-,-X-X-X-X-X-X-X-X-X-X-X-X-X-X-X-X-X-X-.-.-.-.-,-.-.-.-.-E-.-.-.-,-.-.-.-.-.-.-,-.-,-.-.-.-,-.-,-.~.~.~.~.~.~.~.~,~.-.-.-.-,-.~.~.~.~.~.~,~X~------
,-,-X-.-.-.-.-.-.-,-,-.-.-.-.-.-A-.-.-.-.-,-.-.-.-.-.-.-.-.-.-.-.-.-.-,---,-X-X-X-X-XP,0,0XPXPX-X-X-X-X-X/X-X-X-X-X-X-X-X3X3X-.-.-.-.-,-.-.-.-A-.-A-.-.-,-.-.-.-.-.-.-,-.-,-.-.-.-,-.-,-.~.~.~.~.~.~.~.~,~.-.-.-.-,-.~.~.~.~.~.~X~--------
,-X-.-.-.-.-.-.-.-,-.-.-.-.-.-.-.-.-.-.-.-,-,-.-.-.-.-.-.-.-.-.-.-.-.-,---,-X---E-,-+P+PT-+P+P--------,-t/.-.-.-.-.-.-,-.3,3.-.-.-.-.-,-.-.-.-.-.-.-.-.-,-.-.-.-.-.-.-,-X-X-.-.-.-,-.-,-.~.~.~.~.~.~.~.~,~.-.-.-.-,-.~.~.~.~.~.~X~,-------
,-X-.-.-.-.-.-.-,-,-.-.-.-.-.-,-,-,-,-.-.-.-,-.-.-.-.-.-.-.-.-.-.-.-.-,---,-X-----,-+P+P+P+P+P--------,-t/.-.-,-,-,-,-,-,3,3.-.-.-.-.-,-.-.-.-.-.-.-.-.-,-.-.-.-.-.-.-.-X-X-.-.-.-,-.-,-.~.~.~.~.~.~.~.~,~.-.-.-.-,-.~.~.~.~.~.~.~X-------
X-.-.-.-.-.-.-.-,-.-.-.-.-.-.-,-.-.-,-.-.-.-,-.-.-.-.-.-.-.-.-.-.-.-.-,-----X-X-X-X-XP+P+PXPXPX-X-X-X-X-X/X-X-X-X-.-X-X-X-X3X-.-.-.-.-,-,-,-,-,-,-,-,-,-,-.-.-.-.-.-.-.-X-X-.-.-.-,-.-,-.~.~.~.~.~.~.~.~,~.-.-.-.-,-.~.~.~.~.~.~.~X~,-----
X-.-.-.-.-.-.-,-,-.-.-.-.-A-.-,-.-tC,-.-.-.-,-.-.-.-.-.-.-.-.-.-.-.-.-,-------------X-----X-X-----------------,-.-.-.-.-X-X-X-.-.-.-.-.-.-.-.-.-.-.-.-.-.-.-.-.-.-.-.-.-X-X-.-.-.-,-.-,-.~.~.~.~.~.~.~.~,~.-.-.-.-,-.~.~.~.~.~.~.~.~X-----
X-.-.-.-.-.-.-,-.-.-.-.-.-.-.-,-,-,-,-.-.-.-,-.-.-.-.-.-.-.-.-.-.-.-.-,-------------X---E-X-X-----------------,-.-.-.-.-X-X-.-.-.-.-.-.-.-.-.-.-.-.-.-.-.-.-.-.-.-.-.-.-X-X-.-.-.-,-.-,-.~.~.~.~.~.~.~.~,~.-.-.-.-,-.~.~.~.~.~.~.~.~X~,---
X-.-.-.-.-.-.-,-,-.-.-.-.-.-.-.-.-.-.-.-.-.-,-.-.-.-.-.-.-.-.-.-.-.-.-,-------------X-----X-X-----------------,-.-.-.-.-X-X-.-.-.-.-.-.-.-.-.-.-.-.-.-.-.-.-.-.-.-.-.-.-X-X-.-.-.-,-.-,-.~.~.~.~.~.~.~.~,~,-,-,-,-,-.~.~.~.~.~.~.~.~.~X---
X-.-.-.-.-.-.-.-,-.-.-.-.-.-.-.-.-.-.-.-.-,-,-.-.-.-.-.-.-.-.-.-.-.-.-,-------------X-X-X-X-X-----------------,-.-.-.-.-X-X-.-.-.-.-.-.-.-.-.-.-.-.-.-.-.-.-.-.-.-.-.-.-,-.-.-.-.-,-.-,-.~.~.~.~.~.~.~.~.~.~.~.~.~.~.~.~.~.~.~.~.~.~.~X~,-
X-.-.-.-.-.-.-.-,-,-.-.-.-.-.-.-.-.-.-.-.-,-.-.-.-.-.-.-.-.-.-.-.-.-.-,---------------------------------------,-.-.-.-.-X-X-.-.-.-.-.-.-.-.-.-.-.-.-.-.-.-.-.-.-.-.-.-.-,-.-.-.-.-,-.-,-.~.~.~.~.~.~,~,~,~,~,~.~.~.~.~.~.~.~.~.~.~.~.~.~X-
X-.-.-.-.-.-.-.-.-,-.-.-.-.-.-.-.-H-.-.-,-,-.-.-.-.-.-.-.-.-.-.-.-.-.-,-,-,-,-,-,-,-,-,-,-,-,-,-,-,-----------,-.-.-.-.-X-X-.-.-.-.-.-.-.-.-.-.-.-.-.-.-.-.-.-.-.-.-.-.-,-.-.-.-E-,-,-,-,~.~.~.~.~,~,~>-.-.-,-,~.~.~.~.~.~.~.~.~.~.~.~.~X~
X-.-.-.-.-.-.-.-.-,-.-.-.-.-.-.-.-.-.-.-,-.-.-.-.-.-.-.-.-.-.-.-.-.-.-.-.-.-.-.-.-.-.-.-.-.-.-.-.-,-----------,-.-.-.-.-X-X-.-.-.-.-.-.-.-.-.-.-.-.-.-.-.-.-.-.-.-.-.-.-X-X-.-.-.-.-.-,-,-,-.~.~.~,~>-.-.-.-.-,-.~.~.~.~.~.~.~.~.~.~.~.~X~
X-.-.-.-.-.-.-.-.-,-.-.-.-.-.-.-.-.-.-,-,-,-.-.-.-.-.-.-.-.-.-.-.-.-.-.-.-.-.-.-.-.-.-.-.-.-.-.-.-,-----------,-.-.-.-.-X-X-.-.-.-.-.-.-.-.-.-.-.-,-,-,-,-,-,-,-,-.-.-.-X-X-.-.-.-.-.-.-.-,-.~.~.~,~>-.-.-.-.-,-.~.~.~.~.~.~.~.~.~.~.~.~X~
X-.-.-.-.-.-.-.-.-,-.-.-.-.-.-.-.-.-,-,-.-,-.-.-.-.-.-.-.-.-.-.-.-.-.-.-.-.-.-.-.-.-.-.-.-.-.-.-.-,-----------,-.-.-.-.-X-X-.-.-.-.-.-.-.-.-.-.-.-X-X-.-.-.-.-.-X-X-X-X-X-X-.-.-.-.-.-<-.-,-.~.~.~,~>-.-E-.-.-,-.~.~.~.~.~.~.~.~.~.~.~.~X~
X-.-.-.-.-.-.-.-.-,-,-.-.-.-.-.-.-,-,-.-.-,-,-.-.-.-.-.-.-.-.-.-.-.-.-.-.-.-.-.-.-.-.-.-.-.-.-.-.-,-----------,-.-.-,-,-X-X-.-.-.-,-A-,-A-.-.-.-.-X-X-,-,-,-,-,-X-----,-,-X-.-.-.-.-,-,-,-,-.~.~.~,~>-.-.-.-,-,-.~.~.~.~.~.~.~.~.~.~.~.~X~
X-.-.-.-.-.-.-.-.-.-,-,-.-.-.-.-,-,-.-.-.-.-,-.-.-.-.-.-.-.-.-.-.-.-.-.-.-.-.-.-.-.-.-.-.-.-.-.-.-,-----------,-.-.-,-K-X-X-.-.-X-X-X-.-X-X-.-.-.-X-X-----------X-XAX-X-XdX-.-.-.-.-,-.~.~.~.~.~.~.~,~>-,-,-,-.~.~.~.~.~.~.~.~.~.~.~.~.~X~
X-X-X-.-.-.-.-.-.-.-.-,-,-,-,-,-,-.-.-.-.-.-,-,-.-.-.-.-.-.-.-.-.-.-.-.-.-.-.-.-.-.-.-.-.-.-.-.-.-,-----------,-.-.-,-:-X-X-.-.-X-X-X-,-X-X-.-E-.-X-X-----------X-XA,-,-.D.-.-.-.-.-,-.~.~.~.~.~.~.~.~.~.~.~.~.~.~.~.~.~.~.~.~.~.~.~.~.~X~
----,-X-.-.-.-.-.-.-.-.-.-.-.-.-.-.-.-.-.-.-.-,-.-.-.-.-.-.-.-.-.-.-.-.-.-.-.-.-.-.-.-.-.-.-.-.-.-,-----------,-.-.-.-.-X-X-.-.-.-.-.-H-.-.-.-.-.-X-X-----E-----X-XAXa+aXDX-.-.-.-.-,-.~.~.~.~.~.~.~.~.~.~.~.~.~.~.~.~.~.~.~.~.~.~.~.~.~X~
------,-X-.-.-.-.-.-.-.-.-.-.-.-.-.-.-,-X-X-X-X-X-.-.-.-.-.-.-.-.-.-.-.-.-.-.-.-.-.-.-.-.-.-.-.-.-,-----------,-.-.-.-.-X-X-.-.-.-.-.-.-.-.-.-.-.-X-X-,-,-,-,-,-X-,-Xa+aXaX-.-.-.-.-,-.~.~.~.~.~.~.~.~.~.~,~,~,~,~.~.~.~.~.~.~.~.~.~.~.~X~
,-,-,-,-X-.-.-.-.-.-.-.-.-.-.-.-.-.-,-X-X-X-X-X-X-,-,-.-.-.-.-.-.-.-.-.-.-,-,-,-.-.-.-.-.-.-.-.-.-,-----------,-.-.-.-.-X-X-X-X-X-X-X-X-X-X-X-X-X-X-X-XT+T+T+TXTX-,-X-E-X-X-.-.-.-.-,-.~.~.~.~.~.~.~.~.~.~,~.-.-,-.~.~.~.~.~.~.~.~.~.~.~X~
X-X-X-X-X-.-.-.-<-.-.-.-.-.-.-.-.-,-X-X-X5,-,-H-X5X-X-.-.-.-.-.-.-.-.-.-.-,-.-,-,-,-,-,-,-,-,-,-,-X-X-,-,-,-X-X-.-A-:-.-X---X-X-X-X-X-X-X-X-X-X-X-X-X-XT+T+T+TXTX-,-X-X-X-X-.-.-.-.-,-.~.~.~.~.~.~.~.~.~,~,~.-.-,-.~.~.~.~.~.~.~.~.~.~.~X~
X-.-.-.-.-.-.-.-.-.-.-.-.-.-.-.-.-,-X-.-,5.5.5,5.5.-,-.-.-.-.-.-.-.-.-.-.-,-.-.-,-.-,-.-,-,-,-,-X-,-X-.-.-X-,-X-X-X-X-X-X-,-X-,-X-X-,-X-X-,-X-X-E-X-X-.-.-.-.-.-X-------,-X-.-.-.-.-,-.~.~.~.~.~.~.~.~.~,~,-.-.-,-.~.~.~.~.~.~.~.~.~.~.~X~
X-.-.-.-.-.-.-.-<-.-.-.-.-.-.-.-.-,-.-.-,5.5.5,5.5.-,-.-.-.-.-.-.-.-.-.-.-,-,-,-,-,-,-,-,-,-.-.-X-X-X-.-.-X-X-----,-X-X-X-X-X-.-X-X-.-X-X-.-X-X-.-X-X-.-.-.-.-.-X-------,-X-.-.-.-.-,-.~.~.~.~.~.~.~.~.~,~,~.-.-,-.~.~.~.~.~.~.~.~.~.~.~X~
X-.-.-.-.-.-.-.-.-.-.-.-.-.-.-.-.-,-.-.-,5.5.5,5.5.-,-.-.-.-.-.-.-.-.-.-.-.-,-.-.-,-.-,-.-,-.-.-.-,-.-.-.-.-X-,-,-,-X-.-.-X-X-.-X-X-.-X-X-.-X-X-.-X-X-.-.-.-.-.-X-------,-X-.-.-.-.-,-.~.~.~.~.~.~.~.~.~.~,~,-,-,-.~.~.~.~.~.~.~.~.~.~.~X~
X-X-.-X-X-.-.-.-<-.-.-.-.-.-.-.-.-,-X-X-X5,5,5,5X5X-X-.-.-.-.-.-.-.-.-.-.-.-,-.-.-,-.-,-.-,-.-.-A-,-.-.-E-.-X.X-XNX-X..-.-.-.-.-.-.-.-.-.-.-.-.-.-.-.-.-.-,-,-,-X-,-,-,-,-X-.-.-E-.-,-.~.~.~.~.~.~.~.~.~.~,~----,-.~.~.~.~.~.~.~.~.~.~,~X~
,-X-+-X-X-.-.-.-.-.-.-.-.-.-.-.-.-.-.-X-X-X-X-X-X-X-.-.-.-.-.-.-.-.-.-.-.-.-,-.-.-,-.-,-.-,-.-.-.-,-.-.-.-.-...-,-,-...-.-.-.-.-.-.-.-.-.-.-.-.-.-.-.-.-.-,-.4,-XTXTX-X-,-X-.-.-.-.-,-.~.~.~.~.~.~.~.~.~.~,~----,-.~.~.~.~.~.~.~.~.~.~X~--
--X-H-X-X-.-.-.-<-.-.-.-.-.-.-.-.-.-.-.-X-X-X-X-X-.-.-.-.-.-.-.-.-.-.-.-.-.-,-.-.-,-.-,-.-,-.-.-.-,-W-.-.-.-...-,-,-...-.-.-.-E-.-.-.-.-.-.-.-.-.-.-.-.-.-,-.4,-+T+T,-X-,-X-.-.-.-.-,-,~.~.~.~.~.~.~.~.~.~,~----,-.~.~.~.~.~.~.~.~.~,~X~--
,-X-X-X-.-.-.-.-.-.-.-.-.-.-.-.-.-.-.-.-,-,-.-.-.-.-.-.-.-.-.-.-.-.-.-.-.-.-,-.-.-,-.-,-.-,-.-.-.-,-.-.-.-.-...-,-,-...-.-.-.-.-.-.-.-.-.-.-.-.-.-.-.-.-.-,-.4,-XTXTX-X-,-X-.-.-.-.-,-,-.~.~.~.~.~.~.~.~.~,~----,-.~.~.~.~.~.~.~.~.~X~----
X-X-X-.-.-.-.-.-.-.-.-.-.-.-.-.-.-.-.-,-,-.-.-.-.-.-.-.-.-.-.-.-.-.-.-.-.-.-,-.-.-,-.-,-.-,-.-.-A-,-.-.-E-.-X.X-XNX-X..-.-.-.-.-.-.-.-.-.-.-.-.-.-.-.-.-.-,-,-,-X-------,-X-.-.-.-.-,-,-.~.~.~.~.~.~.~.~.~,~----,-.~.~.~.~.~.~.~.~,~X~----
X-.-.-.-.-.-.-.-.-.-.-.-.-.-.-.-.-.-,-,-.-.-.-.-.-.-.-.-.-.-.-.-.-.-.-.-.-.-,-.-.-,-.-,-.-,-.-.-.-,-.-.-.-.-X-----,-X..-.-X-X-,-X-X-.-X-X-.-X-X-.-X-X-.-.-.-.-.-X-------,-X-.-.-.-.-,-.~.~.~.~.~.~.~.~.~.~,~----,-.~.~.~.~.~.~.~.~X~------
X-.-.-.-.-.-.-.-.-.-.-.-.-.-.-.-.-,-,-.-.-.-.-.-.-.-.-.-.-.-.-.-.-.-.-.-.-.-,-,-.-,-.-,-.-,-.-.-,-X-X-,-,-,-X-----,-X-X-X-X-X-.-X-X-,-X-X-,-X-X-,-X-X-.-.-.-.-.-X-------,-X-E-.-.-.-,-.~.~.~.~.~.~.~.~.~.~,~----,-.~.~.~.~.~.~.~,~X~------
X-.-.-.-.-.-.-.-.-.-.-.-.-.-.-.-,-,-.-.-.-.-.-.-.-.-.-.-.-.-.-.-.-.-.-.-.-.-,-,-,-,-,-,-,-,-,-,-X-,-X-,-,-X-,-,-,-------,-,-X-,-X-X-,-X-X-,-X-X-E-X-X-.-.-.-.-.-X-------,-X-.-.-.-.-,-.~.~.~.~.~.~.~.~.~.~,~----,-.~.~.~.~.~.~.~X~--------
X-.-.-.-.-.-.-.-.-.-.-.-.-.-.-.-,-.-.-.-.-.-.-.-.-.-.-.-.-.-.-.-.-.-.-.-.-.-.-.-.-.-.-.-.-.-.-.-X-X-X-.-.-X-X-X-X-X-X-X-X-X-X-.-X-X-.-X-X-.-X-X-.-X-X-X-.-.-.-X-X-------,-X-.-.-.-.-,-.~.~.~.~.~.~.~.~.~.~,~----,-.~.~.~.~.~.~,~X~--------
X-.-.-.-.-.-.-.-.-.-.-.-.-.-.-.-,-.-.-.-.-.-.-.-.-.-.-.-.-.-.-.-.-.-.-.-.-.-.-.-.-.-.-.-.-.-.-.-,-.-,-.-.-.-,-.-,-------X-X-W-.-.-.-.-.-.-.-.-.-.-X-X-X-,-,-,-X-X-------,-X-.-.-.-.-,-.~.~.~.~.~.~.~.~.~.~,~----,-.~.~.~.~.~.~X~----------
X-.-.-.-.-.-.-.-.-.-.-.-.-.-.-.-,-.-.-.-.-.-.-.-.-.-.-.-.-.-.-.-.-.-.-.-.-.-.-.-.-.-.-.-.-.-.-.-,-.-,-.-.-.-,-.-,-------X-X-A-.-.-.-.-.-.-.-.-.-.-X-X-,-.-.-,-.-X-------,-X-.-.-.-.-,-.~.~.~.~.~.~.~.~.~.~,~----,-.~.~.~.~.~,~X~----------
X-.-.-.-.-.-.-.-.-.-.-.-.-.-.-.-,-.-.-.-.-.-.-.-.-.-.-.-.-.-.-.-.-.-.-.-.-.-.-.-.-.-.-.-.-.-.-.-,-.-,-.-.-.-,-.-,-------X-X-X-X-X-X-X-X-X-X-X-X-X-X-X-,-.-E-,-.-X-------,-X-.-.-.-.-,-.~.~.~.~.~.~.~.~.~.~,~----,-.~.~.~,~X~X-------------
X-.-.-.-.-.-.-.-.-.-.-.-.-.-.-.-,-,-.-.-.-.-.-.-.-.-.-.-.-.-.-.-.-.-.-.-.-.-.-.-.-.-.-.-.-.-.-.-,-.-,-.-.-.-,-.-,-------X-,-X-X-X-X-X-X-X-X-X-X-X-,-X-,-,-,-,-.-X-------,-X-.-.-.-.-,-.~.~.~.~.~.~.~.~.~.~,~----,-.~,~X~X-----------------
X-.-.-.-.-.-.-.-.-.-.-.-.-.-.-.-.-,-.-.-.-.-.-.-.-.-.-.-.-.-.-.-.-.-.-.-.-.-.-.-.-.-.-.-.-.-.-.-,-.-,-.-.-.-,-.-,-----,-X-X-X-,-,-,-,-.-.-.-.-.-X-X-X-.-.-.-.-.-X-------,-X-.-.-.-.-,-.~.~.~.~.~.~.~.~.~.~,~----X-X~X---------------------
X-.-.-.-.-.-.-.-.-.-.-.-.-.-.-.-.-,-,-.-.-.-.-.-.-.-.-.-.-.-.-.-.-.-.-.-.-.-.-.-.-.-.-.-.-.-.-.-,-.-,-.-.-.-,-.-,-----,-X-X-.-,-.-.-,-.-.-.-.-.-.-X-X-X-.-.-.-X-X-------,-X-.-.-.-.-,-.~.~.~.~.~.~.~.~,~X~X~X-X---------------------------
X-.-.-.-.-.-.-.-.-.-.-.-.-.-.-.-.-.-,-.-.-.-.-.-.-.-.-.-.-.-.-.-.-.-.-.-.-.-.-.-.-.-.-.-.-.-.-.-,-.-,-.-.-.-,-.-,-----,-+-,-.-,-.-<-,-,-,-,-,-.-.-X-X-X-L-L-L-X-X-------,-X-.-.-.-.-,-.~.~.~.~,~X~X~X-X-----------------------------------
X-X-X-X-X-X-.-.-.-.-.-.-.-.-.-.-.-.-,-,-.-.-.-.-.-.-.-.-.-.-.-.-.-.-,-,-,-,-,-,-,-,-,-,-,-,-,-,-,-.-,-.-.-.-,-.-,-----,-X-X-.-,-,-,-,-,-.-.-,-.-.-X-X-.-.-.-.-.-X-------,-X-.-.-,-X-X-X~X~X~X-X-------------------------------------------
----------,-X-X-.-.-.-.-.-.-.-.-.-.-.-,-.-.-.-.-.-.-.-.-.-.-.-.-.-.-,-.-.-.-.-.-.-.-.-.-.-.-.-.-.-.-,-.-.-.-,-.-,-------X-X-.-.-.-.-.-,-.-H-,-.-.-.-.-.-.-.-.-.-X-------,-X-.-,-,-X-------------------------------------------------------
--------------,-X-.-.-.-.-.-.-.-.-.-.-,-,-.-.-.-.-.-.-.-.-.-.-.-.-.-,-.-.-.-.-.-,-,-,-,-,-,-,-,-,-,-,-.-.-.-,-.-,-------X-X-.-.-.-.-.-,-,-,-,-.-.-.-.-.-.-.-.-.-X-------,-X-,-,---X-------------------------------------------------------
----------------,-X-.-.-.-.-.-.-.-.-.-.-,-.-.-.-.-.-.-.-.-.-.-.-.-.-,-.-.-.-.-,-,-.-.-.-.-.-.-.-.-.-.-.-.-.-,-.-,-------X-X-.-.-.-.-.-.-.-.-.-.-.-.-.-.-.-E-.-.-X-------,-X-,-----X-------------------------------------------------------
------------------,-X-.-.-.-.-.-.-.-.-.-,-.-.-.-.-.-.-.-.-.-.-.-.-.-,-.-.-.-,-,-.-,-X-X-X-X-X-.-.-.-.-.-.-.-,-.-,-------X-X-.-.-.-.-E-.-.-.-.-.-E-.-.-.-.-.-.-.-X-------,-X-------X-------------------------------------------------------
------------------,-X-.-.-.-.-.-.-.-.-.-,-.-.-.-.-.-.-.-.-.-.-.-.-.-,-.-.-,-,-.-.-,-X-X-X-X-X-.-.-.-.-.-.-.-,-.-,-------X-X-.-.-.-.-.-.-.-.-.-.-.-.-.-.-.-.-.-.-X---------X-------X-------------------------------------------------------
--------------------,-X-.-.-.-.-.-.-.-.-,-.-.-.-.-.-.-.-.-.-.-.-.-.-,-.-.-,-.-.-.-,-X-.-E-X-X-.-.-.-.-.-.-.-,-.-,-------X-X-.-.-.-.-.-.-.-.-.-.-.-.-E-.-.-.-.-.-X-------X---------X-------------------------------------------------------
--------------------,-X-.-.-.-.-.-.-.-.-,-.-.-.-.-.-.-.-.-.-.-.-.-.-,-.-,-,-.-.-.-,-X-.-t:X-X-.-.-.-.-.-.-.-,-.-,-,-,-,-X-X-.-,-,-,-,-.-.-.-.-T-.-.-,-,-,-,-,-,-X-------X-----------X-----------------------------------------------------
------:-:-:-:-------,-X-.-.-.-.-.-.-.-.-,-.-.-.-.-.-.-.-.-.-.-.-.-.-,-.-,-,-X-X-X-X-X-,-,-X-X-X-X-X-X-X-X-X-X-X-X-X-.-X-X-X-.-,-.-.-,-.-.-.-.-.-.-.-X-X-.-.-.-X-X-----X-,-----------X-----------------------------------------------------
----:---:-:-:---------,-X-.-.-.-.-.-.-.-,-.-.-.-.-.-.-.-.-.-.-.-.-.-,-.-,-,-X-X-X-X-X;t;t;X;X-X>X-X-X-X-X:X-X-X-X-X-.-X-X-X-.-,-.-A-,-.-.-.-.-.-.-.-X-X@,@,@,@X@--,-,-,-X-,-----------X---------------------------------------------------
------:-----:---------,-X-.-.-.-.-.-.-.-,-.-.-.-.-.-.-.-.-.-.-.-.-.-,-.-,-,-X-.-E-t;t<.-t=.-,-t>.-.-.-.-t:.-.-.-,-.-.-.-X-X-.-,-,-,-,-.-.-.-E-.-.-.-X-X@.@.@.@X@,-,-X-X-.-,-,---------X---------------------------------------------------
--------:-:-:---------,-X-.-.-.-.-.-.-.-,-.-.-.-.-.-.-.-.-.-.-.-.-.-,-.-,-,-X-.-.-,-t<.-.-.-,-t>.-.-.-.-t:.-.-.-,-.-.-.-X-X-.-.-.-.-.-,-,-,-,-.-.-.-X-X@,@E@,@X@,-X-X-.-+b.-,---------X---------------------------------------------------
----------------------,-X-.-.-.-.-.-.-,-,-.-.-.-.-.-.-.-.-.-.-.-.-.-,-.-,-,-X-X-X-X-X<t=t=X=X-X>X-X-X-X-X:X-X-X-X-X-,-X-X-X-.-.-.-.-.-,-.-.-,-.-.-.-X-X@.@.@.@X@X-.-.-.-.-.B,-,-------X---------------------------------------------------
----------------------,-X-.-.-.-.-.-.-,-.-.-.-.-.-.-.-.-.-.-.-.-.-.-,-.-,-,-.-.-.-,-X-.-t<X-X-.-.-.-,-.-.-.-.-,---------X-X-.-.-.-.-.-,-.-W-,-.-.-.-X-X-.-.-,-X-.-.-.-.-.-.-.B,B,-----X---------------------------------------------------
--------------------,-,-X-.-.-.-.-.-,-,-.-.-.-.-.-.-.-.-.-.-.-.-.-.-,-.-.-,-,-.-.-,-X-.-E-X-X-.-.-,-,-.-.-.-.-,---------X-X-.-.-.-.-.-,-,-,-,-.-.-.-X-X-.-,-,-.-.-.-.-.-E-.-.B,BX---X-----------------------------------------------------
------------------,-,-X-.-.-.-.-.-.-,-.-.-.-.-.-.-.-.-.-.-.-.-.-.-.-,-.-.-.-,-,-.-,-X-.-.-X-X-.-,-,-.-.-.-.-.-,---------X-X-X-.-.-.-.-.-.-.-.-.-.-X-X-X-,-,-.-.-.-.-.-.-.-.-.-X-,-X-------------------------------------------------------
----------------,-,-X-.-.-.-.-.-.-,-,-.-.-.-.-.-.-.-.-.-.-.-.-.-.-.-,-.-.-.-.-,-,-,-X-X-X-X-X-,-,-.-.-.-,-X-X-X-X-X-----X-,-X-X-X-X-X-X-X-X-X-X-X-X-,-X-,-.-.-.-.-.-.-.-.-.-.-,-X---------------------------------------------------------
--------------,-,-X-.-.-.-.-.-.-.-,-.-.-.-.-.-.-.-.-.-.-.-.-.-.-.-.-,-.-.-.-.-.-.-,-,-,-,-,-,-,-.-.-.-,-X---------X-------X---------------------,-,-X-X-.-.-.-.-.-.-.-.-.-.-,-X-----------------------------------------------------------
--------------,-X-.-.-.-.-.-.-.-,-,-.-.-.-.-.-.-.-.-.-.-.-.-.-.-.-.-,-.-.-.-.-.-.-.-.-.-.-.-.-.-.-.-.-X-----------X-------X-----------------,-,-X-X-.-.-.-.-.-.-.-.-E-.-.-,-X-------------------------------------------------------------
--------------,-X-H-.-.-.-.-.-.-,-.-.-.-.-.-.-.-.-.-.-.-.-.-.-.-.-.-,-,-,-,-,-,-,-,-,-,-,-,-,-,-,-,-,-X---------,-X-,-,-,-,-X-,-,-,-,-,-,-,-X-X-.-.-.-.-.-.-.-.-.-.-.-.-,-X---------------------------------------------------------------
--------------,-X-X-X-X-X-X-X-X-X-X-.-.-.-.-.-.-.-.-.-.-.-.-.-.-.-.-.-.-.-.-.-.-.-.-.-.-.-.-.-.-.-.-.-X---------,-X-.-.-.-.-.-X-X-X-X-X-X-X-.-.-.-.-.-.-.-.-.-.-.-,-X-X-X-----------------------------------------------------------------
----------------------------------,-X-X-.-.-.-.-.-.-.-.-.-.-.-.-.-.-.-.-.-.-.-.-.-.-.-.-.-.-.-.-.-.-,-X---------,-X-.-.-.-.-.-.-.-.-.-.-.-.-.-.-.-.-.-.-.-.-.-.-,-X-----------------------------------------------------------------------
--------------------------------------,-X-X-.-.-.-.-.-.-.-.-.-.-.-.-.-.-.-.-.-.-.-.-.-.-.-.-.-.-.-,-X---------,-,-X-E-.-.-.-.-.-.-.-.-.-.-.-.-.-.-.-.-.-.-.-.-,-X-------------------------------------------------------------------------
------------------------------------------,-X-X-.-.-.-.-.-.-.-.-.-.-.-.-.-.-.-.-.-.-.-.-.-.-.-.-,-X-----------,-.-X-.-.-.-.-.-.-.-.-.-.-.-.-.-.-.-.-.-.-.-.-,-X---------------------------------------------------------------------------
----------------------------------------------,-X-.-.-.-.-.-.-.-.-.-.-.-.-.-.-.-.-.-.-.-.-.-.-,-X-------------,-X-.-.-.-.-.-.-.-.-.-.-.-.-.-.-.-.-.-.-.-.-,-X-----------------------------------------------------------------------------
------------------------------------------------,-X-.-.-.-.-.-.-.-.-.-.-.-.-.-.-.-.-.-.-.-.-,-X-----------------,-X-.-.-.-.-,-X-X-X-X-X-.-.-.-.-,-,-X-X-X-X-------------------------------------------------------------------------------
--------------------------------------------------,-X-.-.-.-.-.-.-.-.-.-.-.-.-.-.-.-.-.-.-,-X---------------------,-X-.-.-,-X-------,-,-X-X-,-,-X-X---------------------------------------------------------------------------------------
----------------------------------------------------,-X-.-.-.-.-.-.-.-.-.-.-.-.-.-.-.-.-,-X-------------------------,-X-,-X-------------,-,-X-X-------------------------------------------------------------------------------------------
------------------------------------------------------,-X-X-.-.-.-.-.-.-.-.-.-.-.-.-.-,-X-----------------------------,-X-----------------------------------------------------------------------------------------------------------------
----------------------------------------------------------,-X-X-.-.-.-.-.-.-.-.-.-,-X-X---------------------------------------------------------------------------------------------------------------------------------------------------
--------------------------------------------------------------,-X-X-.-.-.-.-.-,-X-X-------------------------------------------------------------------------------------------------------------------------------------------------------
------------------------------------------------------------------,-X-X-.-,-X-X-----------------------------------------------------------------------------------------------------------------------------------------------------------
----------------------------------------------------------------------,-X-X---------------------------------------------------------------------------------------------------------------------------------------------------------------
