------------------------------------------------------------------------------------------------------------------------------------------,-X-X-X-X-X-X-X-X-------------------------------------------
------------------------------------------------------------------------------------------------------------,-,-,-,-,-,-,-,-,-,-,-,-,-----,-X-H-.-,-,-,-,-X-------------------------------------------
--------------------------------------------------------------------------------------------------------,-,-,-X-X~X~X~X~X~X~X~X~X~X~X~,---,-X-.-.-,-t8t8t8X-------------------------------------------
----------------------------------------------------------------------------------------------------,-,-,-X-X~.~.~.~.~.~.~.~.~.~.~.~.~X~,-,-X-.-.-,-t8.-t8X-------------------------------------------
--------------------------------------------------------------------------------------------------,-,-X-X~.~.~.~.~.~.~.~.~.~.~.~.~.~.~,~X-,-X-.-.-,-t8t8t8X-------------------------------------------
--------------------------------------------------------------------------------------------------,-X~.~.~.~.~.~.~.~.~.~.~.~.~.~.~.~.~,~.-X-X-.-W-.-.-.-.-X-------------------------------------------
------------------------------------------------------------------------------------------------,-,-X~.~.~.~.~.~.~.~.~.~.~.~.~.~.~.~.~,~.-.-.-.-.-.-.-.-A-X-------------------------------------------
------------------------------------------------------------------------------------------------,-X~.~.~,~,~,~,~,~,~,~.~.~.~.~.~.~.~.~,~.-.-.-.-X-X-X-X-X-X-,-,-,-,-,-,-,-,---------------------------
----------------------------------------------------------------------------------------------,-,-X~.~,~,~,-,-,-,-,-,~,~.~.~.~.~.~.~.~,~.-.-.-.-X-X-X-X-X-X-X-X-X-X-X-X-X-X---------------------------
----------------------------------------------------------------------------------------------,-X~.~,~,~,-,-,-,-,-,-,-,-,~.~.~.~.~.~.~,~.-.-.-.-X-X-.-.-.-.-.-.-.-.-.-.-.-X---------------------------
------------------------------------------------------------------------------------------------,-X~,~,-,-,-.-.-,-,-,-,-,-.~.~.~.~.~.~,~.-.-E-,-X-X-X-.-.-.-.-.-.-,-,-,-,-X---------------------------
--------------------------------------------------------------------------------------------------,-X-X-,-,-,-,-.-,-,-,-,-,~.~.~.~.~.~,~.-,-,-,-X-X-X-.-.-.-.-.-,-,-,-,-,-X---------------------------
------------------------------------------------------------------------------------------------------,-X-,-.-,-,-.-,-,-,-,-.~.~.~.~.~,~.-,-,-,-L-L-.-.-.-.-.-.-,-,->->->-X---------------------------
------------------------------------------------------------------------------------------------------,-,-X-.-.-,-,-.-,-,-,-.~.~.~.~.~,~.-,-,-,-L-L-.-.-.-.-E-.-,-,->-.-,-X---------------------------
----------------------------------------------------------------------------------------------------,-,-X-.-.-W-.-,-.-,-,-,-.~.~.~.~.~,~.-.-.-,-L-L-.-.-.-.-.-.-,-,->->->-X---------------------------
------------------------------------------------------------------------------------------,-,-----,-,-X-.-.-.-.-,-,-,-,-,-,-.~.~.~.~.~,~.-.-.-,-X-X-X-.-.-.-.-.-.-,-,-,-,-X---------------------------
----------------------------------------------------------------------------------------,-,-X-,-,-,-X-.-.-.-,-,-,-,-,-,-,-,-.~.~.~.~,~,~.-.-.-.-X-X-X-.-.-.-.-.-.-.-.-.-.-X---------------------------
--------------------------------------------------------------------------------------,-,-X-,-X-,-X-.-.-.-,-,-.-,-X-,-,-,-.~.~.~.~,~,~.-.-.-.-.-X-X-.-.-.-.-.-.-.-.-.-.-.-X---------------------------
------------------------------------------------------------------------------------,-,-X-,-,-,-X-.-.-.-,-,-.-,-X-,-X-,-.~.~.~.~,~,~.-.-.-.-<-,-X-X-X-X-X-X-X-X-X-X-X-X-X-X---------------------------
----------------------------------------------------------------------------------,-,-X-,-,-,-.-.-.-.-,-,-.-,-X---,-X-.~.~.~.~,~,~.-.-.-.-.-,-X-------------------------------------------------------
--------------------------------------------------------------------------------,-,-X-,-,-,-.-.-.-.-,-,-.-,-X-------,-X~.~.~.~,~X-X-X-X-X-X-X---------------------------------------------------------
------------------------------------------------------------------------------,-,-X-,-,-,-.-.-.-.-.-,-.-,-X-----------,-X~X~X~X~----------------------------------------------------------------------
----------------------------------------------------------------------------,-,-X-,-,-,-.-.-.-.-.-,-,-,-X-,-,-----------------------------------------------------------------------------------------
--------------------------------------------------------------------------,-,-X-,-,-,-.-.-.-.-.-,-,-,-,-,-X-X-,---------------------------------------------------------------------------------------
------------------------------------------------------------------------,-,-X-,-,-,-.-.-.-.-.-,-,-,-,-,-,-,-.-X-,-------------------------------------------------------------------------------------
----------------------------------------------------------------------,-,-X-,-,-,-.-.-.-.-.-,-,-,-,-,-,-,-.-A-.-X-,-----------------------------------------------------------------------------------
--------------------------------------------------------------------,-,-X-,-,-,-.-.-.-.-.-,-,-,-,-,-,-,-.-.-.-.-.-X-----------------------------------------------------------------------------------
------------------------------------------------------------------,-,-X-,-,-,-.-.-.-.-.-,-,-,-,-,-,-,-.-A-.-.-.-.-X-,---------------------------------------------------------------------------------
----------------------------------------------------------------,-,-X-,-,-,-.-.-.-.-.-,-,-,-,-,-,-,-.-.-.-.-W-.-.-.-X-,-------------------------------------------------------------------------------
--------------------------------------------------------------,-,-X-,-,-,-.-.-.-.-.-,-,-,-,-,-,-,-.-.-.-.-.-.-.-.-.-.-X-,-,-,-,-,---------------------------------------------------------------------
--------------------------------------------------------------,-X-,-,-,-.-.-.-.-.-,-,-,-,-,-,-,-.-.-.-.-.-.-.-.-.-.-.-.-X-X-X-X-X---------------------------------------------------------------------
----------------------------------------------------------------,-X-,-.-.-.-.-.-,-,-,-,-,-,-,-.-.-.-.-.-.-.-.-.-.-.-.-.-.-.-.-.-X---------------------------------------------------------------------
------------------------------------------------------------------,-X-.-.-.-.-,-,-,-,-,-,-,-.-.-.-.-.-.-.-.-.-.-.-.-.-.-.-.-t6.-X---------------------------------------------------------------------
--------------------------------------------------------------------,-X-.-.-,-,-,-,-,-,-,-,-.-.-.-.-.-.-.-.-.-.-.-.-.-.-.-.-.-.-X---------------------------------------------------------------------
----------------------------------------------------------------------,-X-,-,-,-,-,-,-.-,-,-.-.-.-.-.-.-.-.-.-.-.-.-.-.-X-X-X-X-X---------------------------------------------------------------------
------------------------------------------------------------------------,-X-,-,-,-,-,-.-,-,-.-.-.-.-.-.-.-.-.-.-.-.-.-,-X-----------------------------------------------------------------------------
--------------------------------------------------------------------------,-X-,-,-.-,-,-,-,-.-.-.-.-.-.-.-.-.-.-.-.-.-,-X-,-,-------------------------------------------------------------------------
----------------------------------------------------------------------------,-X-X-.-,-,-,-,-.-.-.-.-.-.-.-.-.-.-.-.-,-,-.-X-X-,-,---------------------------------------------------------------------
--------------------------------------------------------------------------------X-,-,-.-.-.-.-.-.-.-.-.-.-.-.-.-.-.-,-.-.-.-.-X-X-,-,-----------------------------------------------------------------
--------------------------------------------------------------------------------,-X-.-.-.-.-.-.-.-.-.-.-.-.-.-.-.-,-,-.-.-.-.-.-.-X-X-----------------------------------------------------------------
----------------------------------------------------------------------------------,-X-.-.-.-.-.-.-.-.-.-.-.-.-.-.-,-X-X-.-.-.-E-.-X-------------------------------------------------------------------
------------------------------------------------------------------------------------,-X-.-.-.-.-.-.-.-.-.-.-.-,-X-X---,-X-X-.-.-H-X-------------------------------------------------------------------
------------------------------------------------------------------------------------,-,-X-,-,-,-,-,-,-,-,-,-X-X-----------,-X-X-X---------------------------------------------------------------------
----------------------------------------------------------------------------------,-,-X-.-.-.-.-.-.-.-.-.-.-X-,---------------,-X---------------------------------------------------------------------
--------------------------------------------------------------------------------,-,-X-.-.-.-.-.-.-.-.-.-.-.-.-X---------------------------------------------------------------------------------------
--,-,-,-,-,-,-,---------------------------------------------------------------,-,-X-.-.-.-.-.-.-.-.-.-.-.-.-.-X-,-------------------------------------------------------------------------------------
,-,-X-X-X-X-X-X-,-----------------------------------------------------------,-,-X-.-.-.-.-.-.-.-.-.-.-.-.-.-.-.-X-------------------------------------------------------------------------------------
,-X-,-,-,-,-,-,-X-,-------------------------------------------------------,-,-X-.-.-.-.-.-.-.-.-.-.-.-.-.-.-.-.-X-------------------------------------------------------------------------------------
X-,-,-,-,-,-,-,-,-X-,-----------------------------------------------------,-X-.-.-.-.-.-.-.-.-.-.-.-.-.-.-.-.-.-X-,-----------------------------------------------------------------------------------
X-,-,-,-.-.-,-,-,-.-X---------------------------------------------------,-,-X-.-.-.-.-.-.-.-.-.-.-.-X-.-.-.-.-.-.-X-----------------------------------------------------------------------------------
X-,-,-.-,-,-,-,-,-.-X---------------------------------------------------,-X-.-.-.-.-.-.-.-.-.-.-X-X-.-X-.-.-.-.-.-X-,---------------------------------------------------------------------------------
X-,-,-E-,-,~E-,-,-.-X-------------------------------------------------,-,-X-.-.-.-.-.-.-.-.-.-.-.-X-.-X-.-.-.-.-.-.-X---------------------------------------------------------------------------------
X-,-,-.-,-,~,-,-,-.-X-------------------------------------------------,-X-.-.-.-.-.-.-.-.-.-.-.-.-X-X-X-.-.-.-.-.-.-X---------------------------------------------------------------------------------
X-,-,-.-,-,~,-,-,-.-X-----------------------------------------------,-,-X-.-.-t4.-.-.-.-.-.-.-.-.-.-.-.-.-.-.-.-.-.-X---------------------------------------------------------------------------------
X-,-,-.-,-,~,-,-,-.-X-----------------------------------------------,-X-.-.-.-.-.-.-.-.-.-.-.-.-.-.-.-.-.-.-.-.-.-.-X---------------------------------------------------------------------------------
X-,-,-.-,-,~,-,-,-.-X---------------------------------------------,-,-X-.-.-.-.-.-.-.-.-.-.-.-.-.-.-.-.-.-.-.-.-.-.-X-,-,-----,-,-,-,-,-,-,-,-,-,-,-,-,-,-,-,-,-,-,-,-,-,-,-,-,-,-,-,-----------------
X-,-,-.-,-,~,-,-,-.-X---------------------------------------------,-X-.-.-.-.-.-.-.-.-.-.-.-.-.-.-,-,-,-,-,-X-X-X-X-X-X-X---,-,-X-X-X-X-X-X-X-X-X-X-X-X-X-X-X-X-X-X-X-X-X-X-X-X-X-X-X-,-,-,-,---------
X-,-,-.-,-,~,-,-,-.-X---------------------------------------------,-X-.-.-.-.-.-.-.-.-.-.-.-.-.-,-,-,-.-.-.-X-X-X-X---------,-X-,-,-,-,-,-,-,-,-,-,-,-,-,-,-,-,-,-,-,-,-,-,-,-,-,-,-,-X-X-X-X-,-,-----
X-,-,-,-,-.-.-,-,-.-X-----------------------------------------------,-X-.-.-.-.-.-.-.-.-.-.-.-.-,-,-,-,-,-,-,-,-,-,-X-----,-,-X-,-,-,-,-,-,-,-,-,-,-,-,-,-,-,-,-,-,-,-,-,-,-,-,-,-,-,-,-,-,-,-X-X-----
X-,-,-,-.-,-,-,-,-.-X-----------------------------------------------,-X-.-.-.-.-.-.-.-.-.-.-.-.-,-,-,-,-.-.-.-.-.-,-X-X-X-X-X-.-.-.-.-.-.-.-.-.-.-.-.-.-.-.-.-.-.-.-.-.-.-.-,-,-,-,-,-,-,-,-,-,-,-X---
X-,-,-,-.-,-t6t6t6.-X-------------------------------------------------,-X-.-.-.-.-.-.-.-.-.-.-.-,-,-,..-.-.-.-.-.-,-,-.-.-.-,-,-,-,-,-,-,-,-,-,-,-,-,-,-,-,-E-,-,-,-,-,-,-,-,-,-.-,-,-,-,-,-,-,-.-X---
X-,-,-,-.-:-t6.-t6.-X-------------------------------------------------,-X-.-.-.-.-.-.-.-.-.-.-.-,-,-,..-.-.-t8.-.-,-+N,-,-,-,-.-.-.-.-.-.-.-.-.-.-.-.-.-.-.-.-.-.-.-.-.-.-.-.-,-,-,-,-.-.-,-,-,-.-X---
X-,-,-,-.-,-t6t6t6.-X-------------------------------------------------,-X-.-.-.-.-.-.-.-.-.-.-.-,-.-,.,-.-.-.-.-,-,-,-.-.-.-,-,-,-,-,-,-,-,-,-,-,-,-,-,-,-,-,-,-,-,-,-,-,-,-,-,-,-,-,-,-,-,-,-,-,-X---
X-,-,-,-.-.-E-:-,-,-X-------------------------------------------------,-X-.-.-.-.-.-.-.-.-.-.-.-,-,-,-,-,-,-,-,-,-,-X-X-X-X-X-X-----------------------------------------------------,-,-,-.-,-,-,-,-X-
X-,-,-,-.-.-.-.-,-,-X-------------------------------------------------,-X-.-.-.-.-.-.-.-.-.-.-.-.-,-,-,-,-,-,-.-.-X-,---------X-------------------------------------E-----------------,-,-.-,-,-,-.-X-
X-,-,-,-,-.-<-,-,---X-------------------------------------------------,-X-.-.-.-.-.-.-.-.-.-.-.-.-.-,-,-,-,-X-X-X-X-,-,-,-------X-----------------------------------------------------,-,-,-.-,-,-,-X-
X-,-,-.-,-,-,-,-----X-------------------------------------------------,-X-.-.-.-.-.-.-.-.-.-.-.-.-.-.-.-.-.-X-X-X-X-X-X-X---------X-X-X-X-X-X-X-X-X-X-X-X-X-X-X-X-X-X-X-X-X-X---------,-.-,-.-,-,-,-X-
X-,-,-.-,-.~,~------X-------------------------------------------------,-X-.-.-.-.-.-.-.-.-.-.-.-.-.-.-.-.-.-.-.-.-.-X-X-------------------------------------------------------X-------,-.-,-.-,-,-,-X-
X-,-,-.-,-.~,~------X---------------------------------------------------,-X-.-.-.-.-.-.-.-.-.-.-.-.-.-.-.-.-.-.-.-.-X---------------------------------------------------------X-------,-.-,-.-.-,-,-X-
X-,-,-.-,-.~,~------X---------------------------------------------------,-X-.-.-.-.-.-.-.-.-.-.-.-.-.-.-.-.-.-.-.-.-X-----------------------------------------------------------X-----,-.-,-.-.-,-,-X-
X-,-,-E-,-.~,~------X-----------------------------------------------------,-X-.-.-.-.-.-X-X-X-.-.-.-.-.-.-.-.-.-.-,-X-----------------------------------------------------------X-----,-.-,-.-.-,-,-X-
X-,-,-.-,-.~,~------X-----------------------------------------------------,-X-.-.-.-.-X-.-.-X-.-.-.-.-.-.-.-.-.-.-X-------------------------------------------------------------X-----,-.-,-.-.-,-,-X-
X-,-,-.-,-.~,~------X-----------------------------------------------------,-X-.-.-.-X-.-.-.-X-.-.-.-.-.-.-.-.-.-,-X-------------------------------------------------------------X-----,-.-,-.-.-,-,-X-
X-,-,-.-,-.~,~------X-----------------------------------------------------,-X-.-.-.-.-X-.-X-.-.-.-.-.-.-.-.-.-.-X---------------------------------------------------------------X-----,-.-,-.-.-,-,-X-
X-,-,-.-,-.~,~------X-----------------------------------------------------,-X-.-.-.-.-.-X-.-.-.-.-.-.-.-.-.-.-.-X-,-------------------------------------------------------------X-----,-.-,-.-.-,-,-X-
X-,-,-.-,-.~,~------X-------------------------------------------------------,-X-.-.-.-.-.-.-.-.-.-.-.-.-.-.-.-.-.-X-------------------------------------------------------------X-----,-.-,-.-.-,-,-X-
X-,-E-.-,-.~,~E-----X---------------------------------------------------------,-X-.-.-.-.-.-.-.-.-.-.-.-.-.-.-.-.-X-,-----------------------------------------------------------X-----,-.-,-.-.-,-,-X-
X-,-,-.-,-.~,~------X-----------------------------------------------------------,-X-.-.-.-.-.-.-.-.-.-.-.-.-.-.-.-.-X-----------------------------------------------------------X-----,-.-,-.-.-,-,-X-
X-,-,-.-,-.~,~------X-------------------------------------------------------------,-X-.-.-.-.-.-.-.-.-.-.-.-.-.-.-,-X-----------------------------------------------------------X-----,-.-,-.-.-,-,-X-
X-,-,-.-,-.~,~------X---------------------------------------------------------------,-X-.-.-.-.-.-.-.-.-.-.-.-.-,-X-------------------------------------------------------------X-----,-.-,-.-.-,-,-X-
X-,-,-.-E-.~,~,-,-,-X-----------------------------------------------------------------,-X-X-X-X-X-X-X-X-.-.-.-,-X---------------------------------------------------------------X-----,-.-,-.-.-,-,-X-
X-,-,-,-,-,~,~,-,-.-X---------------------------------------------------------------------------------,-X-X-,-X-----------------------,-,-,-,-,-,-,-,-,-,-----------------------X-----,-.-,-.-.-,-,-X-
X-----,-.~,~,-,-,-.-X-------------------------------------------------------------------------------------,-X-----------------------,-,-X-X-X-X-X-X-X-X-X-,---------------------X-----,-.-,-.-.-,-,-X-
X-----,-.~,~,-,-,-.-X-------------------------------------------------------------------------------------------------------------,-,-X-.-.-.-.-.-.-.-.-.-X-,-------------------X-----,-.-,-.-.-,-,-X-
X-----,-.~,~,-,-E-.-X-------------------------------------------------------------------------------------------------------------,-X-.-.-.-.-.-.-.-.-.-.-.-X-,-----------------X-----,-.-,-.-.-,-,-X-
X-----,-.~,~,-,-,-.-X-----------------------------------------------------------------------------------------------------------,-,-X-.-.-.-.-.-.-.-.-.-.-.-.-X-----------------X---,-,-,-,-,-.-,-,-X-
X-,-,-,-.~,~,-,-,-.-X---------------------------------------------------------------------------------------------------------,-,-X-.-.-.-.-.-.-.-.-.-.-.-.-.-,-X---------------X-,-,-,-,-,-,-,-,-,-X-
X-,-,-,-,~,~,-,-,-,-X-------------------------------------------------------------------------------------------------------,-,-X-.-.-.-.-.-.-.-.-.-.-.-.-.-.-.-,-X-------------X-,-,-,-,-,-,-,-,-,-X-
X-,-,-,-.~,~.-,-----X-------------------------------------------------------------------------------------------------------,-X-.-.-.-.-.-.-.-.-.-.-.-.-.-.-.-.-.-,-X---------,-X-,-,-,-,-,-,-,-,-,-X-
X-,-,-,-.~,~.-,-----X-------------------------------------------------------------------------------------------------------,-X-.-.-.-.-.-.-.-.-.-.-.-.-.-.-.-.-.-,-X---------,-X-,-,-,-.-.-,-,-.-,-X-
X-,-,-,-.~,~.-,-----X-------------------------------------------------------------------------------------------------------,-X-.-.-.-.-.-.-.-W-<-A-.-.-.-.-.-.-.-,-X---------,-X-,-,-,-,-,-.-,-.-,-X-
X-,-,-,-.~,~.-,-----X-------------------------------------------------------------------------------------------------------,-X-,-,-,-.-.-.-H-.-.-.-W-.-.-.-.-.-.-,-X---------,-X-,-,-,-.-<-.-,-.-,-X-
X-,-,-,-.~,~.-,-----X-------------------------------------------------------------------------------------------------------,-X-t4t4t4.-.-.-A-<-<-.-<-.-.-.-.-.-.-,-X---------,-X-,-,-,-.-,-.-,-.-,-X-
X-,-,-,-,~,~,-,-----X-------------------------------------------------------------------------------------------------------,-X-t4.-t4.-.-.-A-.-.-.-H-.-.-.-.-.-.-,-X---------,-X-,-,-,-.-,-.-,-,-,-X-
X-,-,-,-.~.~,~,-----X-------------------------------------------------------------------------------------------------------,-X-t4t4t4.-.-.-.-A-.-A-.-.-.-.-.-.-.-,-X-----------X-,-,-,-.-,-,-,-,-,-X-
X-,-,-,-.~.~,~,-----X-------------------------------------------------------------------------------------------------------,-X-.-.-.-.-.-.-.-.-.-.-.-.-.-.-.-.-.-,-X-----------X---,-,-.-,-,-,-,-,-X-
X-,-,-,-.~.~,~,-----X-------------------------------------------------------------------------------------------------------,-X-.-.-.-.-.-.-.-.-.-.-.-.-.-.-.-.-,-,-X-----------X-----,-.-,-.-,-,-,-X-
X-,-,-,-.~.~,~,-----X---------------------------------------------------------------------------------------------------------,-X-.-.-.-.-.-.-.-.-.-.-.-.-.-.-,-,-X-------------X-----,-.-A-.-,-,-,-X-
X-,-,-,-.~.~,~,-,-,-X-----------------------------------------------------------------------------------------------------------,-X-.-.-.-.-.-.-.-.-.-.-.-.-,-,-X---------------X-----,-.-,-.-,-,-,-X-
X-,-,-,-,~A~,~,-,-,-X-------------------------------------------------------------------------------------------------------------,-X-.-.-.-.-.-.-.-.-.-.-,-X-X-----------------X-----,-.-,-.-,-,-,-X-
X-,-,-,-.~.~,~,-,-,-X---------------------------------------------------------------------------------------------------------------,-X-.-.-.-.-.-.-.-.-,-X---------------------X-----,-.-,-.-,-,-,-X-
X-,-,-,-.~.~,~,-,-,-X-----------------------------------------------------------------------------------------------------------------,-X-X-X-X-X-X-X-X-X-----------------------X-----,-.-,-.-,-,-,-X-
X-,-,-,-.~.~,~,-,-,-X-----------------------------------------------------------------------------------------------------------------------------------------------------------X-----,-.-,-.-,-,-,-X-
X-,-,-,-.~.~,~,-,-,-X-----------------------------------------------------------------------------------------------------------------------------------------------------------X-----,-.-,-.-,-,-,-X-
X-,-,-,-.~.~,~,-,-,-X-----------------------------------------------------------------------------------------------------------------------------------------------------------X-----,-.-,-.-,-,-,-X-
X-,-,-,-.~.~,~,-,-,-X-----------------------------------------------------------------------------------------------------------------------------------------------------------X-----,-.-,-.-,-,-,-X-
X-,-,-,-.~.~,~,-,-,-,-X---------------------------------------------------------------------------------------------------------------------------------------------------------X-----,-.-,-.-,-,-,-X-
X-,-,-,-.-.~,~,-,-,-,-X-,-,-,-,-,-,-,-,-,-,-,-,-,-,-,-,-,-,-,-,-,-,-,-,---------------------------------------------------------------------------------------------------------X-----,-.-,-.-,-,-,-X-
X-,-,-,-,-,~,~,-,-,-,-,-X-X-X-X-X-X-X-X-X-X-X-X-X-X-X-X-X-X-X-X-X-X-X-X-,-------------------------------------------------------------------------------------------------------X-----,-.-,-.-,-,-,-X-
X-,-,-,-,-,~,~,~,-.-,-,-,-,-,-,-,-,-,-,-,-,-,-,-,-,-,-,-,-,-,-,-,-,-,-,-X-X-X---------------------------------------------------------------------------------------------------X-----,-.-,-.-,-,-,-X-
X-,-,-,-,-,~.~,~,-,-,-,-,-,-,-,-,-,-,-,-,-,-,-,-,-,-,-,-,-,-,-,-,-,-,-,-,---X-X-X-X-X-X-----------------------------------------------------------------------------------------X-----,-.-A-.-,-,-,-X-
,-X-,-,-,-,~.~W~.~,-,-,-,-,-,-.-,-,-,-,-,-,---,-,-,-,-,-,-,-,-,-,-,-,-,-,-,---,-,-.-.-,-X---------------------------------------------------------------------------------------X-----,-.-,-.-,-,-,-X-
,-X-,-,-,-,-.~.~.~.~.~,~,~.-,-,-,-,~,~,~.~,~,-K-.~.~.~.~.~.~.~.~.~.~.~.~.~,~--,-.-.-.-.-,-X-------------------------------------------------------------------------------------X-----,-.-,-.-,-,-,-X-
,-X-,-,-,-,-,~.~.~.~.~,~,-A-,-.~.~,~.-,-,~.~.~.~.~.~.~.~.~.~.~.~.~.~.~.~.~,~,-,-.-.-.-.-,---X-----------------------------------------------------------------------------------X-----,-.-,-.-,-,-,-X-
,-X-.-,-,---,-,~,~,~,~.~.~.~.~.~.~,~.-H-,-.~.~.~.~.~.~.~.~.~.~.~.~.~.~.~,~,~.-,-,-.-.-,-,-----X---------------------------------------------------------------------------------X-----,-.-,-.-,-E-,-X-
--,-X-X-------------,-,-,-,~,~,~,~,~,-,-,-,~,~,~,~,~,~,~,~,~,~,~,~,~,~,~,~,-X-X-X-X-X-,-,-E-,-,-X-------------------------------------------------------------------------------X---E-,-.-,-.-,-,-,-X-
--------X-X-------------------------------------------------------------X-X-X-------,-X-,-,-.-.-,-X-----------------------------------------------------------------------------X-----,-.-,-.-,-,-,-X-
------------X-X-X-----------------------------------------------------X---------------,-X-.-.-.-.-,-X---------------------------------------------------------------------------X-----,-.-,-,-,-,-,-X-
------------------X-X-X-X-X-X-X-X-X-X-X-X-X-X-X-X-X-X-X-X-X-X-X-X-X-X-------------------X-.-.-.-.-,-X-----------------------------------------------------------------------X-X-------,-,-,-,-,-,-,-X-
----------------------------------------------------------------------------------------,-X-.-.-,-,---X---------------------------X-X-X-X-X-X-X-X-X-X-X-X-X-X-X-X-X-X-X-X-X---------,-,-,-.-,-,-,-,-X-
------------------------------------------------------------------------------------------,-X-,-,-----X-------------------,-X-X-X-------------------------------------------------,-,-.-,-,-,-,-,-.-X-
--------------:-:-:-------------------------------------------------------------------------,-X-,-E-,-,-X-X-X-X-X-X-X-X-X-X-X-.-,---------------------------------------------,-,-,-.-.-,-,-,-,-,-X-,-
------------:-----:---------------------------------------------------------------------------X-,-,-.-.-,-,-,-,-.-.-,-,-,-,-,-,-,-,-,-,-,-,-,-,-E-,-,-,-,-,-,-,-,-,-,-,-,-,-,-,-.-.-.-W-,-,-,-,-,-X---
----------:-:-:-:-:---------------------------------------------------------------------------,-X-.-.-.-.-,-,-.-.-.-.-.-.-.-,-,-.-.-.-.-.-.-.-.-.-.-.-.-.-.-.-.-.-.-.-.-.-.-.-.-,-,-,-,-,-,-,-,-.-X---
--------------:-:-:-----------------------------------------------------------------------------X-.-.-.-.-,-E-.-.-.-.-,-,-,-,-,-,-,-,-,-,-,-,-,-,-,-,-,-,-,-,-A-,-,-,-,-,-,-,-,-,-,-,-,-,-,-,-,-.-X---
------------------------------------------------------------------------------------------------,-X-.-.-,-,-,-,-.-.-,-,-.-.-,-,-,-,-,-,-,-,-,-,-,-,-,-,-,-,-,-,-,-,-,-,-,-,-,-,-,-,-,-,-,-,-,-.-X-,---
--------------------------------------------------------------------------------------------------,-X-X-X-X-X-X-X-X-X-X-X-X-X-.-,-,-,-,-,-,-E-,-,-,-,-,-,-,-,-,-,-,-,-,-,-,-,-,-,-,-,-,-,-,-,-,-X-----
--------------------------------------------------------------------------------------------------------------------------,-X-X-X-,-,-,-,-,-,-,-,-,-,-,-,-,-,-,-,-,-,-,-,-,-,-,-,-,-,-.-,-X-X-X-------
--------------------------------------------------------------------------------------------------------------------------------,-X-.-.-.-.-.-.-.-.-.-.-.-.-.-.-.-.-.-.-.-.-.-.-.-,-X-X-X-------------
----------------------------------------------------------------------------------------------------------------------------------,-X-X-X-X-X-X-X-X-X-X-X-X-X-X-X-X-X-X-X-X-X-X-X-X-------------------
